rev_id,num_workers_labelling_yes,num_workers_labelling_no,num_workers_disagree,total_labellers,percent_disagree
89320,4,5,4.0,9,0.4444444444444444
155243,2,7,2.0,9,0.2222222222222222
192579,1,7,1.0,8,0.125
249432,2,8,2.0,10,0.2
290598,3,15,3.0,18,0.16666666666666666
375422,2,8,2.0,10,0.2
398923,1,9,1.0,10,0.1
554005,3,16,3.0,19,0.15789473684210525
569192,1,18,1.0,19,0.05263157894736842
622095,6,14,6.0,20,0.3
633526,1,8,1.0,9,0.1111111111111111
661509,1,8,1.0,9,0.1111111111111111
680470,1,18,1.0,19,0.05263157894736842
694840,7,12,7.0,19,0.3684210526315789
801279,5,4,4.0,9,0.4444444444444444
804607,1,9,1.0,10,0.1
833825,1,9,1.0,10,0.1
849920,2,17,2.0,19,0.10526315789473684
916927,1,18,1.0,19,0.05263157894736842
1064649,1,8,1.0,9,0.1111111111111111
1078839,2,8,2.0,10,0.2
1126594,1,18,1.0,19,0.05263157894736842
1133583,1,9,1.0,10,0.1
1173977,2,7,2.0,9,0.2222222222222222
1185345,1,19,1.0,20,0.05
1221055,2,7,2.0,9,0.2222222222222222
1240138,3,6,3.0,9,0.3333333333333333
1250844,1,18,1.0,19,0.05263157894736842
1271243,2,7,2.0,9,0.2222222222222222
1274893,1,18,1.0,19,0.05263157894736842
1319467,8,12,8.0,20,0.4
1378881,1,8,1.0,9,0.1111111111111111
1399397,2,17,2.0,19,0.10526315789473684
1445262,2,8,2.0,10,0.2
1450441,4,6,4.0,10,0.4
1502668,3,6,3.0,9,0.3333333333333333
1511787,1,17,1.0,18,0.05555555555555555
1514095,1,16,1.0,17,0.058823529411764705
1571456,1,8,1.0,9,0.1111111111111111
1688728,3,7,3.0,10,0.3
1710587,5,15,5.0,20,0.25
1739728,1,8,1.0,9,0.1111111111111111
1766005,1,17,1.0,18,0.05555555555555555
1822867,1,18,1.0,19,0.05263157894736842
1842885,2,7,2.0,9,0.2222222222222222
1958817,1,9,1.0,10,0.1
2019031,1,18,1.0,19,0.05263157894736842
2200466,4,16,4.0,20,0.2
2205553,1,7,1.0,8,0.125
2314562,1,9,1.0,10,0.1
2336156,2,17,2.0,19,0.10526315789473684
2337410,1,9,1.0,10,0.1
2339911,1,8,1.0,9,0.1111111111111111
2434442,1,18,1.0,19,0.05263157894736842
2492647,1,18,1.0,19,0.05263157894736842
2606162,1,18,1.0,19,0.05263157894736842
2628839,1,8,1.0,9,0.1111111111111111
2637993,1,16,1.0,17,0.058823529411764705
2644049,2,8,2.0,10,0.2
2727211,2,18,2.0,20,0.1
2807850,1,9,1.0,10,0.1
2809532,1,8,1.0,9,0.1111111111111111
2822026,1,9,1.0,10,0.1
2825604,1,17,1.0,18,0.05555555555555555
2930834,1,19,1.0,20,0.05
2942923,1,8,1.0,9,0.1111111111111111
2991403,1,19,1.0,20,0.05
3043866,1,18,1.0,19,0.05263157894736842
3132477,1,9,1.0,10,0.1
3148037,6,14,6.0,20,0.3
3154173,2,8,2.0,10,0.2
3156619,2,16,2.0,18,0.1111111111111111
3218970,1,18,1.0,19,0.05263157894736842
3224969,2,6,2.0,8,0.25
3360621,1,9,1.0,10,0.1
3494080,1,8,1.0,9,0.1111111111111111
3525676,1,7,1.0,8,0.125
3568531,2,14,2.0,16,0.125
3578859,2,8,2.0,10,0.2
3592470,1,17,1.0,18,0.05555555555555555
3604206,1,9,1.0,10,0.1
3607710,1,8,1.0,9,0.1111111111111111
3637110,2,8,2.0,10,0.2
3720681,2,18,2.0,20,0.1
3734468,3,16,3.0,19,0.15789473684210525
3793165,1,9,1.0,10,0.1
3798128,1,8,1.0,9,0.1111111111111111
3824980,3,7,3.0,10,0.3
3897107,7,11,7.0,18,0.3888888888888889
3913164,1,18,1.0,19,0.05263157894736842
3925539,2,18,2.0,20,0.1
3990296,1,8,1.0,9,0.1111111111111111
4054247,1,18,1.0,19,0.05263157894736842
4094616,1,18,1.0,19,0.05263157894736842
4117580,2,8,2.0,10,0.2
4126589,2,16,2.0,18,0.1111111111111111
4132387,1,18,1.0,19,0.05263157894736842
4252057,1,9,1.0,10,0.1
4322944,2,18,2.0,20,0.1
4334457,2,8,2.0,10,0.2
4342815,2,7,2.0,9,0.2222222222222222
4463018,1,9,1.0,10,0.1
4480909,1,19,1.0,20,0.05
4530607,1,7,1.0,8,0.125
4600597,1,17,1.0,18,0.05555555555555555
4619883,3,6,3.0,9,0.3333333333333333
4632658,9,1,1.0,10,0.1
4790512,1,7,1.0,8,0.125
4843236,2,7,2.0,9,0.2222222222222222
4864279,6,11,6.0,17,0.35294117647058826
4876796,1,8,1.0,9,0.1111111111111111
4898172,1,9,1.0,10,0.1
5085524,1,18,1.0,19,0.05263157894736842
5097249,1,18,1.0,19,0.05263157894736842
5107418,1,17,1.0,18,0.05555555555555555
5108359,3,16,3.0,19,0.15789473684210525
5155366,1,7,1.0,8,0.125
5252559,1,9,1.0,10,0.1
5262377,1,8,1.0,9,0.1111111111111111
5320312,1,9,1.0,10,0.1
5387066,1,8,1.0,9,0.1111111111111111
5414702,2,18,2.0,20,0.1
5417906,1,17,1.0,18,0.05555555555555555
5459395,1,17,1.0,18,0.05555555555555555
5571217,1,18,1.0,19,0.05263157894736842
5603627,6,13,6.0,19,0.3157894736842105
5619479,1,18,1.0,19,0.05263157894736842
5623886,1,8,1.0,9,0.1111111111111111
5635120,1,16,1.0,17,0.058823529411764705
5643793,1,17,1.0,18,0.05555555555555555
5646320,3,16,3.0,19,0.15789473684210525
5671785,1,7,1.0,8,0.125
5766110,2,16,2.0,18,0.1111111111111111
5838638,2,7,2.0,9,0.2222222222222222
5840678,1,9,1.0,10,0.1
5857640,1,18,1.0,19,0.05263157894736842
5902358,1,9,1.0,10,0.1
5983299,1,9,1.0,10,0.1
6072317,1,8,1.0,9,0.1111111111111111
6085331,1,18,1.0,19,0.05263157894736842
6201487,9,9,9.0,18,0.5
6227228,1,19,1.0,20,0.05
6473887,2,7,2.0,9,0.2222222222222222
6485710,1,18,1.0,19,0.05263157894736842
6545332,9,1,1.0,10,0.1
6545351,7,3,3.0,10,0.3
6561426,2,8,2.0,10,0.2
6575074,1,17,1.0,18,0.05555555555555555
6612651,1,18,1.0,19,0.05263157894736842
6683326,1,9,1.0,10,0.1
6738513,1,18,1.0,19,0.05263157894736842
6739098,1,9,1.0,10,0.1
6742878,1,18,1.0,19,0.05263157894736842
6801519,1,9,1.0,10,0.1
6813383,1,7,1.0,8,0.125
6832933,2,17,2.0,19,0.10526315789473684
6902391,1,9,1.0,10,0.1
6984093,1,18,1.0,19,0.05263157894736842
7034125,1,9,1.0,10,0.1
7132903,1,8,1.0,9,0.1111111111111111
7189227,2,6,2.0,8,0.25
7422051,2,7,2.0,9,0.2222222222222222
7423111,2,6,2.0,8,0.25
7427711,1,9,1.0,10,0.1
7433478,1,8,1.0,9,0.1111111111111111
7586127,3,17,3.0,20,0.15
7588842,1,19,1.0,20,0.05
7826081,2,7,2.0,9,0.2222222222222222
7829616,3,7,3.0,10,0.3
7838300,2,18,2.0,20,0.1
7838899,1,17,1.0,18,0.05555555555555555
7871012,2,8,2.0,10,0.2
7914310,1,19,1.0,20,0.05
7977970,7,3,3.0,10,0.3
8053756,1,19,1.0,20,0.05
8096614,1,8,1.0,9,0.1111111111111111
8102355,1,17,1.0,18,0.05555555555555555
8126037,1,16,1.0,17,0.058823529411764705
8163533,3,6,3.0,9,0.3333333333333333
8175879,2,8,2.0,10,0.2
8229236,1,8,1.0,9,0.1111111111111111
8247331,1,18,1.0,19,0.05263157894736842
8260547,1,8,1.0,9,0.1111111111111111
8271742,1,9,1.0,10,0.1
8284251,8,9,8.0,17,0.47058823529411764
8297471,1,9,1.0,10,0.1
8310740,4,5,4.0,9,0.4444444444444444
8323109,2,7,2.0,9,0.2222222222222222
8324788,1,7,1.0,8,0.125
8336206,2,8,2.0,10,0.2
8346526,1,8,1.0,9,0.1111111111111111
8347658,1,8,1.0,9,0.1111111111111111
8347684,2,7,2.0,9,0.2222222222222222
8350378,1,9,1.0,10,0.1
8351483,2,8,2.0,10,0.2
8354624,4,6,4.0,10,0.4
8356071,2,6,2.0,8,0.25
8357601,5,5,5.0,10,0.5
8357736,4,5,4.0,9,0.4444444444444444
8359431,6,4,4.0,10,0.4
8371531,1,8,1.0,9,0.1111111111111111
8375796,1,19,1.0,20,0.05
8424530,1,9,1.0,10,0.1
8621412,3,6,3.0,9,0.3333333333333333
8622992,2,7,2.0,9,0.2222222222222222
8624535,1,8,1.0,9,0.1111111111111111
8644708,1,19,1.0,20,0.05
8647800,1,8,1.0,9,0.1111111111111111
8651698,1,8,1.0,9,0.1111111111111111
8708229,3,7,3.0,10,0.3
8721576,2,8,2.0,10,0.2
8723181,1,9,1.0,10,0.1
8724028,8,2,2.0,10,0.2
8724769,2,7,2.0,9,0.2222222222222222
8725515,3,7,3.0,10,0.3
8726172,2,7,2.0,9,0.2222222222222222
8726328,4,4,4.0,8,0.5
8727175,1,9,1.0,10,0.1
8727268,1,9,1.0,10,0.1
8740748,2,7,2.0,9,0.2222222222222222
8768929,3,7,3.0,10,0.3
8772699,2,6,2.0,8,0.25
8809377,1,9,1.0,10,0.1
8845700,8,2,2.0,10,0.2
8845736,9,1,1.0,10,0.1
8845780,4,6,4.0,10,0.4
8855349,1,9,1.0,10,0.1
8855444,3,7,3.0,10,0.3
8855554,3,7,3.0,10,0.3
8875274,3,34,3.0,37,0.08108108108108109
8876353,2,18,2.0,20,0.1
8894790,1,19,1.0,20,0.05
8898827,1,15,1.0,16,0.0625
8898868,4,6,4.0,10,0.4
8898892,3,6,3.0,9,0.3333333333333333
8899112,14,16,14.0,30,0.4666666666666667
8899166,4,6,4.0,10,0.4
8925594,3,7,3.0,10,0.3
8942766,1,9,1.0,10,0.1
8971984,2,7,2.0,9,0.2222222222222222
8972653,8,21,8.0,29,0.27586206896551724
8997245,3,7,3.0,10,0.3
9021595,1,8,1.0,9,0.1111111111111111
9081074,2,16,2.0,18,0.1111111111111111
9102140,1,19,1.0,20,0.05
9109054,1,18,1.0,19,0.05263157894736842
9113920,1,8,1.0,9,0.1111111111111111
9142673,2,18,2.0,20,0.1
9149908,1,9,1.0,10,0.1
9151537,8,22,8.0,30,0.26666666666666666
9185986,3,16,3.0,19,0.15789473684210525
9220314,1,19,1.0,20,0.05
9240848,1,8,1.0,9,0.1111111111111111
9253580,1,18,1.0,19,0.05263157894736842
9260929,1,9,1.0,10,0.1
9273851,2,8,2.0,10,0.2
9299458,1,9,1.0,10,0.1
9308556,5,5,5.0,10,0.5
9311712,1,8,1.0,9,0.1111111111111111
9318724,1,8,1.0,9,0.1111111111111111
9338953,1,9,1.0,10,0.1
9339988,2,7,2.0,9,0.2222222222222222
9341657,4,15,4.0,19,0.21052631578947367
9362147,1,9,1.0,10,0.1
9373666,3,7,3.0,10,0.3
9374760,1,17,1.0,18,0.05555555555555555
9396830,9,1,1.0,10,0.1
9401786,1,9,1.0,10,0.1
9401961,3,7,3.0,10,0.3
9436902,2,7,2.0,9,0.2222222222222222
9521749,1,9,1.0,10,0.1
9521926,5,4,4.0,9,0.4444444444444444
9534106,2,8,2.0,10,0.2
9534738,2,7,2.0,9,0.2222222222222222
9535373,1,9,1.0,10,0.1
9536253,1,7,1.0,8,0.125
9581608,1,7,1.0,8,0.125
9604432,5,5,5.0,10,0.5
9620943,1,18,1.0,19,0.05263157894736842
9664203,9,1,1.0,10,0.1
9666832,1,9,1.0,10,0.1
9678610,3,7,3.0,10,0.3
9678940,4,6,4.0,10,0.4
9680071,2,8,2.0,10,0.2
9681754,1,9,1.0,10,0.1
9716206,2,8,2.0,10,0.2
9722653,5,5,5.0,10,0.5
9725692,5,3,3.0,8,0.375
9735893,9,18,9.0,27,0.3333333333333333
9761129,1,9,1.0,10,0.1
9806726,2,7,2.0,9,0.2222222222222222
9810672,1,9,1.0,10,0.1
9815844,1,8,1.0,9,0.1111111111111111
9818373,1,9,1.0,10,0.1
9858487,2,8,2.0,10,0.2
9862371,1,8,1.0,9,0.1111111111111111
9875604,2,8,2.0,10,0.2
9885273,1,18,1.0,19,0.05263157894736842
9916585,4,4,4.0,8,0.5
9934407,1,8,1.0,9,0.1111111111111111
9936104,3,17,3.0,20,0.15
9944737,1,8,1.0,9,0.1111111111111111
9945512,2,8,2.0,10,0.2
9963275,5,12,5.0,17,0.29411764705882354
9969256,1,8,1.0,9,0.1111111111111111
10014218,4,6,4.0,10,0.4
10014426,4,16,4.0,20,0.2
10020786,1,19,1.0,20,0.05
10056809,1,9,1.0,10,0.1
10074898,2,8,2.0,10,0.2
10119786,1,8,1.0,9,0.1111111111111111
10131175,1,9,1.0,10,0.1
10144987,7,2,2.0,9,0.2222222222222222
10168542,1,18,1.0,19,0.05263157894736842
10169491,2,8,2.0,10,0.2
10185780,3,6,3.0,9,0.3333333333333333
10186636,5,5,5.0,10,0.5
10187064,5,5,5.0,10,0.5
10229119,1,9,1.0,10,0.1
10253580,7,3,3.0,10,0.3
10254282,2,8,2.0,10,0.2
10255042,5,4,4.0,9,0.4444444444444444
10258072,7,11,7.0,18,0.3888888888888889
10266890,8,2,2.0,10,0.2
10275650,1,18,1.0,19,0.05263157894736842
10288920,5,5,5.0,10,0.5
10307178,2,7,2.0,9,0.2222222222222222
10307564,2,8,2.0,10,0.2
10311993,2,7,2.0,9,0.2222222222222222
10316634,4,6,4.0,10,0.4
10335102,7,3,3.0,10,0.3
10337445,1,9,1.0,10,0.1
10343777,2,6,2.0,8,0.25
10346963,4,5,4.0,9,0.4444444444444444
10347678,1,8,1.0,9,0.1111111111111111
10365624,3,6,3.0,9,0.3333333333333333
10372876,4,6,4.0,10,0.4
10393751,1,17,1.0,18,0.05555555555555555
10411449,1,9,1.0,10,0.1
10424130,1,9,1.0,10,0.1
10444014,1,9,1.0,10,0.1
10445065,1,9,1.0,10,0.1
10458527,3,7,3.0,10,0.3
10470096,5,22,5.0,27,0.18518518518518517
10471642,2,8,2.0,10,0.2
10480561,1,8,1.0,9,0.1111111111111111
10493814,1,9,1.0,10,0.1
10496976,4,11,4.0,15,0.26666666666666666
10511957,1,9,1.0,10,0.1
10513330,1,8,1.0,9,0.1111111111111111
10515880,1,9,1.0,10,0.1
10528666,2,17,2.0,19,0.10526315789473684
10532150,11,19,11.0,30,0.36666666666666664
10533233,2,8,2.0,10,0.2
10550156,8,20,8.0,28,0.2857142857142857
10551712,2,17,2.0,19,0.10526315789473684
10559080,1,17,1.0,18,0.05555555555555555
10563063,4,6,4.0,10,0.4
10564118,2,8,2.0,10,0.2
10574791,3,14,3.0,17,0.17647058823529413
10586223,1,9,1.0,10,0.1
10596606,3,7,3.0,10,0.3
10600564,4,6,4.0,10,0.4
10613488,2,18,2.0,20,0.1
10620280,5,5,5.0,10,0.5
10638814,1,9,1.0,10,0.1
10654775,7,13,7.0,20,0.35
10663882,1,9,1.0,10,0.1
10711924,2,6,2.0,8,0.25
10787382,2,8,2.0,10,0.2
10809295,1,8,1.0,9,0.1111111111111111
10850951,1,9,1.0,10,0.1
10855810,1,9,1.0,10,0.1
10874189,1,8,1.0,9,0.1111111111111111
10876924,1,9,1.0,10,0.1
10900894,5,4,4.0,9,0.4444444444444444
10936236,1,18,1.0,19,0.05263157894736842
10952841,7,2,2.0,9,0.2222222222222222
10960049,1,9,1.0,10,0.1
11002481,5,5,5.0,10,0.5
11006426,4,6,4.0,10,0.4
11010978,4,5,4.0,9,0.4444444444444444
11015351,2,7,2.0,9,0.2222222222222222
11060652,1,9,1.0,10,0.1
11101612,2,6,2.0,8,0.25
11106931,1,9,1.0,10,0.1
11127070,1,8,1.0,9,0.1111111111111111
11132339,2,7,2.0,9,0.2222222222222222
11135750,4,23,4.0,27,0.14814814814814814
11162629,2,8,2.0,10,0.2
11162683,4,6,4.0,10,0.4
11187140,5,4,4.0,9,0.4444444444444444
11189184,3,7,3.0,10,0.3
11221566,1,8,1.0,9,0.1111111111111111
11238715,1,9,1.0,10,0.1
11280468,1,8,1.0,9,0.1111111111111111
11292828,1,18,1.0,19,0.05263157894736842
11356470,1,8,1.0,9,0.1111111111111111
11385805,1,8,1.0,9,0.1111111111111111
11426030,1,9,1.0,10,0.1
11436249,3,7,3.0,10,0.3
11439343,3,14,3.0,17,0.17647058823529413
11439491,1,18,1.0,19,0.05263157894736842
11452162,1,9,1.0,10,0.1
11462967,14,5,5.0,19,0.2631578947368421
11495353,1,9,1.0,10,0.1
11495491,1,7,1.0,8,0.125
11495735,3,6,3.0,9,0.3333333333333333
11495928,4,6,4.0,10,0.4
11498126,1,9,1.0,10,0.1
11498359,2,7,2.0,9,0.2222222222222222
11507472,5,5,5.0,10,0.5
11528942,7,23,7.0,30,0.23333333333333334
11573496,7,3,3.0,10,0.3
11579325,3,7,3.0,10,0.3
11585040,4,5,4.0,9,0.4444444444444444
11627302,1,9,1.0,10,0.1
11633327,1,17,1.0,18,0.05555555555555555
11673744,18,2,2.0,20,0.1
11681871,2,8,2.0,10,0.2
11687201,2,7,2.0,9,0.2222222222222222
11707105,1,9,1.0,10,0.1
11714012,1,9,1.0,10,0.1
11714246,2,27,2.0,29,0.06896551724137931
11718214,5,5,5.0,10,0.5
11720728,5,5,5.0,10,0.5
11723163,4,6,4.0,10,0.4
11726597,1,9,1.0,10,0.1
11727214,1,8,1.0,9,0.1111111111111111
11748867,7,3,3.0,10,0.3
11753197,2,18,2.0,20,0.1
11753340,2,8,2.0,10,0.2
11757947,7,3,3.0,10,0.3
11773901,2,7,2.0,9,0.2222222222222222
11794642,9,1,1.0,10,0.1
11800674,12,7,7.0,19,0.3684210526315789
11802537,4,16,4.0,20,0.2
11812079,3,7,3.0,10,0.3
11821192,3,7,3.0,10,0.3
11829970,2,8,2.0,10,0.2
11845147,1,8,1.0,9,0.1111111111111111
11847422,2,8,2.0,10,0.2
11852258,1,19,1.0,20,0.05
11878415,1,9,1.0,10,0.1
11904523,4,6,4.0,10,0.4
11957964,6,4,4.0,10,0.4
11969110,1,9,1.0,10,0.1
11970378,2,7,2.0,9,0.2222222222222222
11989150,5,13,5.0,18,0.2777777777777778
11995757,1,9,1.0,10,0.1
11995952,2,6,2.0,8,0.25
11996986,4,6,4.0,10,0.4
11997463,5,4,4.0,9,0.4444444444444444
12012614,4,22,4.0,26,0.15384615384615385
12036493,6,4,4.0,10,0.4
12036834,1,9,1.0,10,0.1
12037079,6,23,6.0,29,0.20689655172413793
12163472,1,9,1.0,10,0.1
12179805,3,13,3.0,16,0.1875
12193560,1,17,1.0,18,0.05555555555555555
12208967,4,16,4.0,20,0.2
12220663,2,8,2.0,10,0.2
12263623,1,8,1.0,9,0.1111111111111111
12305047,1,28,1.0,29,0.034482758620689655
12317938,4,6,4.0,10,0.4
12321722,1,19,1.0,20,0.05
12348023,9,1,1.0,10,0.1
12441614,1,8,1.0,9,0.1111111111111111
12476659,1,9,1.0,10,0.1
12529530,1,19,1.0,20,0.05
12549697,3,5,3.0,8,0.375
12556324,1,9,1.0,10,0.1
12566441,5,4,4.0,9,0.4444444444444444
12574555,1,19,1.0,20,0.05
12596397,5,4,4.0,9,0.4444444444444444
12626921,1,7,1.0,8,0.125
12638956,4,5,4.0,9,0.4444444444444444
12639298,2,8,2.0,10,0.2
12639381,3,7,3.0,10,0.3
12645382,1,18,1.0,19,0.05263157894736842
12673579,5,15,5.0,20,0.25
12676066,6,3,3.0,9,0.3333333333333333
12676332,1,8,1.0,9,0.1111111111111111
12678317,5,4,4.0,9,0.4444444444444444
12683372,6,4,4.0,10,0.4
12696870,5,5,5.0,10,0.5
12729384,1,9,1.0,10,0.1
12740225,2,17,2.0,19,0.10526315789473684
12768535,2,7,2.0,9,0.2222222222222222
12773284,2,7,2.0,9,0.2222222222222222
12778686,2,6,2.0,8,0.25
12807839,8,1,1.0,9,0.1111111111111111
12807978,4,6,4.0,10,0.4
12808386,12,16,12.0,28,0.42857142857142855
12816569,1,8,1.0,9,0.1111111111111111
12823018,4,4,4.0,8,0.5
12827482,1,8,1.0,9,0.1111111111111111
12835702,4,5,4.0,9,0.4444444444444444
12838931,3,6,3.0,9,0.3333333333333333
12839443,1,9,1.0,10,0.1
12861625,1,9,1.0,10,0.1
12862196,2,8,2.0,10,0.2
12862825,1,9,1.0,10,0.1
12864990,3,13,3.0,16,0.1875
12881870,4,6,4.0,10,0.4
12882735,11,17,11.0,28,0.39285714285714285
12911021,1,8,1.0,9,0.1111111111111111
12930390,2,8,2.0,10,0.2
12970810,2,8,2.0,10,0.2
12971004,1,9,1.0,10,0.1
12978585,1,8,1.0,9,0.1111111111111111
12978832,3,5,3.0,8,0.375
12978864,2,8,2.0,10,0.2
12978893,3,7,3.0,10,0.3
12978951,2,7,2.0,9,0.2222222222222222
13019178,2,18,2.0,20,0.1
13068736,1,9,1.0,10,0.1
13099407,1,9,1.0,10,0.1
13105744,1,18,1.0,19,0.05263157894736842
13161398,4,5,4.0,9,0.4444444444444444
13189331,1,8,1.0,9,0.1111111111111111
13202156,1,9,1.0,10,0.1
13203038,4,5,4.0,9,0.4444444444444444
13204994,2,17,2.0,19,0.10526315789473684
13211609,1,9,1.0,10,0.1
13240647,1,9,1.0,10,0.1
13247352,9,1,1.0,10,0.1
13247734,9,1,1.0,10,0.1
13247852,7,3,3.0,10,0.3
13262553,6,4,4.0,10,0.4
13262595,1,9,1.0,10,0.1
13272383,2,8,2.0,10,0.2
13339568,4,15,4.0,19,0.21052631578947367
13428817,1,18,1.0,19,0.05263157894736842
13451848,6,4,4.0,10,0.4
13453224,19,10,10.0,29,0.3448275862068966
13453964,1,8,1.0,9,0.1111111111111111
13453990,1,9,1.0,10,0.1
13455190,1,9,1.0,10,0.1
13455941,3,7,3.0,10,0.3
13457220,2,7,2.0,9,0.2222222222222222
13457421,3,7,3.0,10,0.3
13457588,1,9,1.0,10,0.1
13457742,2,7,2.0,9,0.2222222222222222
13458098,2,7,2.0,9,0.2222222222222222
13458289,5,4,4.0,9,0.4444444444444444
13485460,2,7,2.0,9,0.2222222222222222
13549358,2,18,2.0,20,0.1
13555211,4,6,4.0,10,0.4
13557825,2,16,2.0,18,0.1111111111111111
13561456,2,8,2.0,10,0.2
13579696,1,9,1.0,10,0.1
13586692,6,4,4.0,10,0.4
13589801,1,9,1.0,10,0.1
13594645,2,8,2.0,10,0.2
13602839,7,3,3.0,10,0.3
13612399,1,9,1.0,10,0.1
13631118,1,9,1.0,10,0.1
13634801,1,19,1.0,20,0.05
13653846,1,8,1.0,9,0.1111111111111111
13654968,3,7,3.0,10,0.3
13726677,2,17,2.0,19,0.10526315789473684
13729887,2,8,2.0,10,0.2
13738030,1,8,1.0,9,0.1111111111111111
13750384,4,6,4.0,10,0.4
13760972,2,8,2.0,10,0.2
13761965,4,6,4.0,10,0.4
13827098,2,18,2.0,20,0.1
13897335,1,28,1.0,29,0.034482758620689655
13913220,1,8,1.0,9,0.1111111111111111
13933503,4,15,4.0,19,0.21052631578947367
13933538,7,3,3.0,10,0.3
13942489,1,9,1.0,10,0.1
13942942,1,9,1.0,10,0.1
13961138,8,2,2.0,10,0.2
13961396,1,9,1.0,10,0.1
13961594,1,9,1.0,10,0.1
13962065,2,8,2.0,10,0.2
13964043,8,2,2.0,10,0.2
13964297,4,6,4.0,10,0.4
13973655,3,7,3.0,10,0.3
13981162,5,5,5.0,10,0.5
14008252,1,8,1.0,9,0.1111111111111111
14042834,2,8,2.0,10,0.2
14135664,2,16,2.0,18,0.1111111111111111
14164329,2,18,2.0,20,0.1
14185242,1,9,1.0,10,0.1
14206081,3,7,3.0,10,0.3
14216265,2,8,2.0,10,0.2
14216292,4,5,4.0,9,0.4444444444444444
14240747,8,2,2.0,10,0.2
14242297,6,4,4.0,10,0.4
14287194,2,8,2.0,10,0.2
14297595,4,15,4.0,19,0.21052631578947367
14319147,1,17,1.0,18,0.05555555555555555
14328899,1,9,1.0,10,0.1
14329245,5,5,5.0,10,0.5
14331005,4,4,4.0,8,0.5
14331158,6,3,3.0,9,0.3333333333333333
14339335,1,9,1.0,10,0.1
14363931,8,1,1.0,9,0.1111111111111111
14441986,1,9,1.0,10,0.1
14470035,1,8,1.0,9,0.1111111111111111
14471233,2,18,2.0,20,0.1
14474906,1,8,1.0,9,0.1111111111111111
14559217,1,18,1.0,19,0.05263157894736842
14567768,1,8,1.0,9,0.1111111111111111
14626127,1,8,1.0,9,0.1111111111111111
14677059,1,7,1.0,8,0.125
14722902,1,9,1.0,10,0.1
14742964,1,19,1.0,20,0.05
14746161,1,17,1.0,18,0.05555555555555555
14769182,9,1,1.0,10,0.1
14810140,1,17,1.0,18,0.05555555555555555
14841177,1,9,1.0,10,0.1
14858287,1,7,1.0,8,0.125
14871870,1,18,1.0,19,0.05263157894736842
14879496,3,7,3.0,10,0.3
14888380,6,3,3.0,9,0.3333333333333333
14889112,26,1,1.0,27,0.037037037037037035
14889558,3,7,3.0,10,0.3
14890343,4,5,4.0,9,0.4444444444444444
14891794,3,7,3.0,10,0.3
14892821,1,9,1.0,10,0.1
14898275,1,9,1.0,10,0.1
14974031,1,8,1.0,9,0.1111111111111111
15011483,1,8,1.0,9,0.1111111111111111
15041981,1,9,1.0,10,0.1
15073011,5,3,3.0,8,0.375
15075911,1,9,1.0,10,0.1
15095499,2,8,2.0,10,0.2
15119523,4,6,4.0,10,0.4
15124357,4,6,4.0,10,0.4
15124754,6,4,4.0,10,0.4
15131213,2,25,2.0,27,0.07407407407407407
15154385,5,5,5.0,10,0.5
15171639,6,4,4.0,10,0.4
15208942,26,3,3.0,29,0.10344827586206896
15209210,7,1,1.0,8,0.125
15221245,1,9,1.0,10,0.1
15223238,7,1,1.0,8,0.125
15242161,2,8,2.0,10,0.2
15242515,3,23,3.0,26,0.11538461538461539
15243943,5,23,5.0,28,0.17857142857142858
15266966,1,9,1.0,10,0.1
15267304,1,9,1.0,10,0.1
15267642,5,5,5.0,10,0.5
15267826,26,3,3.0,29,0.10344827586206896
15287880,3,7,3.0,10,0.3
15298790,3,7,3.0,10,0.3
15302782,1,9,1.0,10,0.1
15303727,6,4,4.0,10,0.4
15304342,5,14,5.0,19,0.2631578947368421
15307844,1,8,1.0,9,0.1111111111111111
15308779,2,8,2.0,10,0.2
15308950,1,9,1.0,10,0.1
15325648,1,9,1.0,10,0.1
15328165,7,3,3.0,10,0.3
15328403,6,2,2.0,8,0.25
15328560,8,2,2.0,10,0.2
15337731,2,6,2.0,8,0.25
15341970,3,7,3.0,10,0.3
15352954,2,8,2.0,10,0.2
15370893,2,8,2.0,10,0.2
15379302,1,8,1.0,9,0.1111111111111111
15401467,1,17,1.0,18,0.05555555555555555
15420680,5,5,5.0,10,0.5
15451520,4,5,4.0,9,0.4444444444444444
15456873,2,8,2.0,10,0.2
15464876,3,6,3.0,9,0.3333333333333333
15509220,2,8,2.0,10,0.2
15509443,3,7,3.0,10,0.3
15553093,3,5,3.0,8,0.375
15553102,9,1,1.0,10,0.1
15555475,1,8,1.0,9,0.1111111111111111
15559055,6,4,4.0,10,0.4
15559463,4,6,4.0,10,0.4
15559682,1,9,1.0,10,0.1
15560051,1,9,1.0,10,0.1
15562274,1,8,1.0,9,0.1111111111111111
15578040,1,8,1.0,9,0.1111111111111111
15607149,6,4,4.0,10,0.4
15610923,3,5,3.0,8,0.375
15620788,5,4,4.0,9,0.4444444444444444
15628575,2,7,2.0,9,0.2222222222222222
15635808,1,18,1.0,19,0.05263157894736842
15635983,1,8,1.0,9,0.1111111111111111
15645270,1,9,1.0,10,0.1
15654107,1,7,1.0,8,0.125
15655221,1,8,1.0,9,0.1111111111111111
15656629,1,9,1.0,10,0.1
15660772,9,1,1.0,10,0.1
15681206,2,7,2.0,9,0.2222222222222222
15699253,3,7,3.0,10,0.3
15706216,1,8,1.0,9,0.1111111111111111
15731700,1,19,1.0,20,0.05
15737763,1,18,1.0,19,0.05263157894736842
15741564,2,13,2.0,15,0.13333333333333333
15749676,1,9,1.0,10,0.1
15792822,1,9,1.0,10,0.1
15810392,15,15,15.0,30,0.5
15818818,1,8,1.0,9,0.1111111111111111
15829702,1,8,1.0,9,0.1111111111111111
15832008,1,9,1.0,10,0.1
15832566,2,28,2.0,30,0.06666666666666667
15834100,1,9,1.0,10,0.1
15834226,1,9,1.0,10,0.1
15834410,1,9,1.0,10,0.1
15839557,1,19,1.0,20,0.05
15849447,28,1,1.0,29,0.034482758620689655
15855928,5,5,5.0,10,0.5
15869001,1,9,1.0,10,0.1
15883286,4,14,4.0,18,0.2222222222222222
15884757,1,8,1.0,9,0.1111111111111111
15887017,1,8,1.0,9,0.1111111111111111
15893390,1,9,1.0,10,0.1
15925407,1,9,1.0,10,0.1
15958192,5,5,5.0,10,0.5
15960640,1,8,1.0,9,0.1111111111111111
16031917,1,19,1.0,20,0.05
16035721,1,19,1.0,20,0.05
16043876,5,5,5.0,10,0.5
16049528,1,8,1.0,9,0.1111111111111111
16126654,1,17,1.0,18,0.05555555555555555
16293075,1,19,1.0,20,0.05
16302134,1,17,1.0,18,0.05555555555555555
16308351,1,19,1.0,20,0.05
16338904,1,8,1.0,9,0.1111111111111111
16348426,2,8,2.0,10,0.2
16385099,12,7,7.0,19,0.3684210526315789
16409497,2,7,2.0,9,0.2222222222222222
16429994,2,17,2.0,19,0.10526315789473684
16438709,1,8,1.0,9,0.1111111111111111
16483780,1,8,1.0,9,0.1111111111111111
16559470,2,8,2.0,10,0.2
16601501,1,19,1.0,20,0.05
16641867,1,18,1.0,19,0.05263157894736842
16683005,1,18,1.0,19,0.05263157894736842
16696462,1,9,1.0,10,0.1
16701860,1,19,1.0,20,0.05
16703180,1,16,1.0,17,0.058823529411764705
16761157,1,8,1.0,9,0.1111111111111111
16793395,2,7,2.0,9,0.2222222222222222
16807155,1,8,1.0,9,0.1111111111111111
16841440,1,19,1.0,20,0.05
16895901,1,9,1.0,10,0.1
16917573,1,9,1.0,10,0.1
16941586,1,9,1.0,10,0.1
17010634,2,7,2.0,9,0.2222222222222222
17080657,1,8,1.0,9,0.1111111111111111
17097893,1,15,1.0,16,0.0625
17149898,25,1,1.0,26,0.038461538461538464
17160352,2,16,2.0,18,0.1111111111111111
17168816,3,7,3.0,10,0.3
17172869,8,1,1.0,9,0.1111111111111111
17205947,2,7,2.0,9,0.2222222222222222
17273583,1,17,1.0,18,0.05555555555555555
17317065,1,9,1.0,10,0.1
17380699,1,9,1.0,10,0.1
17382789,1,9,1.0,10,0.1
17395105,2,8,2.0,10,0.2
17411917,1,8,1.0,9,0.1111111111111111
17420672,2,15,2.0,17,0.11764705882352941
17478189,1,8,1.0,9,0.1111111111111111
17480642,2,8,2.0,10,0.2
17493931,5,14,5.0,19,0.2631578947368421
17497423,1,8,1.0,9,0.1111111111111111
17516230,3,7,3.0,10,0.3
17517000,1,9,1.0,10,0.1
17537878,1,9,1.0,10,0.1
17540142,2,18,2.0,20,0.1
17629722,3,7,3.0,10,0.3
17631979,1,8,1.0,9,0.1111111111111111
17641539,1,9,1.0,10,0.1
17650768,2,8,2.0,10,0.2
17722098,1,17,1.0,18,0.05555555555555555
17745568,4,6,4.0,10,0.4
17755017,3,7,3.0,10,0.3
17773949,2,6,2.0,8,0.25
17787508,1,17,1.0,18,0.05555555555555555
17790465,1,9,1.0,10,0.1
17803538,1,7,1.0,8,0.125
17833643,5,5,5.0,10,0.5
17856960,6,4,4.0,10,0.4
17866716,1,8,1.0,9,0.1111111111111111
17885808,2,17,2.0,19,0.10526315789473684
17891368,3,7,3.0,10,0.3
17910577,1,9,1.0,10,0.1
17948036,3,7,3.0,10,0.3
17951234,1,9,1.0,10,0.1
17954875,9,21,9.0,30,0.3
17956059,6,4,4.0,10,0.4
18006573,9,1,1.0,10,0.1
18014512,1,9,1.0,10,0.1
18019347,1,8,1.0,9,0.1111111111111111
18023684,3,7,3.0,10,0.3
18025390,1,9,1.0,10,0.1
18026959,1,17,1.0,18,0.05555555555555555
18033695,1,9,1.0,10,0.1
18033701,2,8,2.0,10,0.2
18033778,2,17,2.0,19,0.10526315789473684
18039508,1,8,1.0,9,0.1111111111111111
18040192,2,14,2.0,16,0.125
18056003,2,8,2.0,10,0.2
18072842,1,9,1.0,10,0.1
18079983,4,6,4.0,10,0.4
18080764,5,5,5.0,10,0.5
18081029,4,6,4.0,10,0.4
18081208,7,11,7.0,18,0.3888888888888889
18082101,2,8,2.0,10,0.2
18115539,1,9,1.0,10,0.1
18130884,1,17,1.0,18,0.05555555555555555
18139980,1,9,1.0,10,0.1
18140039,1,8,1.0,9,0.1111111111111111
18140160,4,15,4.0,19,0.21052631578947367
18164649,1,8,1.0,9,0.1111111111111111
18166050,1,19,1.0,20,0.05
18173461,1,9,1.0,10,0.1
18173564,8,2,2.0,10,0.2
18173617,9,1,1.0,10,0.1
18173671,7,2,2.0,9,0.2222222222222222
18182431,1,9,1.0,10,0.1
18182499,2,8,2.0,10,0.2
18210586,1,9,1.0,10,0.1
18216033,2,7,2.0,9,0.2222222222222222
18231027,1,19,1.0,20,0.05
18236365,1,9,1.0,10,0.1
18242968,1,9,1.0,10,0.1
18264260,2,7,2.0,9,0.2222222222222222
18271603,1,9,1.0,10,0.1
18273011,5,3,3.0,8,0.375
18276708,7,12,7.0,19,0.3684210526315789
18278418,5,5,5.0,10,0.5
18282927,1,9,1.0,10,0.1
18284709,1,8,1.0,9,0.1111111111111111
18284776,3,6,3.0,9,0.3333333333333333
18288594,1,19,1.0,20,0.05
18291100,5,13,5.0,18,0.2777777777777778
18315608,2,18,2.0,20,0.1
18317860,6,4,4.0,10,0.4
18323570,2,8,2.0,10,0.2
18323801,1,9,1.0,10,0.1
18349853,1,9,1.0,10,0.1
18358322,1,19,1.0,20,0.05
18367220,1,9,1.0,10,0.1
18380465,1,9,1.0,10,0.1
18381276,2,7,2.0,9,0.2222222222222222
18406542,1,18,1.0,19,0.05263157894736842
18417813,6,13,6.0,19,0.3157894736842105
18423104,7,3,3.0,10,0.3
18441883,1,9,1.0,10,0.1
18466855,2,16,2.0,18,0.1111111111111111
18504300,1,8,1.0,9,0.1111111111111111
18524481,1,8,1.0,9,0.1111111111111111
18535880,1,9,1.0,10,0.1
18536131,1,9,1.0,10,0.1
18536206,5,4,4.0,9,0.4444444444444444
18536577,5,4,4.0,9,0.4444444444444444
18536660,5,5,5.0,10,0.5
18537024,7,2,2.0,9,0.2222222222222222
18555916,8,19,8.0,27,0.2962962962962963
18556024,6,24,6.0,30,0.2
18562110,3,7,3.0,10,0.3
18568650,3,7,3.0,10,0.3
18570325,17,13,13.0,30,0.43333333333333335
18570501,1,9,1.0,10,0.1
18573257,2,8,2.0,10,0.2
18597501,1,9,1.0,10,0.1
18603752,7,2,2.0,9,0.2222222222222222
18606002,1,9,1.0,10,0.1
18606380,9,1,1.0,10,0.1
18610120,23,6,6.0,29,0.20689655172413793
18610514,3,7,3.0,10,0.3
18615100,1,9,1.0,10,0.1
18620240,2,18,2.0,20,0.1
18640870,2,18,2.0,20,0.1
18651650,1,9,1.0,10,0.1
18661716,2,8,2.0,10,0.2
18662356,5,5,5.0,10,0.5
18667987,5,4,4.0,9,0.4444444444444444
18669945,7,2,2.0,9,0.2222222222222222
18674888,1,8,1.0,9,0.1111111111111111
18677892,1,28,1.0,29,0.034482758620689655
18688889,4,6,4.0,10,0.4
18692968,4,6,4.0,10,0.4
18695134,6,4,4.0,10,0.4
18695381,1,7,1.0,8,0.125
18695490,1,9,1.0,10,0.1
18696130,7,21,7.0,28,0.25
18697596,3,7,3.0,10,0.3
18698803,4,4,4.0,8,0.5
18699469,1,9,1.0,10,0.1
18699658,2,27,2.0,29,0.06896551724137931
18700644,1,9,1.0,10,0.1
18701030,1,9,1.0,10,0.1
18702802,1,29,1.0,30,0.03333333333333333
18710497,8,2,2.0,10,0.2
18711494,2,8,2.0,10,0.2
18711738,4,6,4.0,10,0.4
18712308,14,14,14.0,28,0.5
18719314,1,8,1.0,9,0.1111111111111111
18724586,3,7,3.0,10,0.3
18724771,6,3,3.0,9,0.3333333333333333
18732073,3,6,3.0,9,0.3333333333333333
18739220,8,2,2.0,10,0.2
18764088,2,8,2.0,10,0.2
18766627,1,9,1.0,10,0.1
18771926,3,7,3.0,10,0.3
18776788,1,9,1.0,10,0.1
18792927,2,8,2.0,10,0.2
18798494,6,4,4.0,10,0.4
18802807,1,8,1.0,9,0.1111111111111111
18821845,1,9,1.0,10,0.1
18823799,1,18,1.0,19,0.05263157894736842
18824339,26,2,2.0,28,0.07142857142857142
18830793,2,6,2.0,8,0.25
18838617,1,8,1.0,9,0.1111111111111111
18839605,1,8,1.0,9,0.1111111111111111
18839692,4,6,4.0,10,0.4
18840405,1,9,1.0,10,0.1
18840521,2,7,2.0,9,0.2222222222222222
18840630,8,2,2.0,10,0.2
18841289,4,5,4.0,9,0.4444444444444444
18850595,4,6,4.0,10,0.4
18850903,5,5,5.0,10,0.5
18851194,3,7,3.0,10,0.3
18851800,5,5,5.0,10,0.5
18852415,7,3,3.0,10,0.3
18870228,3,7,3.0,10,0.3
18873424,2,8,2.0,10,0.2
18874013,1,9,1.0,10,0.1
18879603,2,7,2.0,9,0.2222222222222222
18901005,1,9,1.0,10,0.1
18902280,6,3,3.0,9,0.3333333333333333
18916448,1,9,1.0,10,0.1
18926737,3,7,3.0,10,0.3
18933835,4,6,4.0,10,0.4
18935791,11,8,8.0,19,0.42105263157894735
18935871,10,9,9.0,19,0.47368421052631576
18936359,10,18,10.0,28,0.35714285714285715
18936662,2,8,2.0,10,0.2
18938076,1,9,1.0,10,0.1
18938543,1,9,1.0,10,0.1
18938895,7,3,3.0,10,0.3
18942706,9,1,1.0,10,0.1
18943414,7,3,3.0,10,0.3
18946187,6,3,3.0,9,0.3333333333333333
18948810,19,10,10.0,29,0.3448275862068966
18951809,3,7,3.0,10,0.3
18980760,1,7,1.0,8,0.125
18985431,8,2,2.0,10,0.2
19008005,7,1,1.0,8,0.125
19016483,1,8,1.0,9,0.1111111111111111
19017226,8,19,8.0,27,0.2962962962962963
19030735,1,9,1.0,10,0.1
19033427,2,8,2.0,10,0.2
19033526,5,3,3.0,8,0.375
19046431,8,1,1.0,9,0.1111111111111111
19057580,1,9,1.0,10,0.1
19060641,2,8,2.0,10,0.2
19061451,3,5,3.0,8,0.375
19062504,1,7,1.0,8,0.125
19065349,1,26,1.0,27,0.037037037037037035
19070010,2,8,2.0,10,0.2
19070682,1,9,1.0,10,0.1
19117256,1,9,1.0,10,0.1
19147052,4,5,4.0,9,0.4444444444444444
19152723,1,19,1.0,20,0.05
19169720,3,7,3.0,10,0.3
19170128,21,7,7.0,28,0.25
19173930,8,1,1.0,9,0.1111111111111111
19188457,5,14,5.0,19,0.2631578947368421
19192173,3,7,3.0,10,0.3
19194603,1,8,1.0,9,0.1111111111111111
19196590,4,5,4.0,9,0.4444444444444444
19197390,1,8,1.0,9,0.1111111111111111
19199151,3,7,3.0,10,0.3
19202640,2,8,2.0,10,0.2
19202968,1,9,1.0,10,0.1
19203754,2,8,2.0,10,0.2
19210269,3,6,3.0,9,0.3333333333333333
19211782,1,9,1.0,10,0.1
19212220,1,9,1.0,10,0.1
19215854,6,20,6.0,26,0.23076923076923078
19218489,4,4,4.0,8,0.5
19221137,1,17,1.0,18,0.05555555555555555
19231730,1,19,1.0,20,0.05
19242294,3,7,3.0,10,0.3
19255638,1,9,1.0,10,0.1
19255986,5,5,5.0,10,0.5
19257086,4,6,4.0,10,0.4
19261681,1,28,1.0,29,0.034482758620689655
19268430,9,1,1.0,10,0.1
19268710,1,9,1.0,10,0.1
19269525,2,8,2.0,10,0.2
19270449,6,23,6.0,29,0.20689655172413793
19270752,2,27,2.0,29,0.06896551724137931
19276464,1,16,1.0,17,0.058823529411764705
19278789,6,3,3.0,9,0.3333333333333333
19282058,1,28,1.0,29,0.034482758620689655
19282280,2,8,2.0,10,0.2
19284626,3,17,3.0,20,0.15
19286135,1,8,1.0,9,0.1111111111111111
19288386,5,5,5.0,10,0.5
19289010,5,4,4.0,9,0.4444444444444444
19289135,1,8,1.0,9,0.1111111111111111
19296632,3,17,3.0,20,0.15
19298224,3,7,3.0,10,0.3
19298502,3,7,3.0,10,0.3
19316440,1,9,1.0,10,0.1
19321680,5,5,5.0,10,0.5
19322504,1,8,1.0,9,0.1111111111111111
19323316,3,16,3.0,19,0.15789473684210525
19324577,2,8,2.0,10,0.2
19325731,2,18,2.0,20,0.1
19335189,5,5,5.0,10,0.5
19335887,1,9,1.0,10,0.1
19336459,2,8,2.0,10,0.2
19337823,1,9,1.0,10,0.1
19342264,1,9,1.0,10,0.1
19343415,6,20,6.0,26,0.23076923076923078
19343539,1,9,1.0,10,0.1
19350760,4,6,4.0,10,0.4
19354280,1,8,1.0,9,0.1111111111111111
19354865,2,8,2.0,10,0.2
19358319,2,7,2.0,9,0.2222222222222222
19395290,1,9,1.0,10,0.1
19411557,2,17,2.0,19,0.10526315789473684
19421241,6,3,3.0,9,0.3333333333333333
19442623,1,9,1.0,10,0.1
19457273,3,7,3.0,10,0.3
19466174,1,9,1.0,10,0.1
19470946,1,8,1.0,9,0.1111111111111111
19478368,1,8,1.0,9,0.1111111111111111
19479498,2,8,2.0,10,0.2
19481612,1,9,1.0,10,0.1
19481781,1,8,1.0,9,0.1111111111111111
19504662,1,9,1.0,10,0.1
19513269,8,1,1.0,9,0.1111111111111111
19527599,1,19,1.0,20,0.05
19529883,3,7,3.0,10,0.3
19536535,4,16,4.0,20,0.2
19544230,2,7,2.0,9,0.2222222222222222
19563606,1,8,1.0,9,0.1111111111111111
19568896,13,16,13.0,29,0.4482758620689655
19572908,3,7,3.0,10,0.3
19573679,1,8,1.0,9,0.1111111111111111
19575545,4,6,4.0,10,0.4
19576467,2,8,2.0,10,0.2
19576721,2,7,2.0,9,0.2222222222222222
19591869,2,18,2.0,20,0.1
19598796,1,9,1.0,10,0.1
19611150,7,3,3.0,10,0.3
19619726,1,9,1.0,10,0.1
19620411,5,5,5.0,10,0.5
19620467,4,5,4.0,9,0.4444444444444444
19620901,7,3,3.0,10,0.3
19632494,4,6,4.0,10,0.4
19654879,5,5,5.0,10,0.5
19658213,3,6,3.0,9,0.3333333333333333
19660378,1,19,1.0,20,0.05
19664435,1,9,1.0,10,0.1
19675417,1,9,1.0,10,0.1
19679876,4,4,4.0,8,0.5
19688491,7,2,2.0,9,0.2222222222222222
19701412,1,8,1.0,9,0.1111111111111111
19702603,1,9,1.0,10,0.1
19703573,4,4,4.0,8,0.5
19703624,1,8,1.0,9,0.1111111111111111
19710122,1,9,1.0,10,0.1
19733868,3,6,3.0,9,0.3333333333333333
19738476,8,2,2.0,10,0.2
19739494,1,18,1.0,19,0.05263157894736842
19741594,1,19,1.0,20,0.05
19747243,28,1,1.0,29,0.034482758620689655
19748654,6,4,4.0,10,0.4
19755127,1,9,1.0,10,0.1
19771232,1,9,1.0,10,0.1
19779586,1,9,1.0,10,0.1
19780273,1,8,1.0,9,0.1111111111111111
19809694,5,4,4.0,9,0.4444444444444444
19817520,6,23,6.0,29,0.20689655172413793
19819491,7,3,3.0,10,0.3
19823380,1,9,1.0,10,0.1
19823508,1,9,1.0,10,0.1
19826891,1,8,1.0,9,0.1111111111111111
19829810,1,27,1.0,28,0.03571428571428571
19831262,1,9,1.0,10,0.1
19832876,4,5,4.0,9,0.4444444444444444
19834026,2,8,2.0,10,0.2
19843446,3,7,3.0,10,0.3
19845324,1,9,1.0,10,0.1
19855235,1,9,1.0,10,0.1
19858994,1,7,1.0,8,0.125
19860513,1,8,1.0,9,0.1111111111111111
19860636,1,9,1.0,10,0.1
19870083,1,9,1.0,10,0.1
19884450,1,8,1.0,9,0.1111111111111111
19885104,1,9,1.0,10,0.1
19885227,3,5,3.0,8,0.375
19888878,1,9,1.0,10,0.1
19889561,1,8,1.0,9,0.1111111111111111
19893102,3,6,3.0,9,0.3333333333333333
19895963,7,3,3.0,10,0.3
19921941,1,9,1.0,10,0.1
19932705,3,7,3.0,10,0.3
19933204,2,8,2.0,10,0.2
19935447,1,8,1.0,9,0.1111111111111111
19935964,3,7,3.0,10,0.3
19935997,2,16,2.0,18,0.1111111111111111
19936203,2,7,2.0,9,0.2222222222222222
19937269,1,9,1.0,10,0.1
19943482,1,9,1.0,10,0.1
19944648,3,6,3.0,9,0.3333333333333333
19950192,1,8,1.0,9,0.1111111111111111
19953806,2,8,2.0,10,0.2
19977424,1,8,1.0,9,0.1111111111111111
19977923,1,9,1.0,10,0.1
19989390,1,9,1.0,10,0.1
20015635,5,5,5.0,10,0.5
20016461,2,8,2.0,10,0.2
20024114,4,6,4.0,10,0.4
20030220,1,18,1.0,19,0.05263157894736842
20035868,8,2,2.0,10,0.2
20063936,1,8,1.0,9,0.1111111111111111
20066189,1,9,1.0,10,0.1
20069695,6,4,4.0,10,0.4
20070567,2,7,2.0,9,0.2222222222222222
20092141,1,19,1.0,20,0.05
20133963,1,8,1.0,9,0.1111111111111111
20138271,1,9,1.0,10,0.1
20152196,1,8,1.0,9,0.1111111111111111
20155374,3,7,3.0,10,0.3
20155643,3,7,3.0,10,0.3
20157017,27,2,2.0,29,0.06896551724137931
20157212,1,9,1.0,10,0.1
20162592,3,6,3.0,9,0.3333333333333333
20162759,1,9,1.0,10,0.1
20171176,2,7,2.0,9,0.2222222222222222
20173070,1,8,1.0,9,0.1111111111111111
20173808,2,8,2.0,10,0.2
20174353,5,5,5.0,10,0.5
20197625,5,5,5.0,10,0.5
20200805,6,4,4.0,10,0.4
20220237,1,7,1.0,8,0.125
20227591,1,18,1.0,19,0.05263157894736842
20228948,3,7,3.0,10,0.3
20240434,1,7,1.0,8,0.125
20293564,1,9,1.0,10,0.1
20308624,1,8,1.0,9,0.1111111111111111
20362859,1,16,1.0,17,0.058823529411764705
20369745,2,6,2.0,8,0.25
20383864,1,9,1.0,10,0.1
20391101,4,5,4.0,9,0.4444444444444444
20396619,8,1,1.0,9,0.1111111111111111
20438921,16,3,3.0,19,0.15789473684210525
20456166,1,9,1.0,10,0.1
20456531,3,6,3.0,9,0.3333333333333333
20464484,1,9,1.0,10,0.1
20497929,1,9,1.0,10,0.1
20498407,3,6,3.0,9,0.3333333333333333
20524328,1,8,1.0,9,0.1111111111111111
20526003,3,7,3.0,10,0.3
20540176,4,6,4.0,10,0.4
20560815,2,16,2.0,18,0.1111111111111111
20561390,1,8,1.0,9,0.1111111111111111
20569049,3,7,3.0,10,0.3
20572751,2,8,2.0,10,0.2
20572789,2,7,2.0,9,0.2222222222222222
20577044,2,16,2.0,18,0.1111111111111111
20577679,12,6,6.0,18,0.3333333333333333
20577779,6,4,4.0,10,0.4
20594900,2,8,2.0,10,0.2
20595504,1,9,1.0,10,0.1
20597263,1,8,1.0,9,0.1111111111111111
20597379,1,9,1.0,10,0.1
20611657,1,9,1.0,10,0.1
20616189,24,4,4.0,28,0.14285714285714285
20620632,20,10,10.0,30,0.3333333333333333
20624915,2,8,2.0,10,0.2
20630459,1,8,1.0,9,0.1111111111111111
20630501,1,8,1.0,9,0.1111111111111111
20633724,1,9,1.0,10,0.1
20640070,7,3,3.0,10,0.3
20650505,1,9,1.0,10,0.1
20652620,1,15,1.0,16,0.0625
20655372,1,9,1.0,10,0.1
20655446,1,9,1.0,10,0.1
20670514,1,8,1.0,9,0.1111111111111111
20671966,2,8,2.0,10,0.2
20675601,4,6,4.0,10,0.4
20681451,1,19,1.0,20,0.05
20686972,6,4,4.0,10,0.4
20714670,1,19,1.0,20,0.05
20739667,1,9,1.0,10,0.1
20776029,1,18,1.0,19,0.05263157894736842
20793069,8,1,1.0,9,0.1111111111111111
20793307,5,4,4.0,9,0.4444444444444444
20793653,6,4,4.0,10,0.4
20795448,1,8,1.0,9,0.1111111111111111
20795627,2,16,2.0,18,0.1111111111111111
20810923,5,5,5.0,10,0.5
20811112,3,6,3.0,9,0.3333333333333333
20811937,6,4,4.0,10,0.4
20813396,2,8,2.0,10,0.2
20813689,1,9,1.0,10,0.1
20818276,4,5,4.0,9,0.4444444444444444
20820600,7,2,2.0,9,0.2222222222222222
20846722,2,7,2.0,9,0.2222222222222222
20860788,3,6,3.0,9,0.3333333333333333
20863547,3,7,3.0,10,0.3
20865234,2,7,2.0,9,0.2222222222222222
20868436,6,4,4.0,10,0.4
20868691,1,9,1.0,10,0.1
20910450,11,15,11.0,26,0.4230769230769231
20917397,6,23,6.0,29,0.20689655172413793
20936622,3,6,3.0,9,0.3333333333333333
20937230,1,9,1.0,10,0.1
20955197,1,9,1.0,10,0.1
20955852,1,28,1.0,29,0.034482758620689655
20958691,3,6,3.0,9,0.3333333333333333
20964040,1,9,1.0,10,0.1
20974521,2,8,2.0,10,0.2
21001835,1,9,1.0,10,0.1
21002547,6,21,6.0,27,0.2222222222222222
21005242,5,4,4.0,9,0.4444444444444444
21040875,2,7,2.0,9,0.2222222222222222
21044481,2,7,2.0,9,0.2222222222222222
21049821,6,3,3.0,9,0.3333333333333333
21050703,9,1,1.0,10,0.1
21072014,1,18,1.0,19,0.05263157894736842
21072381,8,1,1.0,9,0.1111111111111111
21082281,1,25,1.0,26,0.038461538461538464
21108506,1,8,1.0,9,0.1111111111111111
21113982,5,5,5.0,10,0.5
21150437,2,8,2.0,10,0.2
21155438,1,9,1.0,10,0.1
21156924,3,7,3.0,10,0.3
21157651,1,9,1.0,10,0.1
21159434,1,9,1.0,10,0.1
21212565,1,7,1.0,8,0.125
21213751,3,7,3.0,10,0.3
21223177,6,4,4.0,10,0.4
21227980,5,4,4.0,9,0.4444444444444444
21231773,5,3,3.0,8,0.375
21240062,9,1,1.0,10,0.1
21242258,4,5,4.0,9,0.4444444444444444
21248003,2,7,2.0,9,0.2222222222222222
21249555,2,7,2.0,9,0.2222222222222222
21270323,7,1,1.0,8,0.125
21271322,3,7,3.0,10,0.3
21271625,2,8,2.0,10,0.2
21273330,5,15,5.0,20,0.25
21276240,1,17,1.0,18,0.05555555555555555
21277469,5,5,5.0,10,0.5
21281928,1,9,1.0,10,0.1
21283579,8,2,2.0,10,0.2
21294258,1,9,1.0,10,0.1
21295277,3,6,3.0,9,0.3333333333333333
21297979,9,18,9.0,27,0.3333333333333333
21318767,4,5,4.0,9,0.4444444444444444
21319268,20,7,7.0,27,0.25925925925925924
21325038,3,6,3.0,9,0.3333333333333333
21325151,1,8,1.0,9,0.1111111111111111
21366104,4,6,4.0,10,0.4
21379382,5,3,3.0,8,0.375
21385747,7,3,3.0,10,0.3
21387430,2,8,2.0,10,0.2
21388170,8,1,1.0,9,0.1111111111111111
21388175,27,2,2.0,29,0.06896551724137931
21403851,2,6,2.0,8,0.25
21405568,2,6,2.0,8,0.25
21405832,5,5,5.0,10,0.5
21405868,3,7,3.0,10,0.3
21461705,17,2,2.0,19,0.10526315789473684
21518819,2,8,2.0,10,0.2
21535444,1,8,1.0,9,0.1111111111111111
21549142,1,8,1.0,9,0.1111111111111111
21559365,1,9,1.0,10,0.1
21565715,24,3,3.0,27,0.1111111111111111
21585045,1,8,1.0,9,0.1111111111111111
21591381,2,7,2.0,9,0.2222222222222222
21597141,1,27,1.0,28,0.03571428571428571
21612709,1,17,1.0,18,0.05555555555555555
21614786,2,7,2.0,9,0.2222222222222222
21642424,25,4,4.0,29,0.13793103448275862
21653454,8,22,8.0,30,0.26666666666666666
21671588,8,2,2.0,10,0.2
21684416,3,6,3.0,9,0.3333333333333333
21719938,2,7,2.0,9,0.2222222222222222
21720541,2,8,2.0,10,0.2
21726466,1,9,1.0,10,0.1
21727778,4,6,4.0,10,0.4
21728427,2,18,2.0,20,0.1
21728948,3,6,3.0,9,0.3333333333333333
21731125,6,4,4.0,10,0.4
21735658,25,4,4.0,29,0.13793103448275862
21738177,3,7,3.0,10,0.3
21738332,8,1,1.0,9,0.1111111111111111
21743312,2,7,2.0,9,0.2222222222222222
21744570,1,8,1.0,9,0.1111111111111111
21744967,2,8,2.0,10,0.2
21754146,3,7,3.0,10,0.3
21762701,3,7,3.0,10,0.3
21768962,1,17,1.0,18,0.05555555555555555
21779036,2,8,2.0,10,0.2
21779079,5,5,5.0,10,0.5
21779267,1,17,1.0,18,0.05555555555555555
21780278,3,25,3.0,28,0.10714285714285714
21782806,9,18,9.0,27,0.3333333333333333
21785108,5,3,3.0,8,0.375
21785642,4,6,4.0,10,0.4
21786174,3,7,3.0,10,0.3
21786278,2,8,2.0,10,0.2
21795522,2,8,2.0,10,0.2
21804987,2,7,2.0,9,0.2222222222222222
21806246,4,15,4.0,19,0.21052631578947367
21813271,2,8,2.0,10,0.2
21819900,1,18,1.0,19,0.05263157894736842
21835036,4,6,4.0,10,0.4
21835067,1,9,1.0,10,0.1
21835282,3,7,3.0,10,0.3
21835344,3,7,3.0,10,0.3
21835477,2,7,2.0,9,0.2222222222222222
21839924,2,7,2.0,9,0.2222222222222222
21845606,2,8,2.0,10,0.2
21870616,1,9,1.0,10,0.1
21873381,10,18,10.0,28,0.35714285714285715
21885773,1,17,1.0,18,0.05555555555555555
21887120,3,15,3.0,18,0.16666666666666666
21896728,2,17,2.0,19,0.10526315789473684
21898090,2,8,2.0,10,0.2
21898692,6,3,3.0,9,0.3333333333333333
21898735,9,1,1.0,10,0.1
21901674,1,8,1.0,9,0.1111111111111111
21906373,1,9,1.0,10,0.1
21907739,7,20,7.0,27,0.25925925925925924
21923803,2,7,2.0,9,0.2222222222222222
21925255,6,3,3.0,9,0.3333333333333333
21928696,6,3,3.0,9,0.3333333333333333
21929764,9,1,1.0,10,0.1
21930394,5,5,5.0,10,0.5
21934346,5,5,5.0,10,0.5
21935866,1,8,1.0,9,0.1111111111111111
21968831,1,17,1.0,18,0.05555555555555555
21972134,1,9,1.0,10,0.1
21982326,1,9,1.0,10,0.1
21985340,6,3,3.0,9,0.3333333333333333
21993455,1,8,1.0,9,0.1111111111111111
22000326,4,6,4.0,10,0.4
22027024,2,8,2.0,10,0.2
22045114,1,8,1.0,9,0.1111111111111111
22054851,1,17,1.0,18,0.05555555555555555
22072436,4,6,4.0,10,0.4
22073538,5,4,4.0,9,0.4444444444444444
22082279,6,4,4.0,10,0.4
22082335,5,5,5.0,10,0.5
22082400,6,4,4.0,10,0.4
22082567,2,8,2.0,10,0.2
22082942,6,4,4.0,10,0.4
22082995,3,16,3.0,19,0.15789473684210525
22092161,2,7,2.0,9,0.2222222222222222
22092902,1,29,1.0,30,0.03333333333333333
22093928,2,7,2.0,9,0.2222222222222222
22094377,4,6,4.0,10,0.4
22103134,14,5,5.0,19,0.2631578947368421
22132860,1,8,1.0,9,0.1111111111111111
22150247,1,8,1.0,9,0.1111111111111111
22154481,23,5,5.0,28,0.17857142857142858
22162181,5,5,5.0,10,0.5
22203351,2,8,2.0,10,0.2
22213628,5,5,5.0,10,0.5
22218414,3,7,3.0,10,0.3
22221597,7,3,3.0,10,0.3
22235429,2,15,2.0,17,0.11764705882352941
22248271,5,4,4.0,9,0.4444444444444444
22256402,1,19,1.0,20,0.05
22265258,6,4,4.0,10,0.4
22266565,3,7,3.0,10,0.3
22267805,1,8,1.0,9,0.1111111111111111
22277145,1,7,1.0,8,0.125
22299966,2,8,2.0,10,0.2
22312822,2,27,2.0,29,0.06896551724137931
22325734,3,27,3.0,30,0.1
22358485,2,8,2.0,10,0.2
22362729,8,1,1.0,9,0.1111111111111111
22380293,1,18,1.0,19,0.05263157894736842
22386518,2,8,2.0,10,0.2
22406346,1,9,1.0,10,0.1
22419601,1,8,1.0,9,0.1111111111111111
22420336,5,5,5.0,10,0.5
22441611,1,9,1.0,10,0.1
22442331,2,8,2.0,10,0.2
22443002,2,7,2.0,9,0.2222222222222222
22443561,1,8,1.0,9,0.1111111111111111
22443638,5,24,5.0,29,0.1724137931034483
22448624,2,8,2.0,10,0.2
22455813,1,9,1.0,10,0.1
22456796,17,2,2.0,19,0.10526315789473684
22457181,7,3,3.0,10,0.3
22472366,1,18,1.0,19,0.05263157894736842
22476317,2,16,2.0,18,0.1111111111111111
22480556,4,6,4.0,10,0.4
22489715,1,9,1.0,10,0.1
22507836,1,17,1.0,18,0.05555555555555555
22513352,2,8,2.0,10,0.2
22514235,3,7,3.0,10,0.3
22525762,8,2,2.0,10,0.2
22525956,29,1,1.0,30,0.03333333333333333
22526060,3,6,3.0,9,0.3333333333333333
22526202,4,5,4.0,9,0.4444444444444444
22535248,1,9,1.0,10,0.1
22542333,4,6,4.0,10,0.4
22542583,5,4,4.0,9,0.4444444444444444
22545890,8,2,2.0,10,0.2
22546584,8,1,1.0,9,0.1111111111111111
22546697,9,1,1.0,10,0.1
22546903,3,7,3.0,10,0.3
22548035,1,9,1.0,10,0.1
22552492,1,8,1.0,9,0.1111111111111111
22553169,2,7,2.0,9,0.2222222222222222
22553690,2,8,2.0,10,0.2
22572371,9,1,1.0,10,0.1
22577077,2,8,2.0,10,0.2
22591729,1,9,1.0,10,0.1
22614366,2,7,2.0,9,0.2222222222222222
22619507,4,6,4.0,10,0.4
22619531,2,8,2.0,10,0.2
22622937,4,6,4.0,10,0.4
22633652,8,2,2.0,10,0.2
22648821,1,8,1.0,9,0.1111111111111111
22650105,1,8,1.0,9,0.1111111111111111
22653707,2,8,2.0,10,0.2
22661151,3,6,3.0,9,0.3333333333333333
22665526,2,7,2.0,9,0.2222222222222222
22667630,1,19,1.0,20,0.05
22675720,1,8,1.0,9,0.1111111111111111
22691605,1,9,1.0,10,0.1
22697014,1,7,1.0,8,0.125
22698481,2,6,2.0,8,0.25
22704452,1,9,1.0,10,0.1
22719816,1,9,1.0,10,0.1
22720856,1,9,1.0,10,0.1
22722518,1,9,1.0,10,0.1
22777264,1,8,1.0,9,0.1111111111111111
22777551,1,9,1.0,10,0.1
22797906,1,8,1.0,9,0.1111111111111111
22800157,7,3,3.0,10,0.3
22802848,1,8,1.0,9,0.1111111111111111
22804604,2,7,2.0,9,0.2222222222222222
22836331,1,9,1.0,10,0.1
22855834,1,9,1.0,10,0.1
22860626,9,1,1.0,10,0.1
22863605,4,5,4.0,9,0.4444444444444444
22870467,2,8,2.0,10,0.2
22872304,8,1,1.0,9,0.1111111111111111
22876452,1,9,1.0,10,0.1
22878230,4,6,4.0,10,0.4
22879548,3,6,3.0,9,0.3333333333333333
22880227,10,16,10.0,26,0.38461538461538464
22883443,7,2,2.0,9,0.2222222222222222
22887234,2,7,2.0,9,0.2222222222222222
22903684,2,6,2.0,8,0.25
22912305,2,8,2.0,10,0.2
22936088,2,8,2.0,10,0.2
22937720,1,8,1.0,9,0.1111111111111111
22938316,1,9,1.0,10,0.1
22958042,1,8,1.0,9,0.1111111111111111
22979228,1,9,1.0,10,0.1
22998866,1,8,1.0,9,0.1111111111111111
23006762,1,9,1.0,10,0.1
23020659,5,4,4.0,9,0.4444444444444444
23020982,8,2,2.0,10,0.2
23067926,2,7,2.0,9,0.2222222222222222
23074449,6,3,3.0,9,0.3333333333333333
23074810,4,24,4.0,28,0.14285714285714285
23103819,1,9,1.0,10,0.1
23138616,3,17,3.0,20,0.15
23139485,2,8,2.0,10,0.2
23142389,5,5,5.0,10,0.5
23142982,4,6,4.0,10,0.4
23179159,1,9,1.0,10,0.1
23185414,1,8,1.0,9,0.1111111111111111
23199131,3,6,3.0,9,0.3333333333333333
23205112,1,9,1.0,10,0.1
23222285,1,8,1.0,9,0.1111111111111111
23251663,2,8,2.0,10,0.2
23264477,2,6,2.0,8,0.25
23276263,2,7,2.0,9,0.2222222222222222
23309464,4,5,4.0,9,0.4444444444444444
23323569,8,1,1.0,9,0.1111111111111111
23323923,7,2,2.0,9,0.2222222222222222
23324835,1,19,1.0,20,0.05
23327456,12,8,8.0,20,0.4
23340193,3,7,3.0,10,0.3
23361955,19,10,10.0,29,0.3448275862068966
23368348,2,7,2.0,9,0.2222222222222222
23374732,4,4,4.0,8,0.5
23384511,2,7,2.0,9,0.2222222222222222
23395709,3,7,3.0,10,0.3
23420956,2,7,2.0,9,0.2222222222222222
23424287,4,5,4.0,9,0.4444444444444444
23425879,1,9,1.0,10,0.1
23460321,2,8,2.0,10,0.2
23461421,1,8,1.0,9,0.1111111111111111
23467989,3,7,3.0,10,0.3
23469584,2,8,2.0,10,0.2
23474379,7,1,1.0,8,0.125
23474542,9,1,1.0,10,0.1
23479528,6,4,4.0,10,0.4
23485311,4,6,4.0,10,0.4
23486186,1,9,1.0,10,0.1
23486488,1,8,1.0,9,0.1111111111111111
23491137,7,13,7.0,20,0.35
23495058,3,16,3.0,19,0.15789473684210525
23498269,3,7,3.0,10,0.3
23517768,2,8,2.0,10,0.2
23525565,1,8,1.0,9,0.1111111111111111
23525772,2,8,2.0,10,0.2
23526517,6,3,3.0,9,0.3333333333333333
23529508,3,7,3.0,10,0.3
23531296,1,9,1.0,10,0.1
23532109,3,7,3.0,10,0.3
23532301,1,9,1.0,10,0.1
23534262,1,8,1.0,9,0.1111111111111111
23534759,2,8,2.0,10,0.2
23536027,1,9,1.0,10,0.1
23536943,1,9,1.0,10,0.1
23537597,2,8,2.0,10,0.2
23541584,1,7,1.0,8,0.125
23543111,4,6,4.0,10,0.4
23570827,1,9,1.0,10,0.1
23571038,1,9,1.0,10,0.1
23571489,2,7,2.0,9,0.2222222222222222
23571761,3,7,3.0,10,0.3
23590628,2,17,2.0,19,0.10526315789473684
23599201,1,16,1.0,17,0.058823529411764705
23599986,1,8,1.0,9,0.1111111111111111
23645499,2,7,2.0,9,0.2222222222222222
23648468,4,26,4.0,30,0.13333333333333333
23650772,3,6,3.0,9,0.3333333333333333
23655442,2,7,2.0,9,0.2222222222222222
23677598,5,23,5.0,28,0.17857142857142858
23679560,3,7,3.0,10,0.3
23688191,1,9,1.0,10,0.1
23694665,9,1,1.0,10,0.1
23712376,2,8,2.0,10,0.2
23723042,1,9,1.0,10,0.1
23738170,2,6,2.0,8,0.25
23738589,4,6,4.0,10,0.4
23751748,1,9,1.0,10,0.1
23751934,5,4,4.0,9,0.4444444444444444
23754666,6,3,3.0,9,0.3333333333333333
23755223,7,3,3.0,10,0.3
23755269,1,9,1.0,10,0.1
23770040,2,8,2.0,10,0.2
23770365,22,5,5.0,27,0.18518518518518517
23770413,21,8,8.0,29,0.27586206896551724
23782418,7,13,7.0,20,0.35
23800013,1,8,1.0,9,0.1111111111111111
23806863,1,9,1.0,10,0.1
23809181,2,27,2.0,29,0.06896551724137931
23809967,1,8,1.0,9,0.1111111111111111
23810815,3,7,3.0,10,0.3
23827993,1,9,1.0,10,0.1
23878672,4,6,4.0,10,0.4
23898601,1,9,1.0,10,0.1
23913065,3,7,3.0,10,0.3
23940653,3,6,3.0,9,0.3333333333333333
23940838,1,9,1.0,10,0.1
23943153,4,6,4.0,10,0.4
23956916,4,5,4.0,9,0.4444444444444444
23961040,2,7,2.0,9,0.2222222222222222
23961159,2,7,2.0,9,0.2222222222222222
23963592,4,6,4.0,10,0.4
23971284,2,8,2.0,10,0.2
23971728,1,9,1.0,10,0.1
23972299,1,9,1.0,10,0.1
23972535,1,9,1.0,10,0.1
23974055,4,6,4.0,10,0.4
23974235,5,5,5.0,10,0.5
23999576,18,11,11.0,29,0.3793103448275862
24000816,1,9,1.0,10,0.1
24003269,4,6,4.0,10,0.4
24027393,2,7,2.0,9,0.2222222222222222
24033293,3,6,3.0,9,0.3333333333333333
24035181,2,7,2.0,9,0.2222222222222222
24042662,6,4,4.0,10,0.4
24053937,3,7,3.0,10,0.3
24055027,1,18,1.0,19,0.05263157894736842
24057555,8,2,2.0,10,0.2
24084064,2,8,2.0,10,0.2
24084447,1,9,1.0,10,0.1
24084663,1,9,1.0,10,0.1
24092108,1,9,1.0,10,0.1
24093793,3,6,3.0,9,0.3333333333333333
24105877,4,15,4.0,19,0.21052631578947367
24109937,7,2,2.0,9,0.2222222222222222
24118417,4,5,4.0,9,0.4444444444444444
24126651,2,6,2.0,8,0.25
24142564,1,8,1.0,9,0.1111111111111111
24149601,1,8,1.0,9,0.1111111111111111
24167476,2,18,2.0,20,0.1
24175560,2,8,2.0,10,0.2
24181214,1,8,1.0,9,0.1111111111111111
24209521,1,9,1.0,10,0.1
24216598,3,5,3.0,8,0.375
24228435,1,19,1.0,20,0.05
24245356,1,9,1.0,10,0.1
24255196,1,8,1.0,9,0.1111111111111111
24269053,2,7,2.0,9,0.2222222222222222
24269095,1,9,1.0,10,0.1
24284368,18,12,12.0,30,0.4
24288032,4,5,4.0,9,0.4444444444444444
24302264,1,9,1.0,10,0.1
24312677,1,19,1.0,20,0.05
24409570,1,17,1.0,18,0.05555555555555555
24413312,5,4,4.0,9,0.4444444444444444
24414215,2,8,2.0,10,0.2
24414536,3,6,3.0,9,0.3333333333333333
24417872,1,8,1.0,9,0.1111111111111111
24420551,4,6,4.0,10,0.4
24426264,3,26,3.0,29,0.10344827586206896
24426701,2,8,2.0,10,0.2
24429956,7,2,2.0,9,0.2222222222222222
24432631,2,6,2.0,8,0.25
24461763,1,8,1.0,9,0.1111111111111111
24462036,2,7,2.0,9,0.2222222222222222
24464221,9,1,1.0,10,0.1
24487452,3,7,3.0,10,0.3
24503972,5,5,5.0,10,0.5
24509361,4,6,4.0,10,0.4
24509777,8,2,2.0,10,0.2
24519866,2,7,2.0,9,0.2222222222222222
24544826,2,8,2.0,10,0.2
24646599,1,38,1.0,39,0.02564102564102564
24647267,4,31,4.0,35,0.11428571428571428
24665343,2,18,2.0,20,0.1
24666735,3,16,3.0,19,0.15789473684210525
24739834,1,19,1.0,20,0.05
24741557,1,9,1.0,10,0.1
24748491,2,8,2.0,10,0.2
24749800,1,9,1.0,10,0.1
24754835,1,9,1.0,10,0.1
24757539,11,17,11.0,28,0.39285714285714285
24758655,3,27,3.0,30,0.1
24765821,2,8,2.0,10,0.2
24777589,8,1,1.0,9,0.1111111111111111
24811951,1,17,1.0,18,0.05555555555555555
24836735,3,6,3.0,9,0.3333333333333333
24853824,2,8,2.0,10,0.2
24870859,3,7,3.0,10,0.3
24896449,6,14,6.0,20,0.3
24902484,1,19,1.0,20,0.05
24914619,2,8,2.0,10,0.2
24915520,4,15,4.0,19,0.21052631578947367
24918525,8,1,1.0,9,0.1111111111111111
24970985,5,5,5.0,10,0.5
24990650,1,8,1.0,9,0.1111111111111111
25002633,1,9,1.0,10,0.1
25002885,1,28,1.0,29,0.034482758620689655
25003944,1,9,1.0,10,0.1
25004234,5,5,5.0,10,0.5
25005744,2,17,2.0,19,0.10526315789473684
25006854,3,17,3.0,20,0.15
25007610,3,7,3.0,10,0.3
25016934,1,8,1.0,9,0.1111111111111111
25021802,1,8,1.0,9,0.1111111111111111
25023759,3,17,3.0,20,0.15
25028084,8,11,8.0,19,0.42105263157894735
25028316,1,9,1.0,10,0.1
25055936,1,8,1.0,9,0.1111111111111111
25135083,1,9,1.0,10,0.1
25160068,1,7,1.0,8,0.125
25166809,5,3,3.0,8,0.375
25174253,1,8,1.0,9,0.1111111111111111
25181043,2,16,2.0,18,0.1111111111111111
25192881,1,8,1.0,9,0.1111111111111111
25195923,2,7,2.0,9,0.2222222222222222
25201314,1,9,1.0,10,0.1
25214999,1,8,1.0,9,0.1111111111111111
25271408,1,9,1.0,10,0.1
25278068,7,1,1.0,8,0.125
25293246,2,8,2.0,10,0.2
25305753,1,8,1.0,9,0.1111111111111111
25325879,9,1,1.0,10,0.1
25371031,7,3,3.0,10,0.3
25400971,8,1,1.0,9,0.1111111111111111
25401346,1,9,1.0,10,0.1
25402360,2,8,2.0,10,0.2
25402571,2,8,2.0,10,0.2
25402780,1,9,1.0,10,0.1
25405629,4,5,4.0,9,0.4444444444444444
25420799,1,9,1.0,10,0.1
25429532,2,8,2.0,10,0.2
25461468,1,9,1.0,10,0.1
25481638,6,4,4.0,10,0.4
25486952,1,8,1.0,9,0.1111111111111111
25489588,5,5,5.0,10,0.5
25492495,5,5,5.0,10,0.5
25494060,4,6,4.0,10,0.4
25533019,1,8,1.0,9,0.1111111111111111
25534107,2,7,2.0,9,0.2222222222222222
25535641,7,3,3.0,10,0.3
25536228,1,8,1.0,9,0.1111111111111111
25536866,7,22,7.0,29,0.2413793103448276
25540147,1,7,1.0,8,0.125
25600740,5,14,5.0,19,0.2631578947368421
25608802,7,3,3.0,10,0.3
25624047,2,6,2.0,8,0.25
25626521,8,2,2.0,10,0.2
25637757,8,1,1.0,9,0.1111111111111111
25637825,7,3,3.0,10,0.3
25667404,1,9,1.0,10,0.1
25670483,1,9,1.0,10,0.1
25706026,7,1,1.0,8,0.125
25730590,1,7,1.0,8,0.125
25758689,3,7,3.0,10,0.3
25758904,1,9,1.0,10,0.1
25759708,1,9,1.0,10,0.1
25760034,3,6,3.0,9,0.3333333333333333
25760317,1,9,1.0,10,0.1
25760396,7,2,2.0,9,0.2222222222222222
25767567,6,4,4.0,10,0.4
25783433,3,7,3.0,10,0.3
25791535,2,8,2.0,10,0.2
25801117,2,6,2.0,8,0.25
25803972,1,8,1.0,9,0.1111111111111111
25805001,7,13,7.0,20,0.35
25807559,1,8,1.0,9,0.1111111111111111
25807978,1,9,1.0,10,0.1
25809752,3,7,3.0,10,0.3
25830082,5,3,3.0,8,0.375
25830104,5,3,3.0,8,0.375
25839172,1,9,1.0,10,0.1
25871878,4,6,4.0,10,0.4
25874749,1,8,1.0,9,0.1111111111111111
25876593,1,7,1.0,8,0.125
25881909,3,17,3.0,20,0.15
25886940,1,8,1.0,9,0.1111111111111111
25896422,2,8,2.0,10,0.2
25916578,1,19,1.0,20,0.05
25917210,25,2,2.0,27,0.07407407407407407
25924517,1,8,1.0,9,0.1111111111111111
25928859,1,18,1.0,19,0.05263157894736842
25957439,1,8,1.0,9,0.1111111111111111
25976450,1,8,1.0,9,0.1111111111111111
25979595,6,2,2.0,8,0.25
25982167,1,9,1.0,10,0.1
25992541,5,4,4.0,9,0.4444444444444444
25994755,3,6,3.0,9,0.3333333333333333
26017771,1,17,1.0,18,0.05555555555555555
26022447,3,6,3.0,9,0.3333333333333333
26040222,5,15,5.0,20,0.25
26048733,2,28,2.0,30,0.06666666666666667
26061379,1,9,1.0,10,0.1
26061571,1,8,1.0,9,0.1111111111111111
26061620,8,21,8.0,29,0.27586206896551724
26075877,1,18,1.0,19,0.05263157894736842
26103647,2,17,2.0,19,0.10526315789473684
26120718,1,9,1.0,10,0.1
26125676,5,5,5.0,10,0.5
26163909,3,6,3.0,9,0.3333333333333333
26223231,3,7,3.0,10,0.3
26237151,1,9,1.0,10,0.1
26240243,9,19,9.0,28,0.32142857142857145
26251591,2,7,2.0,9,0.2222222222222222
26317844,1,8,1.0,9,0.1111111111111111
26321452,3,7,3.0,10,0.3
26325506,2,8,2.0,10,0.2
26327353,2,17,2.0,19,0.10526315789473684
26328995,3,6,3.0,9,0.3333333333333333
26329071,1,8,1.0,9,0.1111111111111111
26335756,3,6,3.0,9,0.3333333333333333
26373196,2,8,2.0,10,0.2
26374717,1,9,1.0,10,0.1
26388667,1,7,1.0,8,0.125
26389460,3,15,3.0,18,0.16666666666666666
26403456,7,3,3.0,10,0.3
26446583,2,17,2.0,19,0.10526315789473684
26451485,1,9,1.0,10,0.1
26488132,1,9,1.0,10,0.1
26498514,4,16,4.0,20,0.2
26507679,3,17,3.0,20,0.15
26538215,1,9,1.0,10,0.1
26548579,2,7,2.0,9,0.2222222222222222
26559974,2,18,2.0,20,0.1
26581267,1,8,1.0,9,0.1111111111111111
26581555,6,22,6.0,28,0.21428571428571427
26595861,5,5,5.0,10,0.5
26598356,1,8,1.0,9,0.1111111111111111
26605403,4,6,4.0,10,0.4
26605801,1,9,1.0,10,0.1
26606946,2,7,2.0,9,0.2222222222222222
26607022,1,8,1.0,9,0.1111111111111111
26607091,1,7,1.0,8,0.125
26607618,6,4,4.0,10,0.4
26628440,1,9,1.0,10,0.1
26667017,3,7,3.0,10,0.3
26668423,2,17,2.0,19,0.10526315789473684
26702673,1,19,1.0,20,0.05
26713813,1,8,1.0,9,0.1111111111111111
26735645,5,5,5.0,10,0.5
26739211,1,9,1.0,10,0.1
26740071,1,17,1.0,18,0.05555555555555555
26794095,2,18,2.0,20,0.1
26825030,2,8,2.0,10,0.2
26895165,1,9,1.0,10,0.1
26899757,5,5,5.0,10,0.5
26900211,1,9,1.0,10,0.1
26900775,22,5,5.0,27,0.18518518518518517
26909796,3,6,3.0,9,0.3333333333333333
26925848,3,7,3.0,10,0.3
26934660,6,12,6.0,18,0.3333333333333333
26982239,1,9,1.0,10,0.1
26982784,4,6,4.0,10,0.4
26983338,1,9,1.0,10,0.1
26988672,1,9,1.0,10,0.1
26990267,1,9,1.0,10,0.1
27000391,2,8,2.0,10,0.2
27004648,5,5,5.0,10,0.5
27012546,1,18,1.0,19,0.05263157894736842
27014915,1,9,1.0,10,0.1
27023230,1,8,1.0,9,0.1111111111111111
27038139,1,8,1.0,9,0.1111111111111111
27039364,1,8,1.0,9,0.1111111111111111
27042269,1,18,1.0,19,0.05263157894736842
27044860,1,8,1.0,9,0.1111111111111111
27084782,4,14,4.0,18,0.2222222222222222
27098032,1,9,1.0,10,0.1
27098281,3,7,3.0,10,0.3
27114468,5,4,4.0,9,0.4444444444444444
27115707,1,9,1.0,10,0.1
27116757,1,9,1.0,10,0.1
27132878,2,8,2.0,10,0.2
27134087,6,4,4.0,10,0.4
27136680,1,9,1.0,10,0.1
27137812,4,6,4.0,10,0.4
27143482,1,7,1.0,8,0.125
27145563,3,21,3.0,24,0.125
27148820,1,16,1.0,17,0.058823529411764705
27213166,1,18,1.0,19,0.05263157894736842
27223714,7,1,1.0,8,0.125
27224928,2,7,2.0,9,0.2222222222222222
27243420,2,18,2.0,20,0.1
27252284,2,7,2.0,9,0.2222222222222222
27255643,1,9,1.0,10,0.1
27266418,2,8,2.0,10,0.2
27273581,1,7,1.0,8,0.125
27274125,1,9,1.0,10,0.1
27274948,4,6,4.0,10,0.4
27275327,4,5,4.0,9,0.4444444444444444
27276605,3,5,3.0,8,0.375
27290728,1,9,1.0,10,0.1
27318363,2,7,2.0,9,0.2222222222222222
27336578,1,9,1.0,10,0.1
27337753,6,4,4.0,10,0.4
27344507,2,13,2.0,15,0.13333333333333333
27349041,8,11,8.0,19,0.42105263157894735
27351409,2,8,2.0,10,0.2
27352914,2,8,2.0,10,0.2
27353262,3,7,3.0,10,0.3
27358253,2,18,2.0,20,0.1
27366284,8,2,2.0,10,0.2
27370418,1,9,1.0,10,0.1
27376775,3,6,3.0,9,0.3333333333333333
27380407,9,1,1.0,10,0.1
27381587,4,15,4.0,19,0.21052631578947367
27398861,8,22,8.0,30,0.26666666666666666
27399218,1,8,1.0,9,0.1111111111111111
27400191,1,9,1.0,10,0.1
27404606,5,14,5.0,19,0.2631578947368421
27405144,6,3,3.0,9,0.3333333333333333
27407739,4,4,4.0,8,0.5
27410119,2,8,2.0,10,0.2
27427006,7,21,7.0,28,0.25
27445204,5,4,4.0,9,0.4444444444444444
27448092,1,8,1.0,9,0.1111111111111111
27455147,6,2,2.0,8,0.25
27455484,7,3,3.0,10,0.3
27469091,3,15,3.0,18,0.16666666666666666
27490436,1,8,1.0,9,0.1111111111111111
27492918,3,16,3.0,19,0.15789473684210525
27517844,2,8,2.0,10,0.2
27519624,2,15,2.0,17,0.11764705882352941
27527252,1,9,1.0,10,0.1
27528017,2,8,2.0,10,0.2
27528373,2,7,2.0,9,0.2222222222222222
27528479,1,9,1.0,10,0.1
27561511,3,6,3.0,9,0.3333333333333333
27570110,1,18,1.0,19,0.05263157894736842
27577866,4,6,4.0,10,0.4
27578626,4,6,4.0,10,0.4
27591695,1,19,1.0,20,0.05
27596869,2,17,2.0,19,0.10526315789473684
27637444,1,18,1.0,19,0.05263157894736842
27649998,1,8,1.0,9,0.1111111111111111
27669012,2,8,2.0,10,0.2
27672009,2,8,2.0,10,0.2
27685036,1,9,1.0,10,0.1
27711235,1,9,1.0,10,0.1
27712346,2,7,2.0,9,0.2222222222222222
27756595,3,17,3.0,20,0.15
27760454,1,9,1.0,10,0.1
27763236,1,8,1.0,9,0.1111111111111111
27766941,3,7,3.0,10,0.3
27771174,1,9,1.0,10,0.1
27772614,3,7,3.0,10,0.3
27787393,3,6,3.0,9,0.3333333333333333
27789129,4,6,4.0,10,0.4
27801368,1,9,1.0,10,0.1
27823514,1,17,1.0,18,0.05555555555555555
27831079,1,7,1.0,8,0.125
27844250,4,25,4.0,29,0.13793103448275862
27859228,1,9,1.0,10,0.1
27908125,3,7,3.0,10,0.3
27909913,1,8,1.0,9,0.1111111111111111
27910233,2,7,2.0,9,0.2222222222222222
27943506,2,15,2.0,17,0.11764705882352941
28055028,2,7,2.0,9,0.2222222222222222
28055342,3,17,3.0,20,0.15
28135971,2,7,2.0,9,0.2222222222222222
28144194,1,7,1.0,8,0.125
28164723,5,5,5.0,10,0.5
28168427,3,7,3.0,10,0.3
28168822,1,8,1.0,9,0.1111111111111111
28173635,2,7,2.0,9,0.2222222222222222
28196260,4,4,4.0,8,0.5
28218048,2,7,2.0,9,0.2222222222222222
28238364,1,19,1.0,20,0.05
28239528,4,14,4.0,18,0.2222222222222222
28239902,5,4,4.0,9,0.4444444444444444
28240356,1,8,1.0,9,0.1111111111111111
28241893,3,6,3.0,9,0.3333333333333333
28242274,1,9,1.0,10,0.1
28243381,2,8,2.0,10,0.2
28247257,4,14,4.0,18,0.2222222222222222
28261297,2,8,2.0,10,0.2
28266019,2,8,2.0,10,0.2
28266231,4,5,4.0,9,0.4444444444444444
28284774,5,5,5.0,10,0.5
28303059,1,7,1.0,8,0.125
28304097,2,6,2.0,8,0.25
28304475,2,16,2.0,18,0.1111111111111111
28304866,2,7,2.0,9,0.2222222222222222
28311502,1,8,1.0,9,0.1111111111111111
28313088,4,15,4.0,19,0.21052631578947367
28334592,1,8,1.0,9,0.1111111111111111
28423340,2,7,2.0,9,0.2222222222222222
28423640,3,16,3.0,19,0.15789473684210525
28426197,1,9,1.0,10,0.1
28426710,1,9,1.0,10,0.1
28440501,1,8,1.0,9,0.1111111111111111
28444963,1,17,1.0,18,0.05555555555555555
28445347,1,18,1.0,19,0.05263157894736842
28490411,1,9,1.0,10,0.1
28495312,1,9,1.0,10,0.1
28516082,2,8,2.0,10,0.2
28516703,18,12,12.0,30,0.4
28533035,1,9,1.0,10,0.1
28534484,2,8,2.0,10,0.2
28545082,3,7,3.0,10,0.3
28553235,2,8,2.0,10,0.2
28555293,12,18,12.0,30,0.4
28593736,1,9,1.0,10,0.1
28599672,10,8,8.0,18,0.4444444444444444
28628058,1,9,1.0,10,0.1
28630460,1,9,1.0,10,0.1
28655113,1,29,1.0,30,0.03333333333333333
28677207,1,8,1.0,9,0.1111111111111111
28680259,1,9,1.0,10,0.1
28697191,3,7,3.0,10,0.3
28701346,2,8,2.0,10,0.2
28713094,2,8,2.0,10,0.2
28717654,1,19,1.0,20,0.05
28738942,1,8,1.0,9,0.1111111111111111
28744419,2,7,2.0,9,0.2222222222222222
28763559,2,17,2.0,19,0.10526315789473684
28764078,2,8,2.0,10,0.2
28764372,1,8,1.0,9,0.1111111111111111
28787225,5,4,4.0,9,0.4444444444444444
28788566,4,5,4.0,9,0.4444444444444444
28788897,1,26,1.0,27,0.037037037037037035
28792286,1,9,1.0,10,0.1
28802758,2,8,2.0,10,0.2
28807932,8,2,2.0,10,0.2
28807993,9,1,1.0,10,0.1
28808212,26,1,1.0,27,0.037037037037037035
28814263,7,3,3.0,10,0.3
28815348,3,7,3.0,10,0.3
28831598,2,7,2.0,9,0.2222222222222222
28839337,1,9,1.0,10,0.1
28843109,1,9,1.0,10,0.1
28847678,4,6,4.0,10,0.4
28851504,1,19,1.0,20,0.05
28852621,1,9,1.0,10,0.1
28862296,1,8,1.0,9,0.1111111111111111
28867697,1,9,1.0,10,0.1
28878067,2,18,2.0,20,0.1
28888674,1,9,1.0,10,0.1
28892549,1,8,1.0,9,0.1111111111111111
28894709,1,8,1.0,9,0.1111111111111111
28895117,2,8,2.0,10,0.2
28895222,4,6,4.0,10,0.4
28896110,9,10,9.0,19,0.47368421052631576
28897269,1,19,1.0,20,0.05
28898950,2,7,2.0,9,0.2222222222222222
28901501,3,7,3.0,10,0.3
28909835,2,7,2.0,9,0.2222222222222222
28911031,2,8,2.0,10,0.2
28911143,1,9,1.0,10,0.1
28911364,5,15,5.0,20,0.25
28912822,1,9,1.0,10,0.1
28931522,5,5,5.0,10,0.5
28932156,3,7,3.0,10,0.3
28935847,1,9,1.0,10,0.1
28943028,1,9,1.0,10,0.1
28958161,9,1,1.0,10,0.1
28958583,9,1,1.0,10,0.1
28962100,1,9,1.0,10,0.1
28971590,2,18,2.0,20,0.1
28976977,1,8,1.0,9,0.1111111111111111
28984760,6,4,4.0,10,0.4
28992585,1,8,1.0,9,0.1111111111111111
28993374,1,9,1.0,10,0.1
28995854,1,9,1.0,10,0.1
29001027,1,8,1.0,9,0.1111111111111111
29016930,4,5,4.0,9,0.4444444444444444
29017278,1,9,1.0,10,0.1
29029901,2,7,2.0,9,0.2222222222222222
29038092,4,5,4.0,9,0.4444444444444444
29039475,2,7,2.0,9,0.2222222222222222
29043283,3,17,3.0,20,0.15
29043400,1,18,1.0,19,0.05263157894736842
29050133,10,18,10.0,28,0.35714285714285715
29056295,1,9,1.0,10,0.1
29056461,1,9,1.0,10,0.1
29056518,2,8,2.0,10,0.2
29065701,5,5,5.0,10,0.5
29066087,7,3,3.0,10,0.3
29070593,3,7,3.0,10,0.3
29084316,5,25,5.0,30,0.16666666666666666
29084389,3,6,3.0,9,0.3333333333333333
29099949,2,8,2.0,10,0.2
29102575,3,5,3.0,8,0.375
29115136,2,8,2.0,10,0.2
29118456,3,17,3.0,20,0.15
29122716,2,8,2.0,10,0.2
29155472,3,26,3.0,29,0.10344827586206896
29158309,1,9,1.0,10,0.1
29163443,2,8,2.0,10,0.2
29187809,10,9,9.0,19,0.47368421052631576
29191040,2,7,2.0,9,0.2222222222222222
29192952,5,14,5.0,19,0.2631578947368421
29193254,8,1,1.0,9,0.1111111111111111
29205887,7,3,3.0,10,0.3
29220213,3,7,3.0,10,0.3
29223552,2,8,2.0,10,0.2
29231263,3,7,3.0,10,0.3
29240991,1,8,1.0,9,0.1111111111111111
29258544,1,8,1.0,9,0.1111111111111111
29262706,2,8,2.0,10,0.2
29351956,4,5,4.0,9,0.4444444444444444
29352085,8,1,1.0,9,0.1111111111111111
29352304,14,16,14.0,30,0.4666666666666667
29352540,1,8,1.0,9,0.1111111111111111
29370254,1,17,1.0,18,0.05555555555555555
29372167,1,9,1.0,10,0.1
29373868,2,7,2.0,9,0.2222222222222222
29374037,1,9,1.0,10,0.1
29389615,8,1,1.0,9,0.1111111111111111
29406942,1,9,1.0,10,0.1
29417346,8,2,2.0,10,0.2
29418110,1,9,1.0,10,0.1
29418739,4,5,4.0,9,0.4444444444444444
29419125,8,1,1.0,9,0.1111111111111111
29419241,18,10,10.0,28,0.35714285714285715
29450009,1,17,1.0,18,0.05555555555555555
29450448,3,7,3.0,10,0.3
29450874,6,4,4.0,10,0.4
29455222,4,6,4.0,10,0.4
29462760,1,9,1.0,10,0.1
29476293,1,9,1.0,10,0.1
29569151,2,8,2.0,10,0.2
29569416,4,5,4.0,9,0.4444444444444444
29572921,1,7,1.0,8,0.125
29612922,1,8,1.0,9,0.1111111111111111
29613298,1,8,1.0,9,0.1111111111111111
29619541,1,9,1.0,10,0.1
29624513,2,7,2.0,9,0.2222222222222222
29629022,2,8,2.0,10,0.2
29632547,1,8,1.0,9,0.1111111111111111
29647442,4,6,4.0,10,0.4
29660787,1,9,1.0,10,0.1
29662419,5,4,4.0,9,0.4444444444444444
29663886,8,2,2.0,10,0.2
29665080,2,8,2.0,10,0.2
29695259,1,9,1.0,10,0.1
29699334,1,9,1.0,10,0.1
29705417,3,15,3.0,18,0.16666666666666666
29728479,5,21,5.0,26,0.19230769230769232
29728491,3,7,3.0,10,0.3
29750173,1,9,1.0,10,0.1
29761596,1,8,1.0,9,0.1111111111111111
29767618,5,5,5.0,10,0.5
29810639,5,4,4.0,9,0.4444444444444444
29853624,1,29,1.0,30,0.03333333333333333
29854738,4,5,4.0,9,0.4444444444444444
29863580,3,7,3.0,10,0.3
29875245,2,7,2.0,9,0.2222222222222222
29909389,1,18,1.0,19,0.05263157894736842
29933886,8,1,1.0,9,0.1111111111111111
29938104,3,16,3.0,19,0.15789473684210525
29946196,2,6,2.0,8,0.25
29946736,1,7,1.0,8,0.125
29950006,2,18,2.0,20,0.1
29954269,1,9,1.0,10,0.1
29969349,5,15,5.0,20,0.25
29970955,1,19,1.0,20,0.05
29993553,2,8,2.0,10,0.2
29994302,4,4,4.0,8,0.5
30000663,2,8,2.0,10,0.2
30028537,6,3,3.0,9,0.3333333333333333
30029780,2,8,2.0,10,0.2
30044158,10,14,10.0,24,0.4166666666666667
30045913,5,5,5.0,10,0.5
30050272,2,8,2.0,10,0.2
30050434,2,8,2.0,10,0.2
30057192,1,7,1.0,8,0.125
30061150,9,1,1.0,10,0.1
30061219,2,8,2.0,10,0.2
30076875,1,8,1.0,9,0.1111111111111111
30084358,4,23,4.0,27,0.14814814814814814
30109581,1,9,1.0,10,0.1
30115071,1,9,1.0,10,0.1
30127572,4,6,4.0,10,0.4
30234746,8,2,2.0,10,0.2
30235020,3,6,3.0,9,0.3333333333333333
30242944,6,4,4.0,10,0.4
30243513,7,3,3.0,10,0.3
30244024,2,8,2.0,10,0.2
30245285,5,5,5.0,10,0.5
30259019,7,19,7.0,26,0.2692307692307692
30259489,5,12,5.0,17,0.29411764705882354
30264734,7,32,7.0,39,0.1794871794871795
30266565,11,28,11.0,39,0.28205128205128205
30268202,8,2,2.0,10,0.2
30283561,4,5,4.0,9,0.4444444444444444
30314542,2,7,2.0,9,0.2222222222222222
30321659,7,22,7.0,29,0.2413793103448276
30367072,4,5,4.0,9,0.4444444444444444
30384127,12,16,12.0,28,0.42857142857142855
30400225,1,8,1.0,9,0.1111111111111111
30426593,1,9,1.0,10,0.1
30426695,1,8,1.0,9,0.1111111111111111
30427135,3,7,3.0,10,0.3
30437144,9,1,1.0,10,0.1
30439159,1,8,1.0,9,0.1111111111111111
30444963,1,8,1.0,9,0.1111111111111111
30447912,2,8,2.0,10,0.2
30449411,2,7,2.0,9,0.2222222222222222
30453306,2,8,2.0,10,0.2
30454760,1,26,1.0,27,0.037037037037037035
30463557,1,9,1.0,10,0.1
30465762,1,9,1.0,10,0.1
30467170,2,16,2.0,18,0.1111111111111111
30474168,1,19,1.0,20,0.05
30476162,2,8,2.0,10,0.2
30476839,2,7,2.0,9,0.2222222222222222
30478891,3,7,3.0,10,0.3
30480440,1,9,1.0,10,0.1
30484681,1,8,1.0,9,0.1111111111111111
30490238,1,9,1.0,10,0.1
30496022,6,3,3.0,9,0.3333333333333333
30544598,1,15,1.0,16,0.0625
30544699,7,3,3.0,10,0.3
30555966,1,18,1.0,19,0.05263157894736842
30560090,3,7,3.0,10,0.3
30560205,1,8,1.0,9,0.1111111111111111
30579248,1,8,1.0,9,0.1111111111111111
30613696,1,9,1.0,10,0.1
30616922,4,5,4.0,9,0.4444444444444444
30617977,1,9,1.0,10,0.1
30622334,4,6,4.0,10,0.4
30625946,1,9,1.0,10,0.1
30629076,4,5,4.0,9,0.4444444444444444
30630462,1,8,1.0,9,0.1111111111111111
30631346,5,24,5.0,29,0.1724137931034483
30631919,21,5,5.0,26,0.19230769230769232
30632918,24,4,4.0,28,0.14285714285714285
30635003,2,8,2.0,10,0.2
30637736,2,8,2.0,10,0.2
30643454,2,7,2.0,9,0.2222222222222222
30644661,6,4,4.0,10,0.4
30649435,4,14,4.0,18,0.2222222222222222
30652942,4,6,4.0,10,0.4
30658723,7,3,3.0,10,0.3
30669871,4,5,4.0,9,0.4444444444444444
30671162,1,19,1.0,20,0.05
30674213,2,8,2.0,10,0.2
30678142,8,2,2.0,10,0.2
30708046,4,6,4.0,10,0.4
30713019,3,7,3.0,10,0.3
30721585,1,8,1.0,9,0.1111111111111111
30768379,5,5,5.0,10,0.5
30770770,2,6,2.0,8,0.25
30800063,2,8,2.0,10,0.2
30801700,6,23,6.0,29,0.20689655172413793
30806794,7,23,7.0,30,0.23333333333333334
30806941,2,8,2.0,10,0.2
30807126,15,15,15.0,30,0.5
30818245,1,8,1.0,9,0.1111111111111111
30818743,3,27,3.0,30,0.1
30833670,2,7,2.0,9,0.2222222222222222
30854063,2,18,2.0,20,0.1
30854280,2,8,2.0,10,0.2
30857806,3,7,3.0,10,0.3
30864578,6,3,3.0,9,0.3333333333333333
30869963,2,8,2.0,10,0.2
30872736,5,4,4.0,9,0.4444444444444444
30873682,4,5,4.0,9,0.4444444444444444
30884904,7,3,3.0,10,0.3
30901158,2,7,2.0,9,0.2222222222222222
30922954,5,15,5.0,20,0.25
30933968,4,5,4.0,9,0.4444444444444444
30934068,4,6,4.0,10,0.4
30936219,7,3,3.0,10,0.3
30937731,6,4,4.0,10,0.4
30938977,1,9,1.0,10,0.1
30950466,1,9,1.0,10,0.1
30951497,1,8,1.0,9,0.1111111111111111
30952104,3,6,3.0,9,0.3333333333333333
30953148,2,7,2.0,9,0.2222222222222222
30957546,5,14,5.0,19,0.2631578947368421
30958971,3,16,3.0,19,0.15789473684210525
30960233,2,8,2.0,10,0.2
30968481,1,8,1.0,9,0.1111111111111111
30973266,1,9,1.0,10,0.1
30976987,1,9,1.0,10,0.1
30978607,1,9,1.0,10,0.1
30979653,1,27,1.0,28,0.03571428571428571
30980776,1,8,1.0,9,0.1111111111111111
31005362,1,8,1.0,9,0.1111111111111111
31012207,1,18,1.0,19,0.05263157894736842
31025622,1,9,1.0,10,0.1
31032933,6,4,4.0,10,0.4
31043434,1,7,1.0,8,0.125
31068325,1,7,1.0,8,0.125
31074430,7,22,7.0,29,0.2413793103448276
31074709,5,3,3.0,8,0.375
31074946,2,7,2.0,9,0.2222222222222222
31075076,3,6,3.0,9,0.3333333333333333
31075186,1,9,1.0,10,0.1
31082808,6,22,6.0,28,0.21428571428571427
31083961,9,1,1.0,10,0.1
31087522,2,8,2.0,10,0.2
31095307,1,8,1.0,9,0.1111111111111111
31105739,1,8,1.0,9,0.1111111111111111
31111034,1,9,1.0,10,0.1
31118471,2,7,2.0,9,0.2222222222222222
31129815,1,9,1.0,10,0.1
31147790,1,9,1.0,10,0.1
31150396,2,7,2.0,9,0.2222222222222222
31153463,2,8,2.0,10,0.2
31164823,20,10,10.0,30,0.3333333333333333
31167872,1,8,1.0,9,0.1111111111111111
31168088,1,9,1.0,10,0.1
31168797,2,17,2.0,19,0.10526315789473684
31184268,1,8,1.0,9,0.1111111111111111
31189093,14,5,5.0,19,0.2631578947368421
31198766,18,10,10.0,28,0.35714285714285715
31218133,4,15,4.0,19,0.21052631578947367
31224088,1,19,1.0,20,0.05
31224725,1,9,1.0,10,0.1
31230427,1,9,1.0,10,0.1
31241721,1,9,1.0,10,0.1
31243368,1,8,1.0,9,0.1111111111111111
31243422,3,15,3.0,18,0.16666666666666666
31256555,2,8,2.0,10,0.2
31272510,1,8,1.0,9,0.1111111111111111
31279185,2,8,2.0,10,0.2
31294933,1,9,1.0,10,0.1
31296078,1,9,1.0,10,0.1
31299285,5,5,5.0,10,0.5
31300299,6,20,6.0,26,0.23076923076923078
31300388,7,1,1.0,8,0.125
31305185,1,9,1.0,10,0.1
31307489,1,8,1.0,9,0.1111111111111111
31310572,2,8,2.0,10,0.2
31324318,3,6,3.0,9,0.3333333333333333
31324511,3,7,3.0,10,0.3
31324938,1,9,1.0,10,0.1
31327373,1,18,1.0,19,0.05263157894736842
31328003,3,6,3.0,9,0.3333333333333333
31332387,4,6,4.0,10,0.4
31332845,5,4,4.0,9,0.4444444444444444
31333061,3,7,3.0,10,0.3
31355709,4,6,4.0,10,0.4
31358758,8,2,2.0,10,0.2
31363021,3,6,3.0,9,0.3333333333333333
31370737,3,6,3.0,9,0.3333333333333333
31370816,3,6,3.0,9,0.3333333333333333
31372543,5,5,5.0,10,0.5
31373055,4,6,4.0,10,0.4
31374156,6,24,6.0,30,0.2
31376731,1,19,1.0,20,0.05
31379050,2,8,2.0,10,0.2
31383270,5,5,5.0,10,0.5
31383743,1,9,1.0,10,0.1
31387435,2,8,2.0,10,0.2
31388417,1,8,1.0,9,0.1111111111111111
31402891,4,15,4.0,19,0.21052631578947367
31403900,1,7,1.0,8,0.125
31404317,4,6,4.0,10,0.4
31406255,4,5,4.0,9,0.4444444444444444
31406871,2,8,2.0,10,0.2
31408185,1,9,1.0,10,0.1
31410627,1,9,1.0,10,0.1
31423118,8,2,2.0,10,0.2
31423129,1,9,1.0,10,0.1
31424528,1,8,1.0,9,0.1111111111111111
31426190,13,7,7.0,20,0.35
31434588,1,28,1.0,29,0.034482758620689655
31443481,1,9,1.0,10,0.1
31444110,1,9,1.0,10,0.1
31451073,1,8,1.0,9,0.1111111111111111
31485873,5,4,4.0,9,0.4444444444444444
31491418,1,7,1.0,8,0.125
31495753,4,5,4.0,9,0.4444444444444444
31496364,9,19,9.0,28,0.32142857142857145
31497767,1,8,1.0,9,0.1111111111111111
31506196,2,8,2.0,10,0.2
31516048,1,19,1.0,20,0.05
31529648,1,8,1.0,9,0.1111111111111111
31531646,6,4,4.0,10,0.4
31531665,4,6,4.0,10,0.4
31536011,5,5,5.0,10,0.5
31536259,3,25,3.0,28,0.10714285714285714
31537115,6,3,3.0,9,0.3333333333333333
31543625,4,15,4.0,19,0.21052631578947367
31544242,1,9,1.0,10,0.1
31555233,1,9,1.0,10,0.1
31557818,1,9,1.0,10,0.1
31559839,1,9,1.0,10,0.1
31561137,1,19,1.0,20,0.05
31561176,8,18,8.0,26,0.3076923076923077
31561445,1,27,1.0,28,0.03571428571428571
31562833,1,9,1.0,10,0.1
31563124,4,15,4.0,19,0.21052631578947367
31569081,2,8,2.0,10,0.2
31574707,1,9,1.0,10,0.1
31576436,1,9,1.0,10,0.1
31576586,1,9,1.0,10,0.1
31577107,3,7,3.0,10,0.3
31577599,5,4,4.0,9,0.4444444444444444
31593271,2,8,2.0,10,0.2
31594838,1,7,1.0,8,0.125
31596102,1,19,1.0,20,0.05
31622519,2,18,2.0,20,0.1
31624227,2,8,2.0,10,0.2
31624866,2,7,2.0,9,0.2222222222222222
31626949,1,9,1.0,10,0.1
31631411,6,2,2.0,8,0.25
31633037,22,7,7.0,29,0.2413793103448276
31635703,1,8,1.0,9,0.1111111111111111
31637496,1,9,1.0,10,0.1
31637780,4,4,4.0,8,0.5
31641334,5,5,5.0,10,0.5
31644391,9,19,9.0,28,0.32142857142857145
31646599,2,7,2.0,9,0.2222222222222222
31647025,1,9,1.0,10,0.1
31649262,1,8,1.0,9,0.1111111111111111
31657267,1,9,1.0,10,0.1
31658462,1,9,1.0,10,0.1
31662529,4,5,4.0,9,0.4444444444444444
31664668,1,9,1.0,10,0.1
31674928,1,18,1.0,19,0.05263157894736842
31702075,5,5,5.0,10,0.5
31717826,3,6,3.0,9,0.3333333333333333
31719541,4,15,4.0,19,0.21052631578947367
31732484,2,7,2.0,9,0.2222222222222222
31740337,3,6,3.0,9,0.3333333333333333
31742800,2,8,2.0,10,0.2
31746438,1,8,1.0,9,0.1111111111111111
31747401,1,8,1.0,9,0.1111111111111111
31749180,6,24,6.0,30,0.2
31780774,1,19,1.0,20,0.05
31790565,2,8,2.0,10,0.2
31795934,1,8,1.0,9,0.1111111111111111
31797983,4,6,4.0,10,0.4
31802055,3,6,3.0,9,0.3333333333333333
31817579,1,9,1.0,10,0.1
31829950,1,17,1.0,18,0.05555555555555555
31844537,1,9,1.0,10,0.1
31878922,2,8,2.0,10,0.2
31882981,2,7,2.0,9,0.2222222222222222
31912250,3,6,3.0,9,0.3333333333333333
31921852,1,9,1.0,10,0.1
31954578,2,8,2.0,10,0.2
31965924,1,9,1.0,10,0.1
31966911,2,7,2.0,9,0.2222222222222222
31967432,3,7,3.0,10,0.3
31967927,6,4,4.0,10,0.4
31974214,4,5,4.0,9,0.4444444444444444
31975902,9,1,1.0,10,0.1
31976332,16,11,11.0,27,0.4074074074074074
31977140,5,4,4.0,9,0.4444444444444444
31980387,1,17,1.0,18,0.05555555555555555
31990628,1,8,1.0,9,0.1111111111111111
31994793,6,4,4.0,10,0.4
31995040,4,6,4.0,10,0.4
31995106,4,6,4.0,10,0.4
31995586,4,6,4.0,10,0.4
32000410,1,19,1.0,20,0.05
32016610,2,8,2.0,10,0.2
32031828,1,9,1.0,10,0.1
32033703,8,21,8.0,29,0.27586206896551724
32055406,7,3,3.0,10,0.3
32103970,1,9,1.0,10,0.1
32122581,29,1,1.0,30,0.03333333333333333
32141927,2,8,2.0,10,0.2
32142734,2,8,2.0,10,0.2
32144549,2,7,2.0,9,0.2222222222222222
32147702,4,14,4.0,18,0.2222222222222222
32158614,1,18,1.0,19,0.05263157894736842
32160373,2,8,2.0,10,0.2
32168941,5,4,4.0,9,0.4444444444444444
32183717,5,4,4.0,9,0.4444444444444444
32185091,9,20,9.0,29,0.3103448275862069
32187054,1,8,1.0,9,0.1111111111111111
32190978,2,8,2.0,10,0.2
32218513,3,7,3.0,10,0.3
32236434,1,8,1.0,9,0.1111111111111111
32241380,6,3,3.0,9,0.3333333333333333
32243941,1,19,1.0,20,0.05
32260130,1,9,1.0,10,0.1
32260659,1,9,1.0,10,0.1
32262079,3,6,3.0,9,0.3333333333333333
32265398,4,6,4.0,10,0.4
32269753,1,7,1.0,8,0.125
32273131,2,8,2.0,10,0.2
32274683,1,9,1.0,10,0.1
32277594,2,8,2.0,10,0.2
32277785,1,9,1.0,10,0.1
32280331,1,9,1.0,10,0.1
32283053,1,8,1.0,9,0.1111111111111111
32285354,1,9,1.0,10,0.1
32296710,4,15,4.0,19,0.21052631578947367
32310406,1,18,1.0,19,0.05263157894736842
32318600,1,9,1.0,10,0.1
32319899,6,2,2.0,8,0.25
32375665,3,6,3.0,9,0.3333333333333333
32378513,1,18,1.0,19,0.05263157894736842
32383108,2,8,2.0,10,0.2
32385940,7,2,2.0,9,0.2222222222222222
32388589,19,10,10.0,29,0.3448275862068966
32388908,7,2,2.0,9,0.2222222222222222
32392490,3,7,3.0,10,0.3
32393647,3,14,3.0,17,0.17647058823529413
32398740,7,1,1.0,8,0.125
32399407,9,1,1.0,10,0.1
32401534,1,19,1.0,20,0.05
32423622,4,6,4.0,10,0.4
32445947,1,8,1.0,9,0.1111111111111111
32449590,2,7,2.0,9,0.2222222222222222
32454069,1,8,1.0,9,0.1111111111111111
32457610,11,8,8.0,19,0.42105263157894735
32463480,1,9,1.0,10,0.1
32473368,1,9,1.0,10,0.1
32473758,2,8,2.0,10,0.2
32476053,8,1,1.0,9,0.1111111111111111
32481618,2,7,2.0,9,0.2222222222222222
32485592,2,17,2.0,19,0.10526315789473684
32504823,7,3,3.0,10,0.3
32506569,2,8,2.0,10,0.2
32509080,9,1,1.0,10,0.1
32510928,4,4,4.0,8,0.5
32541803,4,6,4.0,10,0.4
32544896,4,6,4.0,10,0.4
32552136,1,9,1.0,10,0.1
32552841,2,18,2.0,20,0.1
32553951,7,3,3.0,10,0.3
32555646,1,9,1.0,10,0.1
32562000,1,9,1.0,10,0.1
32567063,1,9,1.0,10,0.1
32567071,1,9,1.0,10,0.1
32567150,2,8,2.0,10,0.2
32594877,1,9,1.0,10,0.1
32595510,2,8,2.0,10,0.2
32608610,1,19,1.0,20,0.05
32614018,1,9,1.0,10,0.1
32615197,9,1,1.0,10,0.1
32617551,4,6,4.0,10,0.4
32619165,1,19,1.0,20,0.05
32655281,3,15,3.0,18,0.16666666666666666
32666804,5,5,5.0,10,0.5
32667136,6,4,4.0,10,0.4
32691625,4,5,4.0,9,0.4444444444444444
32702594,2,8,2.0,10,0.2
32711840,1,28,1.0,29,0.034482758620689655
32714178,2,6,2.0,8,0.25
32728407,2,6,2.0,8,0.25
32729049,4,5,4.0,9,0.4444444444444444
32729133,6,4,4.0,10,0.4
32729570,5,5,5.0,10,0.5
32730812,3,7,3.0,10,0.3
32730832,2,8,2.0,10,0.2
32740403,2,7,2.0,9,0.2222222222222222
32741251,1,9,1.0,10,0.1
32746375,1,8,1.0,9,0.1111111111111111
32747555,1,26,1.0,27,0.037037037037037035
32751874,1,8,1.0,9,0.1111111111111111
32765711,2,8,2.0,10,0.2
32766673,9,11,9.0,20,0.45
32776997,6,11,6.0,17,0.35294117647058826
32784477,3,7,3.0,10,0.3
32784503,2,7,2.0,9,0.2222222222222222
32785052,1,9,1.0,10,0.1
32786255,1,8,1.0,9,0.1111111111111111
32786609,5,4,4.0,9,0.4444444444444444
32787988,4,5,4.0,9,0.4444444444444444
32788605,2,7,2.0,9,0.2222222222222222
32789222,4,6,4.0,10,0.4
32800586,5,5,5.0,10,0.5
32812211,1,8,1.0,9,0.1111111111111111
32813663,2,7,2.0,9,0.2222222222222222
32814760,5,21,5.0,26,0.19230769230769232
32815242,5,22,5.0,27,0.18518518518518517
32815596,2,7,2.0,9,0.2222222222222222
32847854,3,6,3.0,9,0.3333333333333333
32848694,2,8,2.0,10,0.2
32850454,2,8,2.0,10,0.2
32854972,4,6,4.0,10,0.4
32864423,1,9,1.0,10,0.1
32882824,1,9,1.0,10,0.1
32883776,2,8,2.0,10,0.2
32915430,1,18,1.0,19,0.05263157894736842
32918159,2,8,2.0,10,0.2
32923461,2,18,2.0,20,0.1
32935823,2,8,2.0,10,0.2
32936772,1,9,1.0,10,0.1
32955382,1,9,1.0,10,0.1
32957358,4,5,4.0,9,0.4444444444444444
32959837,2,8,2.0,10,0.2
32960481,9,1,1.0,10,0.1
32960654,3,5,3.0,8,0.375
32964498,6,3,3.0,9,0.3333333333333333
32966841,2,7,2.0,9,0.2222222222222222
32970144,1,9,1.0,10,0.1
32972187,5,5,5.0,10,0.5
32977951,1,19,1.0,20,0.05
32984901,1,9,1.0,10,0.1
33012485,3,15,3.0,18,0.16666666666666666
33013286,2,8,2.0,10,0.2
33014537,3,7,3.0,10,0.3
33015066,6,14,6.0,20,0.3
33029748,4,6,4.0,10,0.4
33037899,1,9,1.0,10,0.1
33043759,2,7,2.0,9,0.2222222222222222
33046067,7,3,3.0,10,0.3
33049405,1,8,1.0,9,0.1111111111111111
33054907,7,3,3.0,10,0.3
33055747,6,4,4.0,10,0.4
33057907,5,4,4.0,9,0.4444444444444444
33073882,1,8,1.0,9,0.1111111111111111
33081005,25,2,2.0,27,0.07407407407407407
33095449,2,8,2.0,10,0.2
33095833,1,8,1.0,9,0.1111111111111111
33097044,1,9,1.0,10,0.1
33097188,3,7,3.0,10,0.3
33097290,2,7,2.0,9,0.2222222222222222
33097915,1,8,1.0,9,0.1111111111111111
33105495,1,8,1.0,9,0.1111111111111111
33108667,1,16,1.0,17,0.058823529411764705
33120737,4,16,4.0,20,0.2
33146681,4,6,4.0,10,0.4
33148858,1,9,1.0,10,0.1
33149184,2,8,2.0,10,0.2
33149705,1,9,1.0,10,0.1
33150319,5,5,5.0,10,0.5
33157264,9,1,1.0,10,0.1
33164488,1,8,1.0,9,0.1111111111111111
33164504,3,7,3.0,10,0.3
33188499,3,16,3.0,19,0.15789473684210525
33192202,3,7,3.0,10,0.3
33192624,1,9,1.0,10,0.1
33193019,1,9,1.0,10,0.1
33198425,4,25,4.0,29,0.13793103448275862
33206892,5,5,5.0,10,0.5
33207148,8,2,2.0,10,0.2
33214688,1,18,1.0,19,0.05263157894736842
33230741,3,5,3.0,8,0.375
33236958,2,8,2.0,10,0.2
33238816,2,7,2.0,9,0.2222222222222222
33245412,1,9,1.0,10,0.1
33249657,2,7,2.0,9,0.2222222222222222
33250579,2,7,2.0,9,0.2222222222222222
33251874,1,28,1.0,29,0.034482758620689655
33252877,2,8,2.0,10,0.2
33266075,2,6,2.0,8,0.25
33266252,1,9,1.0,10,0.1
33266502,2,8,2.0,10,0.2
33273166,2,8,2.0,10,0.2
33280564,7,3,3.0,10,0.3
33282972,3,7,3.0,10,0.3
33283499,2,8,2.0,10,0.2
33284587,1,9,1.0,10,0.1
33286392,4,5,4.0,9,0.4444444444444444
33287541,8,2,2.0,10,0.2
33295936,4,5,4.0,9,0.4444444444444444
33296422,6,4,4.0,10,0.4
33296960,2,7,2.0,9,0.2222222222222222
33297183,6,4,4.0,10,0.4
33299140,1,8,1.0,9,0.1111111111111111
33309044,5,5,5.0,10,0.5
33314247,1,8,1.0,9,0.1111111111111111
33315713,1,9,1.0,10,0.1
33317571,1,8,1.0,9,0.1111111111111111
33346276,1,9,1.0,10,0.1
33347713,1,8,1.0,9,0.1111111111111111
33376768,4,15,4.0,19,0.21052631578947367
33380429,2,16,2.0,18,0.1111111111111111
33392726,6,4,4.0,10,0.4
33395555,6,14,6.0,20,0.3
33396312,6,3,3.0,9,0.3333333333333333
33396378,6,3,3.0,9,0.3333333333333333
33397371,5,4,4.0,9,0.4444444444444444
33397559,4,6,4.0,10,0.4
33397618,1,9,1.0,10,0.1
33398941,1,18,1.0,19,0.05263157894736842
33399985,1,7,1.0,8,0.125
33406205,4,6,4.0,10,0.4
33421209,3,7,3.0,10,0.3
33426179,3,6,3.0,9,0.3333333333333333
33427474,1,9,1.0,10,0.1
33439777,4,6,4.0,10,0.4
33452849,2,7,2.0,9,0.2222222222222222
33458905,2,7,2.0,9,0.2222222222222222
33461791,2,7,2.0,9,0.2222222222222222
33462360,3,5,3.0,8,0.375
33463691,1,9,1.0,10,0.1
33473442,2,7,2.0,9,0.2222222222222222
33480810,1,8,1.0,9,0.1111111111111111
33481190,5,5,5.0,10,0.5
33494534,8,12,8.0,20,0.4
33523381,8,1,1.0,9,0.1111111111111111
33527444,5,4,4.0,9,0.4444444444444444
33527685,3,6,3.0,9,0.3333333333333333
33528060,4,6,4.0,10,0.4
33528477,6,4,4.0,10,0.4
33555403,2,8,2.0,10,0.2
33590913,3,7,3.0,10,0.3
33605122,19,10,10.0,29,0.3448275862068966
33605959,2,7,2.0,9,0.2222222222222222
33607372,2,8,2.0,10,0.2
33660251,2,16,2.0,18,0.1111111111111111
33680313,2,8,2.0,10,0.2
33689510,1,9,1.0,10,0.1
33690770,1,9,1.0,10,0.1
33698048,2,17,2.0,19,0.10526315789473684
33701788,1,19,1.0,20,0.05
33702405,1,9,1.0,10,0.1
33716599,2,7,2.0,9,0.2222222222222222
33721343,1,17,1.0,18,0.05555555555555555
33727811,1,7,1.0,8,0.125
33729739,1,7,1.0,8,0.125
33731288,9,19,9.0,28,0.32142857142857145
33734629,8,2,2.0,10,0.2
33735249,2,8,2.0,10,0.2
33737962,3,7,3.0,10,0.3
33739455,1,8,1.0,9,0.1111111111111111
33746199,4,6,4.0,10,0.4
33747278,7,19,7.0,26,0.2692307692307692
33749551,1,8,1.0,9,0.1111111111111111
33757658,1,25,1.0,26,0.038461538461538464
33759637,8,2,2.0,10,0.2
33760178,2,7,2.0,9,0.2222222222222222
33767529,9,1,1.0,10,0.1
33769334,3,6,3.0,9,0.3333333333333333
33789044,3,7,3.0,10,0.3
33799516,2,7,2.0,9,0.2222222222222222
33804368,1,9,1.0,10,0.1
33806972,2,17,2.0,19,0.10526315789473684
33807059,1,19,1.0,20,0.05
33810165,3,7,3.0,10,0.3
33810590,1,9,1.0,10,0.1
33813129,3,7,3.0,10,0.3
33813236,1,9,1.0,10,0.1
33818686,1,8,1.0,9,0.1111111111111111
33819681,3,7,3.0,10,0.3
33825499,5,5,5.0,10,0.5
33826612,1,8,1.0,9,0.1111111111111111
33829629,1,18,1.0,19,0.05263157894736842
33830252,3,7,3.0,10,0.3
33839397,4,6,4.0,10,0.4
33850848,8,1,1.0,9,0.1111111111111111
33879331,3,6,3.0,9,0.3333333333333333
33891775,4,15,4.0,19,0.21052631578947367
33896491,1,9,1.0,10,0.1
33901059,2,7,2.0,9,0.2222222222222222
33908106,2,8,2.0,10,0.2
33909397,3,7,3.0,10,0.3
33914957,3,7,3.0,10,0.3
33915668,6,22,6.0,28,0.21428571428571427
33916121,1,9,1.0,10,0.1
33927058,1,9,1.0,10,0.1
33929177,1,9,1.0,10,0.1
33958701,2,8,2.0,10,0.2
33959096,5,4,4.0,9,0.4444444444444444
33975178,4,6,4.0,10,0.4
33976016,14,15,14.0,29,0.4827586206896552
33984011,5,5,5.0,10,0.5
33995502,1,9,1.0,10,0.1
34002296,1,8,1.0,9,0.1111111111111111
34003807,3,7,3.0,10,0.3
34016470,2,7,2.0,9,0.2222222222222222
34016811,3,7,3.0,10,0.3
34017271,1,9,1.0,10,0.1
34017623,1,9,1.0,10,0.1
34017796,1,8,1.0,9,0.1111111111111111
34024825,1,9,1.0,10,0.1
34044021,3,5,3.0,8,0.375
34044108,4,6,4.0,10,0.4
34045921,1,9,1.0,10,0.1
34047374,3,26,3.0,29,0.10344827586206896
34048079,2,6,2.0,8,0.25
34048276,4,5,4.0,9,0.4444444444444444
34050472,1,9,1.0,10,0.1
34053163,1,8,1.0,9,0.1111111111111111
34055319,1,8,1.0,9,0.1111111111111111
34064031,2,18,2.0,20,0.1
34071439,1,9,1.0,10,0.1
34071607,3,27,3.0,30,0.1
34073347,6,13,6.0,19,0.3157894736842105
34074583,2,7,2.0,9,0.2222222222222222
34075592,1,8,1.0,9,0.1111111111111111
34075789,1,27,1.0,28,0.03571428571428571
34076472,3,25,3.0,28,0.10714285714285714
34077762,1,8,1.0,9,0.1111111111111111
34081023,1,9,1.0,10,0.1
34086824,4,15,4.0,19,0.21052631578947367
34110216,1,9,1.0,10,0.1
34119212,1,9,1.0,10,0.1
34122689,1,9,1.0,10,0.1
34133101,3,7,3.0,10,0.3
34160255,2,8,2.0,10,0.2
34163270,2,8,2.0,10,0.2
34163428,4,5,4.0,9,0.4444444444444444
34166058,6,13,6.0,19,0.3157894736842105
34179385,2,8,2.0,10,0.2
34194655,2,18,2.0,20,0.1
34198748,3,7,3.0,10,0.3
34203582,2,8,2.0,10,0.2
34218159,3,23,3.0,26,0.11538461538461539
34222275,4,6,4.0,10,0.4
34224934,5,4,4.0,9,0.4444444444444444
34246219,1,29,1.0,30,0.03333333333333333
34249381,2,8,2.0,10,0.2
34249527,3,7,3.0,10,0.3
34249558,14,13,13.0,27,0.48148148148148145
34252747,6,14,6.0,20,0.3
34266293,3,16,3.0,19,0.15789473684210525
34299572,1,8,1.0,9,0.1111111111111111
34315729,4,25,4.0,29,0.13793103448275862
34326813,2,18,2.0,20,0.1
34328588,1,7,1.0,8,0.125
34343442,2,8,2.0,10,0.2
34347319,3,6,3.0,9,0.3333333333333333
34347964,3,5,3.0,8,0.375
34348995,8,11,8.0,19,0.42105263157894735
34374354,1,9,1.0,10,0.1
34375931,2,8,2.0,10,0.2
34389024,5,4,4.0,9,0.4444444444444444
34391629,1,9,1.0,10,0.1
34391834,1,9,1.0,10,0.1
34392046,1,9,1.0,10,0.1
34405876,1,19,1.0,20,0.05
34422328,1,18,1.0,19,0.05263157894736842
34422691,1,9,1.0,10,0.1
34424860,5,5,5.0,10,0.5
34427838,1,19,1.0,20,0.05
34438965,2,6,2.0,8,0.25
34441528,5,5,5.0,10,0.5
34442015,7,3,3.0,10,0.3
34452972,1,18,1.0,19,0.05263157894736842
34464164,12,17,12.0,29,0.41379310344827586
34465849,1,9,1.0,10,0.1
34484562,1,8,1.0,9,0.1111111111111111
34495620,1,9,1.0,10,0.1
34514747,9,1,1.0,10,0.1
34516166,1,8,1.0,9,0.1111111111111111
34517125,7,3,3.0,10,0.3
34518700,2,18,2.0,20,0.1
34520703,5,5,5.0,10,0.5
34522218,4,5,4.0,9,0.4444444444444444
34523412,5,5,5.0,10,0.5
34531426,3,6,3.0,9,0.3333333333333333
34580422,1,8,1.0,9,0.1111111111111111
34581027,3,15,3.0,18,0.16666666666666666
34581129,8,1,1.0,9,0.1111111111111111
34629326,5,4,4.0,9,0.4444444444444444
34640068,2,8,2.0,10,0.2
34649367,1,8,1.0,9,0.1111111111111111
34657104,1,8,1.0,9,0.1111111111111111
34662488,3,15,3.0,18,0.16666666666666666
34665393,4,6,4.0,10,0.4
34669254,1,8,1.0,9,0.1111111111111111
34669464,2,7,2.0,9,0.2222222222222222
34672643,5,5,5.0,10,0.5
34729737,1,19,1.0,20,0.05
34730891,1,9,1.0,10,0.1
34731319,7,3,3.0,10,0.3
34731745,2,8,2.0,10,0.2
34731831,3,16,3.0,19,0.15789473684210525
34732224,1,8,1.0,9,0.1111111111111111
34737413,2,26,2.0,28,0.07142857142857142
34765377,1,9,1.0,10,0.1
34766296,5,5,5.0,10,0.5
34770077,1,8,1.0,9,0.1111111111111111
34771671,2,8,2.0,10,0.2
34772775,3,7,3.0,10,0.3
34781661,8,2,2.0,10,0.2
34782434,17,13,13.0,30,0.43333333333333335
34785735,1,7,1.0,8,0.125
34786098,2,8,2.0,10,0.2
34795853,2,6,2.0,8,0.25
34803398,1,8,1.0,9,0.1111111111111111
34805449,1,9,1.0,10,0.1
34808384,2,7,2.0,9,0.2222222222222222
34809080,2,7,2.0,9,0.2222222222222222
34819787,2,7,2.0,9,0.2222222222222222
34827596,1,8,1.0,9,0.1111111111111111
34837310,1,9,1.0,10,0.1
34837439,1,9,1.0,10,0.1
34838650,1,19,1.0,20,0.05
34855952,7,20,7.0,27,0.25925925925925924
34862197,2,7,2.0,9,0.2222222222222222
34869151,2,8,2.0,10,0.2
34870533,3,16,3.0,19,0.15789473684210525
34897317,2,7,2.0,9,0.2222222222222222
34922573,4,5,4.0,9,0.4444444444444444
34934804,2,7,2.0,9,0.2222222222222222
34941415,7,2,2.0,9,0.2222222222222222
34941506,5,4,4.0,9,0.4444444444444444
34948635,5,4,4.0,9,0.4444444444444444
34964542,5,4,4.0,9,0.4444444444444444
34964863,3,17,3.0,20,0.15
34990075,2,8,2.0,10,0.2
34998326,1,17,1.0,18,0.05555555555555555
35001884,5,15,5.0,20,0.25
35022605,1,8,1.0,9,0.1111111111111111
35041308,1,8,1.0,9,0.1111111111111111
35099854,2,8,2.0,10,0.2
35111936,2,8,2.0,10,0.2
35120395,5,4,4.0,9,0.4444444444444444
35123478,1,9,1.0,10,0.1
35133901,1,9,1.0,10,0.1
35136267,1,9,1.0,10,0.1
35152829,2,17,2.0,19,0.10526315789473684
35178268,5,14,5.0,19,0.2631578947368421
35179858,9,1,1.0,10,0.1
35181467,9,1,1.0,10,0.1
35185952,1,7,1.0,8,0.125
35191610,3,7,3.0,10,0.3
35198974,2,8,2.0,10,0.2
35199879,5,5,5.0,10,0.5
35202206,1,9,1.0,10,0.1
35204212,3,6,3.0,9,0.3333333333333333
35205175,1,7,1.0,8,0.125
35214135,1,8,1.0,9,0.1111111111111111
35214514,1,19,1.0,20,0.05
35220980,3,7,3.0,10,0.3
35224726,5,5,5.0,10,0.5
35226881,7,21,7.0,28,0.25
35231694,2,8,2.0,10,0.2
35232611,2,8,2.0,10,0.2
35237810,2,8,2.0,10,0.2
35238855,14,16,14.0,30,0.4666666666666667
35240181,5,13,5.0,18,0.2777777777777778
35252079,1,7,1.0,8,0.125
35253552,1,9,1.0,10,0.1
35278791,6,4,4.0,10,0.4
35279960,1,9,1.0,10,0.1
35285768,1,9,1.0,10,0.1
35307053,1,9,1.0,10,0.1
35313301,1,9,1.0,10,0.1
35313913,2,7,2.0,9,0.2222222222222222
35314961,1,9,1.0,10,0.1
35317903,1,9,1.0,10,0.1
35319711,1,8,1.0,9,0.1111111111111111
35351187,1,9,1.0,10,0.1
35355157,1,8,1.0,9,0.1111111111111111
35355354,1,18,1.0,19,0.05263157894736842
35359137,3,26,3.0,29,0.10344827586206896
35368771,3,16,3.0,19,0.15789473684210525
35390536,1,7,1.0,8,0.125
35404165,1,9,1.0,10,0.1
35410523,3,26,3.0,29,0.10344827586206896
35437285,2,8,2.0,10,0.2
35438469,2,17,2.0,19,0.10526315789473684
35438616,2,15,2.0,17,0.11764705882352941
35439151,16,12,12.0,28,0.42857142857142855
35441898,5,5,5.0,10,0.5
35445625,22,8,8.0,30,0.26666666666666666
35457337,5,5,5.0,10,0.5
35469441,7,2,2.0,9,0.2222222222222222
35469498,2,8,2.0,10,0.2
35474302,1,9,1.0,10,0.1
35486941,1,19,1.0,20,0.05
35487265,3,7,3.0,10,0.3
35503935,1,8,1.0,9,0.1111111111111111
35504619,4,6,4.0,10,0.4
35506774,2,8,2.0,10,0.2
35507218,1,8,1.0,9,0.1111111111111111
35511341,7,1,1.0,8,0.125
35512341,1,9,1.0,10,0.1
35534196,2,7,2.0,9,0.2222222222222222
35545583,6,4,4.0,10,0.4
35598535,6,3,3.0,9,0.3333333333333333
35599012,8,2,2.0,10,0.2
35601044,2,8,2.0,10,0.2
35601712,3,7,3.0,10,0.3
35625010,3,6,3.0,9,0.3333333333333333
35625627,6,23,6.0,29,0.20689655172413793
35626218,2,7,2.0,9,0.2222222222222222
35627233,8,2,2.0,10,0.2
35629007,2,8,2.0,10,0.2
35630018,2,8,2.0,10,0.2
35640696,1,8,1.0,9,0.1111111111111111
35653943,2,7,2.0,9,0.2222222222222222
35663032,1,8,1.0,9,0.1111111111111111
35664622,5,3,3.0,8,0.375
35670825,9,1,1.0,10,0.1
35673800,1,16,1.0,17,0.058823529411764705
35676576,1,9,1.0,10,0.1
35677926,1,8,1.0,9,0.1111111111111111
35680326,1,18,1.0,19,0.05263157894736842
35703399,2,6,2.0,8,0.25
35703462,3,14,3.0,17,0.17647058823529413
35722529,1,8,1.0,9,0.1111111111111111
35723042,2,25,2.0,27,0.07407407407407407
35723246,8,2,2.0,10,0.2
35723989,3,6,3.0,9,0.3333333333333333
35724680,8,2,2.0,10,0.2
35730554,8,2,2.0,10,0.2
35737376,1,8,1.0,9,0.1111111111111111
35739124,8,2,2.0,10,0.2
35748442,2,8,2.0,10,0.2
35758352,5,5,5.0,10,0.5
35759035,21,7,7.0,28,0.25
35761751,3,7,3.0,10,0.3
35764314,13,13,13.0,26,0.5
35765236,1,19,1.0,20,0.05
35777446,1,9,1.0,10,0.1
35779184,1,8,1.0,9,0.1111111111111111
35783231,6,4,4.0,10,0.4
35799832,6,23,6.0,29,0.20689655172413793
35806052,4,6,4.0,10,0.4
35819235,2,8,2.0,10,0.2
35835572,2,8,2.0,10,0.2
35838932,2,17,2.0,19,0.10526315789473684
35848000,3,6,3.0,9,0.3333333333333333
35849123,1,17,1.0,18,0.05555555555555555
35855621,6,2,2.0,8,0.25
35856239,7,2,2.0,9,0.2222222222222222
35858860,1,29,1.0,30,0.03333333333333333
35867763,8,1,1.0,9,0.1111111111111111
35868512,1,17,1.0,18,0.05555555555555555
35871938,9,20,9.0,29,0.3103448275862069
35874396,2,8,2.0,10,0.2
35875625,4,6,4.0,10,0.4
35885456,1,8,1.0,9,0.1111111111111111
35898399,2,8,2.0,10,0.2
35902474,2,17,2.0,19,0.10526315789473684
35909625,1,7,1.0,8,0.125
35917589,1,8,1.0,9,0.1111111111111111
35922493,8,20,8.0,28,0.2857142857142857
35938357,2,7,2.0,9,0.2222222222222222
35941597,1,7,1.0,8,0.125
35962133,1,7,1.0,8,0.125
35963602,3,16,3.0,19,0.15789473684210525
35963882,2,18,2.0,20,0.1
35969759,2,8,2.0,10,0.2
35976612,8,20,8.0,28,0.2857142857142857
35984118,5,4,4.0,9,0.4444444444444444
35986611,2,18,2.0,20,0.1
36005428,3,17,3.0,20,0.15
36022450,7,2,2.0,9,0.2222222222222222
36026897,2,7,2.0,9,0.2222222222222222
36039233,4,5,4.0,9,0.4444444444444444
36046874,5,5,5.0,10,0.5
36059736,1,9,1.0,10,0.1
36061467,3,15,3.0,18,0.16666666666666666
36068446,3,7,3.0,10,0.3
36069914,1,8,1.0,9,0.1111111111111111
36070271,5,5,5.0,10,0.5
36076511,1,19,1.0,20,0.05
36083966,1,9,1.0,10,0.1
36098189,2,8,2.0,10,0.2
36100765,4,15,4.0,19,0.21052631578947367
36106934,7,2,2.0,9,0.2222222222222222
36126190,4,5,4.0,9,0.4444444444444444
36126660,9,1,1.0,10,0.1
36133673,8,2,2.0,10,0.2
36134097,4,5,4.0,9,0.4444444444444444
36136213,17,9,9.0,26,0.34615384615384615
36141088,3,6,3.0,9,0.3333333333333333
36142501,8,2,2.0,10,0.2
36152537,2,6,2.0,8,0.25
36159820,3,7,3.0,10,0.3
36163985,8,2,2.0,10,0.2
36184139,1,9,1.0,10,0.1
36191962,3,6,3.0,9,0.3333333333333333
36192406,7,2,2.0,9,0.2222222222222222
36192520,3,6,3.0,9,0.3333333333333333
36193272,3,7,3.0,10,0.3
36196649,1,9,1.0,10,0.1
36197201,2,7,2.0,9,0.2222222222222222
36197881,2,8,2.0,10,0.2
36198618,2,7,2.0,9,0.2222222222222222
36199520,1,9,1.0,10,0.1
36215674,1,9,1.0,10,0.1
36216872,2,8,2.0,10,0.2
36254286,1,9,1.0,10,0.1
36256210,5,5,5.0,10,0.5
36264126,1,7,1.0,8,0.125
36265891,1,8,1.0,9,0.1111111111111111
36267740,1,9,1.0,10,0.1
36267996,1,28,1.0,29,0.034482758620689655
36268143,2,8,2.0,10,0.2
36270520,9,1,1.0,10,0.1
36275677,2,8,2.0,10,0.2
36278664,1,9,1.0,10,0.1
36279674,2,8,2.0,10,0.2
36281335,7,3,3.0,10,0.3
36281647,2,7,2.0,9,0.2222222222222222
36281929,1,18,1.0,19,0.05263157894736842
36282953,1,7,1.0,8,0.125
36283055,1,8,1.0,9,0.1111111111111111
36290683,4,5,4.0,9,0.4444444444444444
36291006,1,9,1.0,10,0.1
36291376,1,9,1.0,10,0.1
36296834,1,8,1.0,9,0.1111111111111111
36302500,2,27,2.0,29,0.06896551724137931
36302906,2,27,2.0,29,0.06896551724137931
36303418,1,9,1.0,10,0.1
36308971,2,8,2.0,10,0.2
36317180,6,4,4.0,10,0.4
36322408,2,8,2.0,10,0.2
36329850,5,5,5.0,10,0.5
36360763,1,16,1.0,17,0.058823529411764705
36375378,1,8,1.0,9,0.1111111111111111
36380900,1,16,1.0,17,0.058823529411764705
36388638,1,9,1.0,10,0.1
36407956,2,8,2.0,10,0.2
36448182,1,9,1.0,10,0.1
36448827,2,8,2.0,10,0.2
36477504,1,9,1.0,10,0.1
36479935,1,18,1.0,19,0.05263157894736842
36491438,1,9,1.0,10,0.1
36526851,5,13,5.0,18,0.2777777777777778
36531427,6,4,4.0,10,0.4
36545797,1,9,1.0,10,0.1
36546621,9,1,1.0,10,0.1
36546939,4,5,4.0,9,0.4444444444444444
36547926,1,9,1.0,10,0.1
36549200,6,3,3.0,9,0.3333333333333333
36556311,8,2,2.0,10,0.2
36560703,4,5,4.0,9,0.4444444444444444
36560770,19,6,6.0,25,0.24
36561649,2,8,2.0,10,0.2
36561869,5,5,5.0,10,0.5
36561987,5,5,5.0,10,0.5
36564117,1,9,1.0,10,0.1
36572934,1,9,1.0,10,0.1
36573650,1,9,1.0,10,0.1
36576684,2,8,2.0,10,0.2
36582758,18,9,9.0,27,0.3333333333333333
36585898,6,2,2.0,8,0.25
36588175,3,6,3.0,9,0.3333333333333333
36592612,2,8,2.0,10,0.2
36595174,8,1,1.0,9,0.1111111111111111
36596435,5,4,4.0,9,0.4444444444444444
36597733,1,8,1.0,9,0.1111111111111111
36626984,4,16,4.0,20,0.2
36646598,1,17,1.0,18,0.05555555555555555
36664207,1,8,1.0,9,0.1111111111111111
36667170,1,9,1.0,10,0.1
36679089,9,1,1.0,10,0.1
36679691,7,3,3.0,10,0.3
36679726,8,2,2.0,10,0.2
36680615,9,1,1.0,10,0.1
36684746,1,8,1.0,9,0.1111111111111111
36685987,5,5,5.0,10,0.5
36686856,9,1,1.0,10,0.1
36687286,7,2,2.0,9,0.2222222222222222
36692130,6,2,2.0,8,0.25
36693406,2,8,2.0,10,0.2
36699135,1,8,1.0,9,0.1111111111111111
36699479,1,8,1.0,9,0.1111111111111111
36704970,6,4,4.0,10,0.4
36728153,1,9,1.0,10,0.1
36747299,1,9,1.0,10,0.1
36809438,4,6,4.0,10,0.4
36810042,2,8,2.0,10,0.2
36821259,2,8,2.0,10,0.2
36822657,1,9,1.0,10,0.1
36823448,2,7,2.0,9,0.2222222222222222
36842257,9,1,1.0,10,0.1
36844018,27,2,2.0,29,0.06896551724137931
36851882,1,9,1.0,10,0.1
36852769,2,8,2.0,10,0.2
36873149,1,9,1.0,10,0.1
36877130,4,6,4.0,10,0.4
36877934,7,1,1.0,8,0.125
36879053,6,4,4.0,10,0.4
36899745,1,9,1.0,10,0.1
36903127,2,8,2.0,10,0.2
36926340,2,8,2.0,10,0.2
36933062,4,14,4.0,18,0.2222222222222222
36940449,2,8,2.0,10,0.2
36949358,1,8,1.0,9,0.1111111111111111
36985542,7,20,7.0,27,0.25925925925925924
36987329,6,4,4.0,10,0.4
37008158,6,3,3.0,9,0.3333333333333333
37015465,8,21,8.0,29,0.27586206896551724
37017218,2,8,2.0,10,0.2
37024822,9,1,1.0,10,0.1
37031290,9,1,1.0,10,0.1
37072306,1,9,1.0,10,0.1
37082520,5,5,5.0,10,0.5
37083780,2,17,2.0,19,0.10526315789473684
37101031,3,6,3.0,9,0.3333333333333333
37109722,1,9,1.0,10,0.1
37109978,3,5,3.0,8,0.375
37110904,8,2,2.0,10,0.2
37121126,1,7,1.0,8,0.125
37134759,1,9,1.0,10,0.1
37135568,9,7,7.0,16,0.4375
37144574,1,9,1.0,10,0.1
37174852,1,8,1.0,9,0.1111111111111111
37178820,1,9,1.0,10,0.1
37195464,2,8,2.0,10,0.2
37196271,3,7,3.0,10,0.3
37211193,4,6,4.0,10,0.4
37230397,3,6,3.0,9,0.3333333333333333
37237961,1,8,1.0,9,0.1111111111111111
37241529,28,1,1.0,29,0.034482758620689655
37247008,4,5,4.0,9,0.4444444444444444
37257893,1,9,1.0,10,0.1
37267438,2,8,2.0,10,0.2
37269582,1,9,1.0,10,0.1
37270864,1,9,1.0,10,0.1
37272601,3,6,3.0,9,0.3333333333333333
37278772,9,1,1.0,10,0.1
37281353,9,1,1.0,10,0.1
37283756,1,9,1.0,10,0.1
37286927,6,4,4.0,10,0.4
37289570,1,9,1.0,10,0.1
37296213,1,19,1.0,20,0.05
37296615,1,26,1.0,27,0.037037037037037035
37296897,1,8,1.0,9,0.1111111111111111
37300809,1,8,1.0,9,0.1111111111111111
37301808,1,9,1.0,10,0.1
37306508,1,9,1.0,10,0.1
37317964,2,6,2.0,8,0.25
37333539,10,17,10.0,27,0.37037037037037035
37347283,6,4,4.0,10,0.4
37347598,4,4,4.0,8,0.5
37348410,28,2,2.0,30,0.06666666666666667
37349877,9,1,1.0,10,0.1
37351406,9,1,1.0,10,0.1
37351587,3,5,3.0,8,0.375
37370186,6,3,3.0,9,0.3333333333333333
37370341,3,26,3.0,29,0.10344827586206896
37384777,2,8,2.0,10,0.2
37389526,1,9,1.0,10,0.1
37392173,3,6,3.0,9,0.3333333333333333
37408127,5,5,5.0,10,0.5
37414153,2,8,2.0,10,0.2
37414789,2,7,2.0,9,0.2222222222222222
37439599,7,22,7.0,29,0.2413793103448276
37440771,3,6,3.0,9,0.3333333333333333
37441539,2,8,2.0,10,0.2
37452484,4,5,4.0,9,0.4444444444444444
37462191,1,26,1.0,27,0.037037037037037035
37469927,1,9,1.0,10,0.1
37470783,2,7,2.0,9,0.2222222222222222
37471118,2,7,2.0,9,0.2222222222222222
37471992,3,7,3.0,10,0.3
37485270,3,7,3.0,10,0.3
37487865,3,6,3.0,9,0.3333333333333333
37541061,9,1,1.0,10,0.1
37559495,1,9,1.0,10,0.1
37570984,5,5,5.0,10,0.5
37574592,6,4,4.0,10,0.4
37575352,2,8,2.0,10,0.2
37582871,4,5,4.0,9,0.4444444444444444
37586712,1,9,1.0,10,0.1
37615069,4,5,4.0,9,0.4444444444444444
37626533,1,9,1.0,10,0.1
37636644,1,9,1.0,10,0.1
37637277,1,9,1.0,10,0.1
37638320,2,8,2.0,10,0.2
37640842,1,18,1.0,19,0.05263157894736842
37642126,2,8,2.0,10,0.2
37648214,2,18,2.0,20,0.1
37662910,6,3,3.0,9,0.3333333333333333
37693508,4,6,4.0,10,0.4
37699818,1,8,1.0,9,0.1111111111111111
37701667,1,18,1.0,19,0.05263157894736842
37713411,2,8,2.0,10,0.2
37715087,1,8,1.0,9,0.1111111111111111
37717187,7,2,2.0,9,0.2222222222222222
37718139,1,9,1.0,10,0.1
37736310,2,18,2.0,20,0.1
37742279,2,16,2.0,18,0.1111111111111111
37748664,6,13,6.0,19,0.3157894736842105
37748968,1,8,1.0,9,0.1111111111111111
37757017,8,1,1.0,9,0.1111111111111111
37757287,9,1,1.0,10,0.1
37757842,6,3,3.0,9,0.3333333333333333
37769943,2,8,2.0,10,0.2
37789028,1,9,1.0,10,0.1
37790395,4,6,4.0,10,0.4
37839079,1,9,1.0,10,0.1
37846841,5,5,5.0,10,0.5
37861700,1,9,1.0,10,0.1
37865618,1,8,1.0,9,0.1111111111111111
37873279,1,8,1.0,9,0.1111111111111111
37876938,1,9,1.0,10,0.1
37881386,1,9,1.0,10,0.1
37885374,6,4,4.0,10,0.4
37886158,2,8,2.0,10,0.2
37886357,1,9,1.0,10,0.1
37889442,6,4,4.0,10,0.4
37889876,2,8,2.0,10,0.2
37895074,5,5,5.0,10,0.5
37899884,2,18,2.0,20,0.1
37901451,1,9,1.0,10,0.1
37906007,1,8,1.0,9,0.1111111111111111
37912969,2,8,2.0,10,0.2
37920812,1,9,1.0,10,0.1
37945814,1,9,1.0,10,0.1
37964541,4,5,4.0,9,0.4444444444444444
37971710,1,19,1.0,20,0.05
37978240,1,18,1.0,19,0.05263157894736842
37997833,1,18,1.0,19,0.05263157894736842
38019862,2,7,2.0,9,0.2222222222222222
38033971,5,5,5.0,10,0.5
38034639,3,7,3.0,10,0.3
38051334,2,8,2.0,10,0.2
38052993,6,4,4.0,10,0.4
38053577,5,5,5.0,10,0.5
38053814,6,3,3.0,9,0.3333333333333333
38055285,1,18,1.0,19,0.05263157894736842
38058021,1,9,1.0,10,0.1
38060703,2,8,2.0,10,0.2
38066635,2,8,2.0,10,0.2
38085010,1,19,1.0,20,0.05
38098384,2,17,2.0,19,0.10526315789473684
38099918,1,16,1.0,17,0.058823529411764705
38105399,3,7,3.0,10,0.3
38106354,2,7,2.0,9,0.2222222222222222
38109906,2,8,2.0,10,0.2
38110479,1,8,1.0,9,0.1111111111111111
38141163,1,8,1.0,9,0.1111111111111111
38141325,2,7,2.0,9,0.2222222222222222
38144835,5,4,4.0,9,0.4444444444444444
38184299,1,19,1.0,20,0.05
38197873,1,9,1.0,10,0.1
38204191,5,5,5.0,10,0.5
38204330,2,6,2.0,8,0.25
38206039,1,8,1.0,9,0.1111111111111111
38209863,8,2,2.0,10,0.2
38224767,6,4,4.0,10,0.4
38232877,4,5,4.0,9,0.4444444444444444
38232928,1,9,1.0,10,0.1
38256961,1,7,1.0,8,0.125
38275471,1,8,1.0,9,0.1111111111111111
38289595,2,8,2.0,10,0.2
38331964,2,8,2.0,10,0.2
38360915,1,9,1.0,10,0.1
38382501,5,4,4.0,9,0.4444444444444444
38391504,1,8,1.0,9,0.1111111111111111
38412673,2,8,2.0,10,0.2
38413090,1,9,1.0,10,0.1
38423066,1,8,1.0,9,0.1111111111111111
38461571,1,9,1.0,10,0.1
38475645,1,9,1.0,10,0.1
38480525,1,8,1.0,9,0.1111111111111111
38482133,1,8,1.0,9,0.1111111111111111
38483418,1,7,1.0,8,0.125
38486388,1,9,1.0,10,0.1
38486944,2,7,2.0,9,0.2222222222222222
38490526,4,6,4.0,10,0.4
38491441,1,9,1.0,10,0.1
38492413,4,6,4.0,10,0.4
38493257,6,4,4.0,10,0.4
38493480,1,9,1.0,10,0.1
38493687,2,8,2.0,10,0.2
38494374,1,9,1.0,10,0.1
38498831,2,8,2.0,10,0.2
38502239,6,23,6.0,29,0.20689655172413793
38511632,1,9,1.0,10,0.1
38513436,1,9,1.0,10,0.1
38516704,8,1,1.0,9,0.1111111111111111
38517322,4,4,4.0,8,0.5
38517702,7,2,2.0,9,0.2222222222222222
38517790,1,9,1.0,10,0.1
38521289,1,9,1.0,10,0.1
38523638,2,17,2.0,19,0.10526315789473684
38534331,3,5,3.0,8,0.375
38546894,2,8,2.0,10,0.2
38547793,3,7,3.0,10,0.3
38548126,2,7,2.0,9,0.2222222222222222
38553147,5,5,5.0,10,0.5
38562862,1,9,1.0,10,0.1
38587003,1,8,1.0,9,0.1111111111111111
38598614,3,7,3.0,10,0.3
38601066,1,8,1.0,9,0.1111111111111111
38606777,1,19,1.0,20,0.05
38614872,3,26,3.0,29,0.10344827586206896
38615020,1,9,1.0,10,0.1
38616146,20,6,6.0,26,0.23076923076923078
38625078,1,9,1.0,10,0.1
38637293,1,9,1.0,10,0.1
38643296,1,9,1.0,10,0.1
38651552,3,7,3.0,10,0.3
38662703,1,9,1.0,10,0.1
38664039,1,8,1.0,9,0.1111111111111111
38666319,1,8,1.0,9,0.1111111111111111
38668051,1,9,1.0,10,0.1
38687044,3,5,3.0,8,0.375
38687192,1,19,1.0,20,0.05
38690763,2,17,2.0,19,0.10526315789473684
38692481,2,7,2.0,9,0.2222222222222222
38697505,1,9,1.0,10,0.1
38705432,1,8,1.0,9,0.1111111111111111
38709311,4,6,4.0,10,0.4
38709802,1,9,1.0,10,0.1
38715226,2,7,2.0,9,0.2222222222222222
38719176,1,9,1.0,10,0.1
38726527,2,8,2.0,10,0.2
38747685,1,8,1.0,9,0.1111111111111111
38747921,3,7,3.0,10,0.3
38760618,3,7,3.0,10,0.3
38761059,6,4,4.0,10,0.4
38765382,1,18,1.0,19,0.05263157894736842
38766191,1,19,1.0,20,0.05
38773560,2,15,2.0,17,0.11764705882352941
38778665,7,2,2.0,9,0.2222222222222222
38780707,6,4,4.0,10,0.4
38788461,1,9,1.0,10,0.1
38789534,6,3,3.0,9,0.3333333333333333
38790176,5,24,5.0,29,0.1724137931034483
38790519,4,6,4.0,10,0.4
38791072,1,9,1.0,10,0.1
38812651,1,9,1.0,10,0.1
38851973,8,19,8.0,27,0.2962962962962963
38854080,2,7,2.0,9,0.2222222222222222
38854269,1,9,1.0,10,0.1
38856599,3,25,3.0,28,0.10714285714285714
38858089,3,26,3.0,29,0.10344827586206896
38858181,1,8,1.0,9,0.1111111111111111
38866787,2,8,2.0,10,0.2
38869009,7,3,3.0,10,0.3
38884913,1,9,1.0,10,0.1
38888831,1,9,1.0,10,0.1
38926805,7,3,3.0,10,0.3
38934436,2,7,2.0,9,0.2222222222222222
38936720,3,15,3.0,18,0.16666666666666666
38970392,1,18,1.0,19,0.05263157894736842
38999368,2,7,2.0,9,0.2222222222222222
39011693,4,4,4.0,8,0.5
39013206,5,4,4.0,9,0.4444444444444444
39018297,1,26,1.0,27,0.037037037037037035
39035377,4,6,4.0,10,0.4
39046493,4,6,4.0,10,0.4
39046860,7,2,2.0,9,0.2222222222222222
39051816,5,5,5.0,10,0.5
39052280,6,3,3.0,9,0.3333333333333333
39052468,18,2,2.0,20,0.1
39054866,1,9,1.0,10,0.1
39062290,1,17,1.0,18,0.05555555555555555
39063323,6,3,3.0,9,0.3333333333333333
39077160,1,9,1.0,10,0.1
39086432,2,17,2.0,19,0.10526315789473684
39086764,1,9,1.0,10,0.1
39091205,1,9,1.0,10,0.1
39093922,1,18,1.0,19,0.05263157894736842
39095881,5,13,5.0,18,0.2777777777777778
39107917,1,9,1.0,10,0.1
39118215,1,9,1.0,10,0.1
39123028,5,5,5.0,10,0.5
39131920,1,9,1.0,10,0.1
39133605,6,13,6.0,19,0.3157894736842105
39139968,3,16,3.0,19,0.15789473684210525
39145724,1,8,1.0,9,0.1111111111111111
39201165,2,8,2.0,10,0.2
39201729,2,8,2.0,10,0.2
39213047,3,6,3.0,9,0.3333333333333333
39228857,4,6,4.0,10,0.4
39231330,2,25,2.0,27,0.07407407407407407
39233746,6,4,4.0,10,0.4
39243114,1,8,1.0,9,0.1111111111111111
39246347,1,9,1.0,10,0.1
39261876,3,7,3.0,10,0.3
39262151,1,8,1.0,9,0.1111111111111111
39272348,3,7,3.0,10,0.3
39284943,1,8,1.0,9,0.1111111111111111
39287519,1,9,1.0,10,0.1
39290757,2,8,2.0,10,0.2
39294818,2,18,2.0,20,0.1
39322292,4,15,4.0,19,0.21052631578947367
39323223,2,7,2.0,9,0.2222222222222222
39323730,9,1,1.0,10,0.1
39331716,7,3,3.0,10,0.3
39347198,3,7,3.0,10,0.3
39352817,1,9,1.0,10,0.1
39355242,1,9,1.0,10,0.1
39372206,1,8,1.0,9,0.1111111111111111
39380823,1,26,1.0,27,0.037037037037037035
39384922,2,8,2.0,10,0.2
39400076,2,7,2.0,9,0.2222222222222222
39403146,3,7,3.0,10,0.3
39406260,4,5,4.0,9,0.4444444444444444
39418543,3,7,3.0,10,0.3
39421590,1,28,1.0,29,0.034482758620689655
39434615,24,4,4.0,28,0.14285714285714285
39435745,1,15,1.0,16,0.0625
39436573,1,9,1.0,10,0.1
39455551,3,5,3.0,8,0.375
39456616,3,6,3.0,9,0.3333333333333333
39456838,14,15,14.0,29,0.4827586206896552
39456904,6,3,3.0,9,0.3333333333333333
39460010,1,8,1.0,9,0.1111111111111111
39461401,1,9,1.0,10,0.1
39461670,1,9,1.0,10,0.1
39462730,15,13,13.0,28,0.4642857142857143
39464117,1,9,1.0,10,0.1
39516553,1,17,1.0,18,0.05555555555555555
39524200,9,1,1.0,10,0.1
39536447,6,4,4.0,10,0.4
39545764,6,14,6.0,20,0.3
39546377,6,4,4.0,10,0.4
39547841,3,7,3.0,10,0.3
39555464,2,8,2.0,10,0.2
39556069,2,8,2.0,10,0.2
39556282,1,16,1.0,17,0.058823529411764705
39556470,1,9,1.0,10,0.1
39561022,1,19,1.0,20,0.05
39561469,1,9,1.0,10,0.1
39561799,5,4,4.0,9,0.4444444444444444
39563842,1,9,1.0,10,0.1
39575510,5,5,5.0,10,0.5
39575570,1,9,1.0,10,0.1
39576268,1,18,1.0,19,0.05263157894736842
39580183,6,3,3.0,9,0.3333333333333333
39580387,8,1,1.0,9,0.1111111111111111
39600681,4,5,4.0,9,0.4444444444444444
39601181,8,1,1.0,9,0.1111111111111111
39604487,1,9,1.0,10,0.1
39604622,4,6,4.0,10,0.4
39605516,4,5,4.0,9,0.4444444444444444
39606226,2,8,2.0,10,0.2
39606666,1,8,1.0,9,0.1111111111111111
39608070,5,5,5.0,10,0.5
39610298,1,19,1.0,20,0.05
39611479,5,5,5.0,10,0.5
39612667,1,19,1.0,20,0.05
39617383,2,8,2.0,10,0.2
39618448,15,12,12.0,27,0.4444444444444444
39619155,1,8,1.0,9,0.1111111111111111
39623007,4,5,4.0,9,0.4444444444444444
39627034,3,6,3.0,9,0.3333333333333333
39630831,1,9,1.0,10,0.1
39633975,1,9,1.0,10,0.1
39636658,1,17,1.0,18,0.05555555555555555
39636922,1,9,1.0,10,0.1
39646018,4,5,4.0,9,0.4444444444444444
39646676,2,7,2.0,9,0.2222222222222222
39647640,7,3,3.0,10,0.3
39661468,4,4,4.0,8,0.5
39663459,1,9,1.0,10,0.1
39667757,1,9,1.0,10,0.1
39671248,1,8,1.0,9,0.1111111111111111
39678969,1,18,1.0,19,0.05263157894736842
39682250,2,7,2.0,9,0.2222222222222222
39688469,1,18,1.0,19,0.05263157894736842
39688835,4,5,4.0,9,0.4444444444444444
39689192,1,9,1.0,10,0.1
39690180,6,4,4.0,10,0.4
39698154,1,8,1.0,9,0.1111111111111111
39714279,7,13,7.0,20,0.35
39721002,1,8,1.0,9,0.1111111111111111
39733504,1,8,1.0,9,0.1111111111111111
39745476,2,18,2.0,20,0.1
39751995,3,22,3.0,25,0.12
39754170,1,9,1.0,10,0.1
39754778,2,8,2.0,10,0.2
39755668,3,7,3.0,10,0.3
39756045,1,9,1.0,10,0.1
39761774,3,7,3.0,10,0.3
39773482,2,8,2.0,10,0.2
39783742,1,16,1.0,17,0.058823529411764705
39785303,1,9,1.0,10,0.1
39792866,2,7,2.0,9,0.2222222222222222
39801209,5,4,4.0,9,0.4444444444444444
39801325,3,6,3.0,9,0.3333333333333333
39801890,2,7,2.0,9,0.2222222222222222
39810403,3,7,3.0,10,0.3
39810831,1,9,1.0,10,0.1
39811110,1,9,1.0,10,0.1
39812798,8,2,2.0,10,0.2
39817483,6,4,4.0,10,0.4
39826135,1,9,1.0,10,0.1
39827499,1,9,1.0,10,0.1
39827799,2,8,2.0,10,0.2
39829163,2,7,2.0,9,0.2222222222222222
39829497,1,9,1.0,10,0.1
39829806,2,6,2.0,8,0.25
39835834,3,6,3.0,9,0.3333333333333333
39836598,5,3,3.0,8,0.375
39840158,1,17,1.0,18,0.05555555555555555
39844767,3,7,3.0,10,0.3
39847460,1,8,1.0,9,0.1111111111111111
39852707,2,17,2.0,19,0.10526315789473684
39854205,2,8,2.0,10,0.2
39857415,2,6,2.0,8,0.25
39858989,2,8,2.0,10,0.2
39867589,1,9,1.0,10,0.1
39876729,4,21,4.0,25,0.16
39892896,4,6,4.0,10,0.4
39895137,8,2,2.0,10,0.2
39896210,6,4,4.0,10,0.4
39896855,3,6,3.0,9,0.3333333333333333
39897037,1,9,1.0,10,0.1
39897304,1,9,1.0,10,0.1
39899678,4,6,4.0,10,0.4
39900940,2,7,2.0,9,0.2222222222222222
39901133,2,7,2.0,9,0.2222222222222222
39902327,8,22,8.0,30,0.26666666666666666
39905682,3,7,3.0,10,0.3
39906070,1,8,1.0,9,0.1111111111111111
39921464,1,9,1.0,10,0.1
39946370,17,12,12.0,29,0.41379310344827586
39946471,7,20,7.0,27,0.25925925925925924
39950564,1,8,1.0,9,0.1111111111111111
39951463,7,3,3.0,10,0.3
39952343,5,5,5.0,10,0.5
39962473,2,7,2.0,9,0.2222222222222222
39969757,1,9,1.0,10,0.1
39969782,12,7,7.0,19,0.3684210526315789
39974812,1,9,1.0,10,0.1
39982180,1,7,1.0,8,0.125
39982352,2,25,2.0,27,0.07407407407407407
39993972,3,6,3.0,9,0.3333333333333333
39994159,1,9,1.0,10,0.1
39998151,1,9,1.0,10,0.1
40003714,1,9,1.0,10,0.1
40016330,7,3,3.0,10,0.3
40020853,7,13,7.0,20,0.35
40028439,1,8,1.0,9,0.1111111111111111
40041870,3,7,3.0,10,0.3
40047291,6,21,6.0,27,0.2222222222222222
40057325,1,9,1.0,10,0.1
40090019,1,9,1.0,10,0.1
40144825,1,8,1.0,9,0.1111111111111111
40146110,2,8,2.0,10,0.2
40157357,6,3,3.0,9,0.3333333333333333
40160069,6,3,3.0,9,0.3333333333333333
40160270,1,9,1.0,10,0.1
40161432,1,9,1.0,10,0.1
40162135,1,9,1.0,10,0.1
40164639,5,4,4.0,9,0.4444444444444444
40165012,2,7,2.0,9,0.2222222222222222
40166065,2,7,2.0,9,0.2222222222222222
40172852,1,28,1.0,29,0.034482758620689655
40173182,8,21,8.0,29,0.27586206896551724
40183579,2,8,2.0,10,0.2
40185280,4,6,4.0,10,0.4
40185736,7,3,3.0,10,0.3
40188392,1,9,1.0,10,0.1
40191215,1,18,1.0,19,0.05263157894736842
40196008,4,5,4.0,9,0.4444444444444444
40197100,4,5,4.0,9,0.4444444444444444
40211759,9,1,1.0,10,0.1
40212794,2,8,2.0,10,0.2
40215106,6,14,6.0,20,0.3
40218063,4,6,4.0,10,0.4
40218352,3,7,3.0,10,0.3
40219107,8,22,8.0,30,0.26666666666666666
40219664,4,5,4.0,9,0.4444444444444444
40234580,3,7,3.0,10,0.3
40240919,1,17,1.0,18,0.05555555555555555
40247291,1,18,1.0,19,0.05263157894736842
40250717,1,8,1.0,9,0.1111111111111111
40251013,1,8,1.0,9,0.1111111111111111
40273255,13,17,13.0,30,0.43333333333333335
40281680,1,8,1.0,9,0.1111111111111111
40315468,1,27,1.0,28,0.03571428571428571
40316561,3,6,3.0,9,0.3333333333333333
40316601,13,6,6.0,19,0.3157894736842105
40317087,4,4,4.0,8,0.5
40318295,7,2,2.0,9,0.2222222222222222
40318800,9,1,1.0,10,0.1
40319168,1,9,1.0,10,0.1
40357241,2,8,2.0,10,0.2
40357735,2,7,2.0,9,0.2222222222222222
40358529,1,9,1.0,10,0.1
40361413,1,19,1.0,20,0.05
40373944,7,2,2.0,9,0.2222222222222222
40389771,10,17,10.0,27,0.37037037037037035
40397158,1,19,1.0,20,0.05
40423174,1,9,1.0,10,0.1
40426169,4,6,4.0,10,0.4
40426200,8,2,2.0,10,0.2
40426568,8,2,2.0,10,0.2
40427210,6,3,3.0,9,0.3333333333333333
40427814,17,13,13.0,30,0.43333333333333335
40449580,2,8,2.0,10,0.2
40450674,1,8,1.0,9,0.1111111111111111
40467086,1,8,1.0,9,0.1111111111111111
40473990,6,4,4.0,10,0.4
40474688,7,3,3.0,10,0.3
40478802,1,9,1.0,10,0.1
40490363,1,9,1.0,10,0.1
40497425,1,8,1.0,9,0.1111111111111111
40507630,2,8,2.0,10,0.2
40508854,9,1,1.0,10,0.1
40508958,6,3,3.0,9,0.3333333333333333
40509974,2,8,2.0,10,0.2
40512469,1,19,1.0,20,0.05
40518281,1,8,1.0,9,0.1111111111111111
40518686,1,9,1.0,10,0.1
40519594,3,7,3.0,10,0.3
40520037,6,3,3.0,9,0.3333333333333333
40520654,3,15,3.0,18,0.16666666666666666
40530646,2,8,2.0,10,0.2
40531174,7,2,2.0,9,0.2222222222222222
40544179,3,7,3.0,10,0.3
40544459,5,3,3.0,8,0.375
40544824,3,6,3.0,9,0.3333333333333333
40544944,8,2,2.0,10,0.2
40546548,1,9,1.0,10,0.1
40548197,3,6,3.0,9,0.3333333333333333
40549530,13,14,13.0,27,0.48148148148148145
40550269,2,7,2.0,9,0.2222222222222222
40551155,3,6,3.0,9,0.3333333333333333
40554299,2,6,2.0,8,0.25
40555383,2,6,2.0,8,0.25
40559326,3,7,3.0,10,0.3
40561684,1,9,1.0,10,0.1
40562273,1,9,1.0,10,0.1
40586762,1,9,1.0,10,0.1
40596554,1,9,1.0,10,0.1
40600096,8,2,2.0,10,0.2
40636456,1,8,1.0,9,0.1111111111111111
40638047,1,7,1.0,8,0.125
40652635,2,8,2.0,10,0.2
40655069,2,8,2.0,10,0.2
40663415,1,9,1.0,10,0.1
40667529,3,27,3.0,30,0.1
40680109,2,6,2.0,8,0.25
40681496,1,9,1.0,10,0.1
40696739,2,7,2.0,9,0.2222222222222222
40697609,1,8,1.0,9,0.1111111111111111
40702401,1,9,1.0,10,0.1
40704806,1,18,1.0,19,0.05263157894736842
40717734,1,17,1.0,18,0.05555555555555555
40728342,1,17,1.0,18,0.05555555555555555
40746307,1,19,1.0,20,0.05
40749201,3,7,3.0,10,0.3
40757563,3,7,3.0,10,0.3
40761348,1,7,1.0,8,0.125
40787023,2,18,2.0,20,0.1
40793431,9,1,1.0,10,0.1
40819406,1,9,1.0,10,0.1
40831198,1,19,1.0,20,0.05
40835477,2,7,2.0,9,0.2222222222222222
40835760,9,1,1.0,10,0.1
40836507,4,6,4.0,10,0.4
40836966,2,8,2.0,10,0.2
40856814,1,9,1.0,10,0.1
40859862,9,1,1.0,10,0.1
40860184,3,7,3.0,10,0.3
40860509,5,4,4.0,9,0.4444444444444444
40860833,8,2,2.0,10,0.2
40874345,2,8,2.0,10,0.2
40894512,1,8,1.0,9,0.1111111111111111
40911930,1,9,1.0,10,0.1
40916145,4,5,4.0,9,0.4444444444444444
40918105,8,1,1.0,9,0.1111111111111111
40918747,1,9,1.0,10,0.1
40922741,1,9,1.0,10,0.1
40935333,3,6,3.0,9,0.3333333333333333
40945005,2,8,2.0,10,0.2
40946138,1,7,1.0,8,0.125
40949547,1,8,1.0,9,0.1111111111111111
40957344,7,3,3.0,10,0.3
40957432,1,7,1.0,8,0.125
40963321,3,6,3.0,9,0.3333333333333333
40985391,1,17,1.0,18,0.05555555555555555
41017374,1,9,1.0,10,0.1
41032570,1,8,1.0,9,0.1111111111111111
41037086,5,5,5.0,10,0.5
41069329,6,4,4.0,10,0.4
41074303,7,1,1.0,8,0.125
41074774,6,4,4.0,10,0.4
41075302,1,8,1.0,9,0.1111111111111111
41078225,3,7,3.0,10,0.3
41080519,9,1,1.0,10,0.1
41081067,6,4,4.0,10,0.4
41081435,3,6,3.0,9,0.3333333333333333
41081527,3,6,3.0,9,0.3333333333333333
41082041,3,6,3.0,9,0.3333333333333333
41099914,1,8,1.0,9,0.1111111111111111
41106673,3,6,3.0,9,0.3333333333333333
41109601,9,1,1.0,10,0.1
41111375,1,9,1.0,10,0.1
41112210,2,7,2.0,9,0.2222222222222222
41123736,1,8,1.0,9,0.1111111111111111
41135830,4,6,4.0,10,0.4
41137970,1,9,1.0,10,0.1
41139441,1,9,1.0,10,0.1
41148907,3,16,3.0,19,0.15789473684210525
41152414,1,9,1.0,10,0.1
41175076,1,19,1.0,20,0.05
41175548,1,7,1.0,8,0.125
41182668,7,3,3.0,10,0.3
41190738,1,9,1.0,10,0.1
41195135,2,8,2.0,10,0.2
41208023,2,7,2.0,9,0.2222222222222222
41208177,11,15,11.0,26,0.4230769230769231
41211876,7,11,7.0,18,0.3888888888888889
41212118,3,7,3.0,10,0.3
41230257,1,17,1.0,18,0.05555555555555555
41233064,1,9,1.0,10,0.1
41252049,2,8,2.0,10,0.2
41254656,1,9,1.0,10,0.1
41262255,4,5,4.0,9,0.4444444444444444
41265825,1,9,1.0,10,0.1
41270305,6,14,6.0,20,0.3
41273625,1,18,1.0,19,0.05263157894736842
41279954,1,9,1.0,10,0.1
41280397,1,9,1.0,10,0.1
41281412,1,8,1.0,9,0.1111111111111111
41286203,3,16,3.0,19,0.15789473684210525
41288701,4,6,4.0,10,0.4
41292439,2,8,2.0,10,0.2
41293679,1,9,1.0,10,0.1
41294846,4,5,4.0,9,0.4444444444444444
41295059,2,8,2.0,10,0.2
41303138,15,13,13.0,28,0.4642857142857143
41310024,1,9,1.0,10,0.1
41312061,16,3,3.0,19,0.15789473684210525
41347279,1,17,1.0,18,0.05555555555555555
41365660,4,6,4.0,10,0.4
41373772,6,3,3.0,9,0.3333333333333333
41408843,1,19,1.0,20,0.05
41413721,2,7,2.0,9,0.2222222222222222
41427932,1,7,1.0,8,0.125
41435608,9,1,1.0,10,0.1
41435704,2,18,2.0,20,0.1
41463674,1,9,1.0,10,0.1
41471157,1,9,1.0,10,0.1
41474031,1,9,1.0,10,0.1
41499385,1,8,1.0,9,0.1111111111111111
41514796,3,6,3.0,9,0.3333333333333333
41518637,1,9,1.0,10,0.1
41524250,6,4,4.0,10,0.4
41526512,3,7,3.0,10,0.3
41538177,2,8,2.0,10,0.2
41539667,7,3,3.0,10,0.3
41547445,2,8,2.0,10,0.2
41551623,1,29,1.0,30,0.03333333333333333
41551773,6,3,3.0,9,0.3333333333333333
41552358,1,8,1.0,9,0.1111111111111111
41557825,1,19,1.0,20,0.05
41561321,1,8,1.0,9,0.1111111111111111
41595406,1,9,1.0,10,0.1
41600018,2,8,2.0,10,0.2
41607144,6,4,4.0,10,0.4
41607610,4,4,4.0,8,0.5
41608128,1,9,1.0,10,0.1
41629686,1,9,1.0,10,0.1
41635107,1,8,1.0,9,0.1111111111111111
41643558,22,5,5.0,27,0.18518518518518517
41651375,1,9,1.0,10,0.1
41651415,2,8,2.0,10,0.2
41670322,1,9,1.0,10,0.1
41671841,2,7,2.0,9,0.2222222222222222
41684373,5,5,5.0,10,0.5
41688228,1,9,1.0,10,0.1
41690412,1,19,1.0,20,0.05
41692397,5,15,5.0,20,0.25
41699533,2,7,2.0,9,0.2222222222222222
41701044,1,9,1.0,10,0.1
41702415,6,3,3.0,9,0.3333333333333333
41719168,5,4,4.0,9,0.4444444444444444
41721245,4,6,4.0,10,0.4
41722845,9,1,1.0,10,0.1
41723500,5,4,4.0,9,0.4444444444444444
41725645,5,5,5.0,10,0.5
41746894,1,8,1.0,9,0.1111111111111111
41763233,1,8,1.0,9,0.1111111111111111
41774433,1,17,1.0,18,0.05555555555555555
41804654,3,6,3.0,9,0.3333333333333333
41806876,3,7,3.0,10,0.3
41807922,3,6,3.0,9,0.3333333333333333
41817400,6,9,6.0,15,0.4
41840368,2,8,2.0,10,0.2
41841787,1,19,1.0,20,0.05
41845177,3,25,3.0,28,0.10714285714285714
41845749,5,4,4.0,9,0.4444444444444444
41846127,2,8,2.0,10,0.2
41850248,1,19,1.0,20,0.05
41855165,5,4,4.0,9,0.4444444444444444
41904190,1,8,1.0,9,0.1111111111111111
41908530,2,8,2.0,10,0.2
41909402,2,8,2.0,10,0.2
41911976,1,18,1.0,19,0.05263157894736842
41917583,3,5,3.0,8,0.375
41926316,4,5,4.0,9,0.4444444444444444
41937474,1,19,1.0,20,0.05
41939831,1,8,1.0,9,0.1111111111111111
41941244,1,9,1.0,10,0.1
41943348,1,9,1.0,10,0.1
41943638,1,7,1.0,8,0.125
41949524,1,9,1.0,10,0.1
41983132,1,8,1.0,9,0.1111111111111111
41988891,1,19,1.0,20,0.05
41997703,1,8,1.0,9,0.1111111111111111
41997796,2,7,2.0,9,0.2222222222222222
42004079,1,9,1.0,10,0.1
42004397,6,4,4.0,10,0.4
42006444,5,14,5.0,19,0.2631578947368421
42007080,2,7,2.0,9,0.2222222222222222
42014372,3,6,3.0,9,0.3333333333333333
42018232,2,28,2.0,30,0.06666666666666667
42019449,1,9,1.0,10,0.1
42068955,3,7,3.0,10,0.3
42069700,3,26,3.0,29,0.10344827586206896
42083758,3,7,3.0,10,0.3
42084704,3,15,3.0,18,0.16666666666666666
42087709,1,8,1.0,9,0.1111111111111111
42116044,8,1,1.0,9,0.1111111111111111
42118057,7,3,3.0,10,0.3
42119585,4,5,4.0,9,0.4444444444444444
42135768,2,7,2.0,9,0.2222222222222222
42142852,3,6,3.0,9,0.3333333333333333
42145790,9,18,9.0,27,0.3333333333333333
42154282,1,9,1.0,10,0.1
42174747,3,7,3.0,10,0.3
42180060,6,14,6.0,20,0.3
42182639,4,6,4.0,10,0.4
42206660,2,8,2.0,10,0.2
42210183,4,6,4.0,10,0.4
42210455,1,9,1.0,10,0.1
42211680,3,6,3.0,9,0.3333333333333333
42224714,1,9,1.0,10,0.1
42226379,1,9,1.0,10,0.1
42231754,1,8,1.0,9,0.1111111111111111
42238139,1,9,1.0,10,0.1
42240608,7,12,7.0,19,0.3684210526315789
42246210,4,15,4.0,19,0.21052631578947367
42265049,2,25,2.0,27,0.07407407407407407
42276545,3,17,3.0,20,0.15
42288938,2,7,2.0,9,0.2222222222222222
42294848,5,5,5.0,10,0.5
42295475,2,8,2.0,10,0.2
42301372,1,9,1.0,10,0.1
42313136,1,8,1.0,9,0.1111111111111111
42332398,9,1,1.0,10,0.1
42332429,9,1,1.0,10,0.1
42337635,5,14,5.0,19,0.2631578947368421
42339418,6,3,3.0,9,0.3333333333333333
42339992,1,8,1.0,9,0.1111111111111111
42340266,2,8,2.0,10,0.2
42352341,6,4,4.0,10,0.4
42354537,5,5,5.0,10,0.5
42371246,5,5,5.0,10,0.5
42372220,1,8,1.0,9,0.1111111111111111
42373551,4,6,4.0,10,0.4
42386528,1,9,1.0,10,0.1
42392025,1,19,1.0,20,0.05
42399896,1,8,1.0,9,0.1111111111111111
42405245,2,8,2.0,10,0.2
42405273,5,5,5.0,10,0.5
42411336,1,18,1.0,19,0.05263157894736842
42414510,1,9,1.0,10,0.1
42416831,2,8,2.0,10,0.2
42420567,3,17,3.0,20,0.15
42428682,7,22,7.0,29,0.2413793103448276
42429669,1,8,1.0,9,0.1111111111111111
42431393,1,7,1.0,8,0.125
42432038,1,16,1.0,17,0.058823529411764705
42435717,3,7,3.0,10,0.3
42437251,2,8,2.0,10,0.2
42440419,1,9,1.0,10,0.1
42446965,3,7,3.0,10,0.3
42448507,5,5,5.0,10,0.5
42448635,2,7,2.0,9,0.2222222222222222
42475620,5,4,4.0,9,0.4444444444444444
42481139,7,3,3.0,10,0.3
42483847,6,4,4.0,10,0.4
42485419,3,7,3.0,10,0.3
42485893,1,8,1.0,9,0.1111111111111111
42486178,11,14,11.0,25,0.44
42487532,8,2,2.0,10,0.2
42487691,21,9,9.0,30,0.3
42501285,1,17,1.0,18,0.05555555555555555
42519043,1,8,1.0,9,0.1111111111111111
42526048,1,8,1.0,9,0.1111111111111111
42550165,2,7,2.0,9,0.2222222222222222
42553340,1,9,1.0,10,0.1
42581035,3,16,3.0,19,0.15789473684210525
42629118,8,1,1.0,9,0.1111111111111111
42629301,8,2,2.0,10,0.2
42629431,8,1,1.0,9,0.1111111111111111
42635417,1,26,1.0,27,0.037037037037037035
42675933,1,9,1.0,10,0.1
42688364,1,8,1.0,9,0.1111111111111111
42693893,3,7,3.0,10,0.3
42694852,7,3,3.0,10,0.3
42696011,5,4,4.0,9,0.4444444444444444
42696323,2,17,2.0,19,0.10526315789473684
42696368,8,1,1.0,9,0.1111111111111111
42701865,1,25,1.0,26,0.038461538461538464
42702213,5,5,5.0,10,0.5
42703440,7,3,3.0,10,0.3
42708072,9,1,1.0,10,0.1
42708722,5,5,5.0,10,0.5
42727521,4,22,4.0,26,0.15384615384615385
42735126,4,5,4.0,9,0.4444444444444444
42737572,2,8,2.0,10,0.2
42747765,2,7,2.0,9,0.2222222222222222
42758906,1,9,1.0,10,0.1
42759758,2,7,2.0,9,0.2222222222222222
42764550,2,8,2.0,10,0.2
42772059,3,7,3.0,10,0.3
42799033,2,17,2.0,19,0.10526315789473684
42800484,1,8,1.0,9,0.1111111111111111
42812363,8,2,2.0,10,0.2
42812447,5,4,4.0,9,0.4444444444444444
42813759,6,13,6.0,19,0.3157894736842105
42822386,1,26,1.0,27,0.037037037037037035
42824125,3,7,3.0,10,0.3
42826515,2,7,2.0,9,0.2222222222222222
42828465,3,7,3.0,10,0.3
42831146,8,2,2.0,10,0.2
42832354,1,7,1.0,8,0.125
42837705,3,7,3.0,10,0.3
42838708,1,8,1.0,9,0.1111111111111111
42840115,1,8,1.0,9,0.1111111111111111
42873195,1,23,1.0,24,0.041666666666666664
42878721,1,9,1.0,10,0.1
42900030,1,8,1.0,9,0.1111111111111111
42900302,5,5,5.0,10,0.5
42908753,1,19,1.0,20,0.05
42912199,2,15,2.0,17,0.11764705882352941
42924638,1,9,1.0,10,0.1
42938792,6,4,4.0,10,0.4
42938892,8,2,2.0,10,0.2
42939192,2,8,2.0,10,0.2
42939208,8,1,1.0,9,0.1111111111111111
42940225,5,5,5.0,10,0.5
42940751,4,5,4.0,9,0.4444444444444444
42945442,3,5,3.0,8,0.375
42945920,8,1,1.0,9,0.1111111111111111
42946172,1,9,1.0,10,0.1
42995307,8,11,8.0,19,0.42105263157894735
43015917,4,6,4.0,10,0.4
43020569,8,2,2.0,10,0.2
43023161,2,7,2.0,9,0.2222222222222222
43023754,6,3,3.0,9,0.3333333333333333
43024416,1,9,1.0,10,0.1
43038642,5,3,3.0,8,0.375
43042471,4,6,4.0,10,0.4
43059099,1,9,1.0,10,0.1
43063056,1,17,1.0,18,0.05555555555555555
43067504,14,4,4.0,18,0.2222222222222222
43069145,2,27,2.0,29,0.06896551724137931
43069199,7,21,7.0,28,0.25
43069349,24,5,5.0,29,0.1724137931034483
43069453,9,1,1.0,10,0.1
43069824,6,2,2.0,8,0.25
43085809,6,4,4.0,10,0.4
43086273,6,4,4.0,10,0.4
43095844,2,7,2.0,9,0.2222222222222222
43097157,3,25,3.0,28,0.10714285714285714
43107132,1,8,1.0,9,0.1111111111111111
43117480,2,8,2.0,10,0.2
43118815,3,7,3.0,10,0.3
43119497,16,11,11.0,27,0.4074074074074074
43128571,7,3,3.0,10,0.3
43134660,1,7,1.0,8,0.125
43137585,1,9,1.0,10,0.1
43151358,7,3,3.0,10,0.3
43157444,1,19,1.0,20,0.05
43167301,2,8,2.0,10,0.2
43167594,1,9,1.0,10,0.1
43174687,2,18,2.0,20,0.1
43185594,1,18,1.0,19,0.05263157894736842
43185810,1,19,1.0,20,0.05
43208863,1,8,1.0,9,0.1111111111111111
43217651,1,7,1.0,8,0.125
43219639,1,8,1.0,9,0.1111111111111111
43222257,2,8,2.0,10,0.2
43223406,1,18,1.0,19,0.05263157894736842
43224057,1,9,1.0,10,0.1
43228364,2,8,2.0,10,0.2
43241335,5,13,5.0,18,0.2777777777777778
43256447,6,4,4.0,10,0.4
43263702,5,3,3.0,8,0.375
43263946,7,1,1.0,8,0.125
43264036,8,2,2.0,10,0.2
43267107,1,18,1.0,19,0.05263157894736842
43271088,8,21,8.0,29,0.27586206896551724
43271347,1,18,1.0,19,0.05263157894736842
43279743,3,7,3.0,10,0.3
43280125,2,8,2.0,10,0.2
43290567,2,7,2.0,9,0.2222222222222222
43290708,2,6,2.0,8,0.25
43291416,1,19,1.0,20,0.05
43294102,2,8,2.0,10,0.2
43294966,6,4,4.0,10,0.4
43295039,1,9,1.0,10,0.1
43322168,2,8,2.0,10,0.2
43323929,1,9,1.0,10,0.1
43324052,6,4,4.0,10,0.4
43327392,1,9,1.0,10,0.1
43330990,1,8,1.0,9,0.1111111111111111
43331867,2,8,2.0,10,0.2
43333240,2,8,2.0,10,0.2
43339456,1,8,1.0,9,0.1111111111111111
43339869,1,26,1.0,27,0.037037037037037035
43344825,1,8,1.0,9,0.1111111111111111
43349633,2,8,2.0,10,0.2
43354977,1,18,1.0,19,0.05263157894736842
43356834,2,7,2.0,9,0.2222222222222222
43375240,3,7,3.0,10,0.3
43386199,1,9,1.0,10,0.1
43390544,1,9,1.0,10,0.1
43392237,1,9,1.0,10,0.1
43397074,1,9,1.0,10,0.1
43404433,8,2,2.0,10,0.2
43405435,6,23,6.0,29,0.20689655172413793
43407658,7,3,3.0,10,0.3
43415989,2,8,2.0,10,0.2
43417149,1,8,1.0,9,0.1111111111111111
43419395,14,5,5.0,19,0.2631578947368421
43419907,1,9,1.0,10,0.1
43421521,5,22,5.0,27,0.18518518518518517
43429681,3,7,3.0,10,0.3
43436464,2,8,2.0,10,0.2
43437561,2,8,2.0,10,0.2
43442505,1,19,1.0,20,0.05
43443181,1,17,1.0,18,0.05555555555555555
43457186,1,18,1.0,19,0.05263157894736842
43460000,1,9,1.0,10,0.1
43460799,5,4,4.0,9,0.4444444444444444
43461181,2,8,2.0,10,0.2
43464963,3,16,3.0,19,0.15789473684210525
43469670,6,4,4.0,10,0.4
43470290,1,9,1.0,10,0.1
43470761,1,9,1.0,10,0.1
43489903,3,16,3.0,19,0.15789473684210525
43492567,4,6,4.0,10,0.4
43523678,1,9,1.0,10,0.1
43530257,2,7,2.0,9,0.2222222222222222
43538553,6,4,4.0,10,0.4
43542014,2,18,2.0,20,0.1
43560828,2,8,2.0,10,0.2
43566256,5,5,5.0,10,0.5
43568732,2,8,2.0,10,0.2
43572250,8,2,2.0,10,0.2
43572879,1,8,1.0,9,0.1111111111111111
43583213,3,24,3.0,27,0.1111111111111111
43583392,1,9,1.0,10,0.1
43599559,9,1,1.0,10,0.1
43615706,2,7,2.0,9,0.2222222222222222
43617335,6,3,3.0,9,0.3333333333333333
43621158,1,8,1.0,9,0.1111111111111111
43633518,1,9,1.0,10,0.1
43634042,7,3,3.0,10,0.3
43635698,2,8,2.0,10,0.2
43637296,9,1,1.0,10,0.1
43641214,5,5,5.0,10,0.5
43641988,4,6,4.0,10,0.4
43643742,1,8,1.0,9,0.1111111111111111
43646893,1,9,1.0,10,0.1
43648525,6,3,3.0,9,0.3333333333333333
43650283,2,8,2.0,10,0.2
43651231,7,2,2.0,9,0.2222222222222222
43651664,9,1,1.0,10,0.1
43652824,1,9,1.0,10,0.1
43652930,2,8,2.0,10,0.2
43654423,2,15,2.0,17,0.11764705882352941
43659543,5,5,5.0,10,0.5
43659787,1,8,1.0,9,0.1111111111111111
43661208,5,5,5.0,10,0.5
43665290,7,3,3.0,10,0.3
43667070,2,8,2.0,10,0.2
43685762,4,6,4.0,10,0.4
43688116,8,1,1.0,9,0.1111111111111111
43716131,1,9,1.0,10,0.1
43757550,1,9,1.0,10,0.1
43764881,3,7,3.0,10,0.3
43765612,1,8,1.0,9,0.1111111111111111
43767660,3,5,3.0,8,0.375
43768013,4,5,4.0,9,0.4444444444444444
43769993,1,9,1.0,10,0.1
43772781,2,8,2.0,10,0.2
43778154,1,9,1.0,10,0.1
43783412,2,8,2.0,10,0.2
43784329,4,5,4.0,9,0.4444444444444444
43801539,4,6,4.0,10,0.4
43812083,1,19,1.0,20,0.05
43817568,2,18,2.0,20,0.1
43836992,2,8,2.0,10,0.2
43842213,3,7,3.0,10,0.3
43845199,3,7,3.0,10,0.3
43851727,1,9,1.0,10,0.1
43855255,4,24,4.0,28,0.14285714285714285
43856943,1,9,1.0,10,0.1
43857996,3,7,3.0,10,0.3
43869900,6,3,3.0,9,0.3333333333333333
43873861,1,9,1.0,10,0.1
43875003,2,26,2.0,28,0.07142857142857142
43877178,1,18,1.0,19,0.05263157894736842
43882711,2,8,2.0,10,0.2
43882856,1,16,1.0,17,0.058823529411764705
43883085,4,6,4.0,10,0.4
43883637,2,7,2.0,9,0.2222222222222222
43884045,2,8,2.0,10,0.2
43886147,2,8,2.0,10,0.2
43901416,1,9,1.0,10,0.1
43929252,5,5,5.0,10,0.5
43938494,4,26,4.0,30,0.13333333333333333
43941275,1,9,1.0,10,0.1
43947132,1,9,1.0,10,0.1
43947402,2,8,2.0,10,0.2
43948251,3,17,3.0,20,0.15
43948380,4,6,4.0,10,0.4
43951443,2,7,2.0,9,0.2222222222222222
43954713,5,24,5.0,29,0.1724137931034483
43960877,7,1,1.0,8,0.125
43963042,1,19,1.0,20,0.05
43964141,1,19,1.0,20,0.05
43978382,2,17,2.0,19,0.10526315789473684
44005528,5,5,5.0,10,0.5
44006029,2,7,2.0,9,0.2222222222222222
44006700,7,3,3.0,10,0.3
44012141,5,4,4.0,9,0.4444444444444444
44015706,5,5,5.0,10,0.5
44038820,1,9,1.0,10,0.1
44061975,2,8,2.0,10,0.2
44065798,12,16,12.0,28,0.42857142857142855
44076495,9,1,1.0,10,0.1
44097074,1,7,1.0,8,0.125
44105326,1,19,1.0,20,0.05
44120540,1,18,1.0,19,0.05263157894736842
44130749,1,8,1.0,9,0.1111111111111111
44134357,1,18,1.0,19,0.05263157894736842
44139517,1,9,1.0,10,0.1
44148874,1,9,1.0,10,0.1
44177074,3,7,3.0,10,0.3
44179796,2,8,2.0,10,0.2
44183514,7,11,7.0,18,0.3888888888888889
44184203,3,25,3.0,28,0.10714285714285714
44203571,2,18,2.0,20,0.1
44208262,7,1,1.0,8,0.125
44211087,7,3,3.0,10,0.3
44213511,2,8,2.0,10,0.2
44220510,1,18,1.0,19,0.05263157894736842
44221246,1,9,1.0,10,0.1
44226107,1,9,1.0,10,0.1
44256440,3,7,3.0,10,0.3
44273349,3,24,3.0,27,0.1111111111111111
44278164,1,8,1.0,9,0.1111111111111111
44284183,2,7,2.0,9,0.2222222222222222
44284563,3,25,3.0,28,0.10714285714285714
44285058,2,8,2.0,10,0.2
44301874,1,7,1.0,8,0.125
44302677,1,9,1.0,10,0.1
44303154,1,8,1.0,9,0.1111111111111111
44305520,2,7,2.0,9,0.2222222222222222
44308685,1,9,1.0,10,0.1
44310471,1,8,1.0,9,0.1111111111111111
44310652,8,2,2.0,10,0.2
44336174,8,2,2.0,10,0.2
44336318,5,4,4.0,9,0.4444444444444444
44336478,5,5,5.0,10,0.5
44338256,1,9,1.0,10,0.1
44353081,2,7,2.0,9,0.2222222222222222
44354859,1,9,1.0,10,0.1
44360514,3,6,3.0,9,0.3333333333333333
44363358,1,9,1.0,10,0.1
44369010,1,9,1.0,10,0.1
44382812,1,9,1.0,10,0.1
44393609,6,4,4.0,10,0.4
44402925,3,7,3.0,10,0.3
44441467,2,8,2.0,10,0.2
44450593,1,17,1.0,18,0.05555555555555555
44479011,1,9,1.0,10,0.1
44483062,6,4,4.0,10,0.4
44497433,2,6,2.0,8,0.25
44497719,3,7,3.0,10,0.3
44497758,7,3,3.0,10,0.3
44507864,2,7,2.0,9,0.2222222222222222
44511018,1,9,1.0,10,0.1
44518198,6,3,3.0,9,0.3333333333333333
44523658,4,6,4.0,10,0.4
44523918,1,9,1.0,10,0.1
44524363,3,16,3.0,19,0.15789473684210525
44528263,1,19,1.0,20,0.05
44528813,3,7,3.0,10,0.3
44529541,13,15,13.0,28,0.4642857142857143
44531464,4,6,4.0,10,0.4
44531672,3,7,3.0,10,0.3
44531793,1,8,1.0,9,0.1111111111111111
44532678,4,6,4.0,10,0.4
44533198,4,5,4.0,9,0.4444444444444444
44537656,3,23,3.0,26,0.11538461538461539
44538239,2,7,2.0,9,0.2222222222222222
44545451,8,2,2.0,10,0.2
44551081,7,22,7.0,29,0.2413793103448276
44578245,1,18,1.0,19,0.05263157894736842
44599349,18,1,1.0,19,0.05263157894736842
44602850,4,6,4.0,10,0.4
44629993,4,4,4.0,8,0.5
44631460,1,9,1.0,10,0.1
44634886,1,9,1.0,10,0.1
44635193,1,9,1.0,10,0.1
44636510,4,6,4.0,10,0.4
44636996,1,9,1.0,10,0.1
44661860,1,9,1.0,10,0.1
44662649,2,8,2.0,10,0.2
44673170,10,10,10.0,20,0.5
44684003,19,8,8.0,27,0.2962962962962963
44694397,1,7,1.0,8,0.125
44707485,6,4,4.0,10,0.4
44713374,3,6,3.0,9,0.3333333333333333
44714777,1,9,1.0,10,0.1
44716628,2,8,2.0,10,0.2
44717185,1,19,1.0,20,0.05
44718876,2,8,2.0,10,0.2
44721938,1,8,1.0,9,0.1111111111111111
44727682,1,8,1.0,9,0.1111111111111111
44743792,2,8,2.0,10,0.2
44750958,1,9,1.0,10,0.1
44751786,6,4,4.0,10,0.4
44752365,5,5,5.0,10,0.5
44753390,3,7,3.0,10,0.3
44753673,5,5,5.0,10,0.5
44761098,1,9,1.0,10,0.1
44761421,1,9,1.0,10,0.1
44777227,6,3,3.0,9,0.3333333333333333
44778093,3,5,3.0,8,0.375
44778286,3,7,3.0,10,0.3
44784822,1,7,1.0,8,0.125
44791703,2,8,2.0,10,0.2
44819261,12,15,12.0,27,0.4444444444444444
44819324,7,1,1.0,8,0.125
44851839,1,9,1.0,10,0.1
44867968,4,5,4.0,9,0.4444444444444444
44868557,2,8,2.0,10,0.2
44869629,3,6,3.0,9,0.3333333333333333
44869975,4,6,4.0,10,0.4
44871643,6,4,4.0,10,0.4
44871992,2,7,2.0,9,0.2222222222222222
44874921,7,2,2.0,9,0.2222222222222222
44880966,1,8,1.0,9,0.1111111111111111
44881180,1,9,1.0,10,0.1
44881390,2,8,2.0,10,0.2
44881872,1,8,1.0,9,0.1111111111111111
44889728,2,7,2.0,9,0.2222222222222222
44891429,4,5,4.0,9,0.4444444444444444
44912076,4,6,4.0,10,0.4
44929823,1,9,1.0,10,0.1
44936536,1,9,1.0,10,0.1
44938766,7,3,3.0,10,0.3
44939723,4,6,4.0,10,0.4
44942316,2,6,2.0,8,0.25
44942446,8,2,2.0,10,0.2
44942680,2,25,2.0,27,0.07407407407407407
44947825,1,9,1.0,10,0.1
44957540,6,3,3.0,9,0.3333333333333333
44958228,5,4,4.0,9,0.4444444444444444
44975145,1,8,1.0,9,0.1111111111111111
45003566,1,9,1.0,10,0.1
45018912,4,6,4.0,10,0.4
45024750,4,6,4.0,10,0.4
45043033,1,8,1.0,9,0.1111111111111111
45043448,1,9,1.0,10,0.1
45053602,1,9,1.0,10,0.1
45067466,3,7,3.0,10,0.3
45068268,3,6,3.0,9,0.3333333333333333
45069791,4,5,4.0,9,0.4444444444444444
45070258,2,7,2.0,9,0.2222222222222222
45070308,1,9,1.0,10,0.1
45083372,3,7,3.0,10,0.3
45083584,7,3,3.0,10,0.3
45108822,6,4,4.0,10,0.4
45118509,2,27,2.0,29,0.06896551724137931
45175658,3,14,3.0,17,0.17647058823529413
45185849,2,8,2.0,10,0.2
45207521,8,2,2.0,10,0.2
45214229,1,19,1.0,20,0.05
45221917,18,2,2.0,20,0.1
45231640,1,15,1.0,16,0.0625
45234354,5,5,5.0,10,0.5
45240304,1,9,1.0,10,0.1
45263240,1,8,1.0,9,0.1111111111111111
45276973,1,9,1.0,10,0.1
45287651,1,9,1.0,10,0.1
45325050,12,16,12.0,28,0.42857142857142855
45326308,1,9,1.0,10,0.1
45329049,2,8,2.0,10,0.2
45352451,4,6,4.0,10,0.4
45370134,3,5,3.0,8,0.375
45383556,1,9,1.0,10,0.1
45384359,2,7,2.0,9,0.2222222222222222
45384435,5,22,5.0,27,0.18518518518518517
45397857,1,9,1.0,10,0.1
45400319,1,9,1.0,10,0.1
45425694,1,9,1.0,10,0.1
45425940,2,8,2.0,10,0.2
45426218,6,4,4.0,10,0.4
45428437,1,9,1.0,10,0.1
45430011,7,3,3.0,10,0.3
45430576,13,7,7.0,20,0.35
45430780,6,4,4.0,10,0.4
45450486,1,8,1.0,9,0.1111111111111111
45454916,2,7,2.0,9,0.2222222222222222
45455267,4,5,4.0,9,0.4444444444444444
45455505,1,8,1.0,9,0.1111111111111111
45467891,6,12,6.0,18,0.3333333333333333
45469209,5,5,5.0,10,0.5
45485229,3,6,3.0,9,0.3333333333333333
45485627,2,8,2.0,10,0.2
45491671,1,9,1.0,10,0.1
45516521,1,9,1.0,10,0.1
45526645,1,16,1.0,17,0.058823529411764705
45526907,1,9,1.0,10,0.1
45544464,2,26,2.0,28,0.07142857142857142
45546407,1,9,1.0,10,0.1
45557203,3,6,3.0,9,0.3333333333333333
45561127,2,8,2.0,10,0.2
45563808,3,7,3.0,10,0.3
45572167,1,9,1.0,10,0.1
45582649,6,4,4.0,10,0.4
45589553,3,6,3.0,9,0.3333333333333333
45591627,1,8,1.0,9,0.1111111111111111
45599139,1,8,1.0,9,0.1111111111111111
45600508,1,17,1.0,18,0.05555555555555555
45607195,3,16,3.0,19,0.15789473684210525
45614823,1,8,1.0,9,0.1111111111111111
45629286,1,8,1.0,9,0.1111111111111111
45642498,3,7,3.0,10,0.3
45654204,2,7,2.0,9,0.2222222222222222
45659424,1,9,1.0,10,0.1
45679087,1,28,1.0,29,0.034482758620689655
45703024,1,9,1.0,10,0.1
45715908,1,7,1.0,8,0.125
45734743,4,6,4.0,10,0.4
45744445,2,8,2.0,10,0.2
45745490,13,15,13.0,28,0.4642857142857143
45745960,9,1,1.0,10,0.1
45748375,5,4,4.0,9,0.4444444444444444
45759610,1,8,1.0,9,0.1111111111111111
45759724,3,6,3.0,9,0.3333333333333333
45760129,1,9,1.0,10,0.1
45762371,4,4,4.0,8,0.5
45764851,1,8,1.0,9,0.1111111111111111
45774710,1,9,1.0,10,0.1
45816070,2,7,2.0,9,0.2222222222222222
45821646,6,3,3.0,9,0.3333333333333333
45823628,1,8,1.0,9,0.1111111111111111
45825578,5,23,5.0,28,0.17857142857142858
45827584,4,25,4.0,29,0.13793103448275862
45828154,4,14,4.0,18,0.2222222222222222
45828542,9,18,9.0,27,0.3333333333333333
45828613,2,8,2.0,10,0.2
45828933,19,6,6.0,25,0.24
45831221,2,6,2.0,8,0.25
45833833,2,8,2.0,10,0.2
45834996,2,7,2.0,9,0.2222222222222222
45835140,1,9,1.0,10,0.1
45835146,16,13,13.0,29,0.4482758620689655
45846040,1,8,1.0,9,0.1111111111111111
45846939,1,9,1.0,10,0.1
45851855,2,8,2.0,10,0.2
45852244,1,8,1.0,9,0.1111111111111111
45864112,4,6,4.0,10,0.4
45865211,5,5,5.0,10,0.5
45867519,4,6,4.0,10,0.4
45872965,1,9,1.0,10,0.1
45874185,4,6,4.0,10,0.4
45887300,14,14,14.0,28,0.5
45887634,1,8,1.0,9,0.1111111111111111
45897116,3,7,3.0,10,0.3
45908564,1,9,1.0,10,0.1
45951577,1,9,1.0,10,0.1
45952519,1,9,1.0,10,0.1
45952540,1,9,1.0,10,0.1
45952849,1,8,1.0,9,0.1111111111111111
45963283,2,16,2.0,18,0.1111111111111111
45971922,2,8,2.0,10,0.2
45985421,9,1,1.0,10,0.1
45996308,2,15,2.0,17,0.11764705882352941
45998061,2,8,2.0,10,0.2
45999232,6,4,4.0,10,0.4
45999751,8,2,2.0,10,0.2
46004414,3,6,3.0,9,0.3333333333333333
46020912,1,8,1.0,9,0.1111111111111111
46038228,8,2,2.0,10,0.2
46080407,8,1,1.0,9,0.1111111111111111
46080763,4,5,4.0,9,0.4444444444444444
46080888,9,20,9.0,29,0.3103448275862069
46085055,1,16,1.0,17,0.058823529411764705
46110497,1,8,1.0,9,0.1111111111111111
46116922,2,8,2.0,10,0.2
46118842,1,8,1.0,9,0.1111111111111111
46136643,1,9,1.0,10,0.1
46139291,2,6,2.0,8,0.25
46141750,1,19,1.0,20,0.05
46148639,1,8,1.0,9,0.1111111111111111
46156477,1,9,1.0,10,0.1
46159167,8,2,2.0,10,0.2
46161196,1,9,1.0,10,0.1
46163576,1,9,1.0,10,0.1
46165301,5,5,5.0,10,0.5
46166767,8,2,2.0,10,0.2
46168760,6,4,4.0,10,0.4
46169398,4,5,4.0,9,0.4444444444444444
46169750,3,5,3.0,8,0.375
46176315,7,3,3.0,10,0.3
46183761,2,8,2.0,10,0.2
46185754,1,8,1.0,9,0.1111111111111111
46195578,2,7,2.0,9,0.2222222222222222
46213031,1,9,1.0,10,0.1
46220870,5,4,4.0,9,0.4444444444444444
46220891,2,7,2.0,9,0.2222222222222222
46235701,1,7,1.0,8,0.125
46244078,4,6,4.0,10,0.4
46244916,1,8,1.0,9,0.1111111111111111
46245041,8,2,2.0,10,0.2
46246227,19,8,8.0,27,0.2962962962962963
46248485,1,9,1.0,10,0.1
46258878,1,19,1.0,20,0.05
46277416,6,4,4.0,10,0.4
46336532,1,9,1.0,10,0.1
46337684,1,9,1.0,10,0.1
46347755,28,1,1.0,29,0.034482758620689655
46347948,8,2,2.0,10,0.2
46370108,4,4,4.0,8,0.5
46370129,8,2,2.0,10,0.2
46371266,5,5,5.0,10,0.5
46372422,3,6,3.0,9,0.3333333333333333
46390259,2,6,2.0,8,0.25
46392554,1,18,1.0,19,0.05263157894736842
46393685,1,9,1.0,10,0.1
46394790,5,4,4.0,9,0.4444444444444444
46412544,2,8,2.0,10,0.2
46436571,6,4,4.0,10,0.4
46436691,7,23,7.0,30,0.23333333333333334
46438144,1,9,1.0,10,0.1
46438333,1,8,1.0,9,0.1111111111111111
46446848,1,9,1.0,10,0.1
46463121,3,7,3.0,10,0.3
46474423,2,7,2.0,9,0.2222222222222222
46477261,6,3,3.0,9,0.3333333333333333
46492600,1,8,1.0,9,0.1111111111111111
46493324,1,8,1.0,9,0.1111111111111111
46493452,1,17,1.0,18,0.05555555555555555
46502802,3,7,3.0,10,0.3
46506681,4,16,4.0,20,0.2
46511411,1,9,1.0,10,0.1
46540777,1,8,1.0,9,0.1111111111111111
46571347,7,2,2.0,9,0.2222222222222222
46572609,1,9,1.0,10,0.1
46581326,2,8,2.0,10,0.2
46588308,1,9,1.0,10,0.1
46588362,1,9,1.0,10,0.1
46608784,2,7,2.0,9,0.2222222222222222
46614689,6,3,3.0,9,0.3333333333333333
46619802,2,7,2.0,9,0.2222222222222222
46621116,1,9,1.0,10,0.1
46624063,7,3,3.0,10,0.3
46624406,8,2,2.0,10,0.2
46624939,7,3,3.0,10,0.3
46625367,1,9,1.0,10,0.1
46627062,4,6,4.0,10,0.4
46629170,1,18,1.0,19,0.05263157894736842
46630766,4,5,4.0,9,0.4444444444444444
46631331,3,7,3.0,10,0.3
46636093,4,6,4.0,10,0.4
46644460,4,6,4.0,10,0.4
46644912,1,7,1.0,8,0.125
46653628,15,13,13.0,28,0.4642857142857143
46654113,4,5,4.0,9,0.4444444444444444
46661605,13,13,13.0,26,0.5
46668273,6,22,6.0,28,0.21428571428571427
46668384,1,7,1.0,8,0.125
46670446,4,5,4.0,9,0.4444444444444444
46684522,2,8,2.0,10,0.2
46689345,1,9,1.0,10,0.1
46708681,4,5,4.0,9,0.4444444444444444
46722296,1,8,1.0,9,0.1111111111111111
46744207,26,1,1.0,27,0.037037037037037035
46745251,5,15,5.0,20,0.25
46750577,2,8,2.0,10,0.2
46767042,1,8,1.0,9,0.1111111111111111
46770947,2,18,2.0,20,0.1
46777551,1,8,1.0,9,0.1111111111111111
46779923,1,7,1.0,8,0.125
46788404,2,8,2.0,10,0.2
46788778,2,7,2.0,9,0.2222222222222222
46807096,2,8,2.0,10,0.2
46808698,1,8,1.0,9,0.1111111111111111
46809122,4,6,4.0,10,0.4
46810708,2,8,2.0,10,0.2
46812423,3,7,3.0,10,0.3
46813454,2,7,2.0,9,0.2222222222222222
46817650,4,5,4.0,9,0.4444444444444444
46843591,1,8,1.0,9,0.1111111111111111
46856469,1,9,1.0,10,0.1
46867155,1,9,1.0,10,0.1
46872151,2,27,2.0,29,0.06896551724137931
46883738,1,7,1.0,8,0.125
46900632,2,7,2.0,9,0.2222222222222222
46909470,3,15,3.0,18,0.16666666666666666
46917903,1,8,1.0,9,0.1111111111111111
46958230,2,8,2.0,10,0.2
46976309,1,8,1.0,9,0.1111111111111111
46984461,1,7,1.0,8,0.125
46995014,7,3,3.0,10,0.3
47014250,2,8,2.0,10,0.2
47016135,2,8,2.0,10,0.2
47016188,2,8,2.0,10,0.2
47021533,2,8,2.0,10,0.2
47031933,2,8,2.0,10,0.2
47041163,3,7,3.0,10,0.3
47062772,2,8,2.0,10,0.2
47066277,6,3,3.0,9,0.3333333333333333
47067297,3,17,3.0,20,0.15
47096052,18,2,2.0,20,0.1
47105531,1,8,1.0,9,0.1111111111111111
47111391,4,14,4.0,18,0.2222222222222222
47145209,1,8,1.0,9,0.1111111111111111
47149780,1,9,1.0,10,0.1
47152360,1,8,1.0,9,0.1111111111111111
47152905,3,6,3.0,9,0.3333333333333333
47172031,7,1,1.0,8,0.125
47175962,2,7,2.0,9,0.2222222222222222
47176044,4,6,4.0,10,0.4
47176302,3,7,3.0,10,0.3
47179475,2,8,2.0,10,0.2
47180996,4,6,4.0,10,0.4
47206217,8,2,2.0,10,0.2
47206943,7,2,2.0,9,0.2222222222222222
47207426,4,5,4.0,9,0.4444444444444444
47209741,8,2,2.0,10,0.2
47230946,6,3,3.0,9,0.3333333333333333
47268855,1,7,1.0,8,0.125
47269833,1,9,1.0,10,0.1
47278388,1,19,1.0,20,0.05
47285496,3,16,3.0,19,0.15789473684210525
47296493,13,15,13.0,28,0.4642857142857143
47300049,1,9,1.0,10,0.1
47309312,3,6,3.0,9,0.3333333333333333
47325342,1,7,1.0,8,0.125
47326663,8,2,2.0,10,0.2
47327213,3,7,3.0,10,0.3
47329683,2,8,2.0,10,0.2
47332881,1,7,1.0,8,0.125
47333543,5,5,5.0,10,0.5
47334079,2,7,2.0,9,0.2222222222222222
47349988,1,9,1.0,10,0.1
47357675,1,9,1.0,10,0.1
47366267,1,8,1.0,9,0.1111111111111111
47389685,6,3,3.0,9,0.3333333333333333
47393318,2,6,2.0,8,0.25
47415283,1,7,1.0,8,0.125
47425282,1,9,1.0,10,0.1
47451600,1,7,1.0,8,0.125
47453452,3,6,3.0,9,0.3333333333333333
47456362,1,8,1.0,9,0.1111111111111111
47474480,2,8,2.0,10,0.2
47483613,1,9,1.0,10,0.1
47488873,2,6,2.0,8,0.25
47492151,4,6,4.0,10,0.4
47496322,7,1,1.0,8,0.125
47511943,2,8,2.0,10,0.2
47521433,8,1,1.0,9,0.1111111111111111
47523250,1,9,1.0,10,0.1
47530947,1,8,1.0,9,0.1111111111111111
47532924,3,6,3.0,9,0.3333333333333333
47535321,1,9,1.0,10,0.1
47559852,1,9,1.0,10,0.1
47589219,4,6,4.0,10,0.4
47593204,5,4,4.0,9,0.4444444444444444
47605266,1,9,1.0,10,0.1
47608048,1,18,1.0,19,0.05263157894736842
47616006,3,7,3.0,10,0.3
47620948,2,7,2.0,9,0.2222222222222222
47631523,2,8,2.0,10,0.2
47634860,1,8,1.0,9,0.1111111111111111
47635545,7,18,7.0,25,0.28
47636387,2,8,2.0,10,0.2
47636643,2,6,2.0,8,0.25
47637143,6,4,4.0,10,0.4
47637488,1,8,1.0,9,0.1111111111111111
47637976,2,17,2.0,19,0.10526315789473684
47639442,1,17,1.0,18,0.05555555555555555
47655665,3,6,3.0,9,0.3333333333333333
47672589,2,8,2.0,10,0.2
47680415,2,8,2.0,10,0.2
47684132,3,6,3.0,9,0.3333333333333333
47687225,1,19,1.0,20,0.05
47693892,5,24,5.0,29,0.1724137931034483
47710851,3,7,3.0,10,0.3
47711189,1,8,1.0,9,0.1111111111111111
47736253,1,9,1.0,10,0.1
47761622,1,28,1.0,29,0.034482758620689655
47766478,1,8,1.0,9,0.1111111111111111
47769237,1,8,1.0,9,0.1111111111111111
47783273,1,7,1.0,8,0.125
47785025,2,7,2.0,9,0.2222222222222222
47787398,5,4,4.0,9,0.4444444444444444
47788353,4,5,4.0,9,0.4444444444444444
47804283,4,6,4.0,10,0.4
47804394,1,9,1.0,10,0.1
47807991,7,1,1.0,8,0.125
47861572,4,5,4.0,9,0.4444444444444444
47870806,1,19,1.0,20,0.05
47870936,3,7,3.0,10,0.3
47888498,4,6,4.0,10,0.4
47888554,1,8,1.0,9,0.1111111111111111
47900532,1,8,1.0,9,0.1111111111111111
47901472,1,7,1.0,8,0.125
47902021,2,8,2.0,10,0.2
47902467,5,5,5.0,10,0.5
47904018,3,7,3.0,10,0.3
47912993,1,25,1.0,26,0.038461538461538464
47920253,4,6,4.0,10,0.4
47920828,1,9,1.0,10,0.1
47932224,4,5,4.0,9,0.4444444444444444
47933364,1,9,1.0,10,0.1
47934105,4,6,4.0,10,0.4
47941311,3,7,3.0,10,0.3
47948246,2,8,2.0,10,0.2
47965750,1,18,1.0,19,0.05263157894736842
47998073,6,14,6.0,20,0.3
48001214,1,18,1.0,19,0.05263157894736842
48007184,1,28,1.0,29,0.034482758620689655
48007784,1,7,1.0,8,0.125
48014402,1,19,1.0,20,0.05
48014619,5,14,5.0,19,0.2631578947368421
48018821,1,8,1.0,9,0.1111111111111111
48020886,4,24,4.0,28,0.14285714285714285
48022532,3,7,3.0,10,0.3
48025645,6,4,4.0,10,0.4
48026186,1,9,1.0,10,0.1
48052696,4,14,4.0,18,0.2222222222222222
48052849,4,6,4.0,10,0.4
48053468,4,5,4.0,9,0.4444444444444444
48062880,1,9,1.0,10,0.1
48102905,3,6,3.0,9,0.3333333333333333
48113568,16,9,9.0,25,0.36
48113832,1,8,1.0,9,0.1111111111111111
48114024,4,6,4.0,10,0.4
48114284,3,7,3.0,10,0.3
48114478,7,3,3.0,10,0.3
48114746,1,9,1.0,10,0.1
48114944,4,24,4.0,28,0.14285714285714285
48115242,6,22,6.0,28,0.21428571428571427
48136403,2,8,2.0,10,0.2
48139159,1,8,1.0,9,0.1111111111111111
48141874,1,9,1.0,10,0.1
48144619,3,6,3.0,9,0.3333333333333333
48146990,1,8,1.0,9,0.1111111111111111
48148806,5,4,4.0,9,0.4444444444444444
48150918,6,4,4.0,10,0.4
48155701,1,9,1.0,10,0.1
48156926,2,7,2.0,9,0.2222222222222222
48167884,3,7,3.0,10,0.3
48172314,3,16,3.0,19,0.15789473684210525
48172517,3,7,3.0,10,0.3
48178382,1,9,1.0,10,0.1
48182836,1,8,1.0,9,0.1111111111111111
48186655,6,3,3.0,9,0.3333333333333333
48188517,9,1,1.0,10,0.1
48188664,27,2,2.0,29,0.06896551724137931
48195207,3,25,3.0,28,0.10714285714285714
48201531,5,4,4.0,9,0.4444444444444444
48224082,2,8,2.0,10,0.2
48226431,9,1,1.0,10,0.1
48228116,9,1,1.0,10,0.1
48229216,8,1,1.0,9,0.1111111111111111
48234966,1,9,1.0,10,0.1
48235591,1,18,1.0,19,0.05263157894736842
48235790,4,6,4.0,10,0.4
48236295,3,7,3.0,10,0.3
48239393,5,5,5.0,10,0.5
48239529,2,8,2.0,10,0.2
48242483,3,7,3.0,10,0.3
48242807,2,8,2.0,10,0.2
48243975,1,9,1.0,10,0.1
48247869,1,9,1.0,10,0.1
48256244,2,7,2.0,9,0.2222222222222222
48273327,1,9,1.0,10,0.1
48288434,1,9,1.0,10,0.1
48290320,2,8,2.0,10,0.2
48290380,1,8,1.0,9,0.1111111111111111
48293651,28,1,1.0,29,0.034482758620689655
48297894,2,8,2.0,10,0.2
48299103,2,8,2.0,10,0.2
48301849,4,16,4.0,20,0.2
48303826,2,8,2.0,10,0.2
48304185,1,9,1.0,10,0.1
48306153,1,9,1.0,10,0.1
48314820,5,14,5.0,19,0.2631578947368421
48322248,1,8,1.0,9,0.1111111111111111
48333346,1,9,1.0,10,0.1
48334325,7,2,2.0,9,0.2222222222222222
48336285,1,8,1.0,9,0.1111111111111111
48337966,19,8,8.0,27,0.2962962962962963
48360551,1,28,1.0,29,0.034482758620689655
48365924,2,8,2.0,10,0.2
48382058,20,9,9.0,29,0.3103448275862069
48382211,7,3,3.0,10,0.3
48382273,1,9,1.0,10,0.1
48382758,1,8,1.0,9,0.1111111111111111
48382947,2,8,2.0,10,0.2
48383253,2,8,2.0,10,0.2
48389531,5,3,3.0,8,0.375
48416839,1,18,1.0,19,0.05263157894736842
48419904,2,6,2.0,8,0.25
48420085,1,9,1.0,10,0.1
48423827,5,5,5.0,10,0.5
48428494,1,18,1.0,19,0.05263157894736842
48455797,1,9,1.0,10,0.1
48475725,1,9,1.0,10,0.1
48499761,1,16,1.0,17,0.058823529411764705
48505600,1,8,1.0,9,0.1111111111111111
48515570,1,8,1.0,9,0.1111111111111111
48518855,1,9,1.0,10,0.1
48536205,3,7,3.0,10,0.3
48536457,3,17,3.0,20,0.15
48537069,9,1,1.0,10,0.1
48542519,5,5,5.0,10,0.5
48542699,2,8,2.0,10,0.2
48544134,4,6,4.0,10,0.4
48554046,1,19,1.0,20,0.05
48555302,2,7,2.0,9,0.2222222222222222
48556552,1,9,1.0,10,0.1
48559884,2,8,2.0,10,0.2
48562841,2,18,2.0,20,0.1
48564121,2,7,2.0,9,0.2222222222222222
48564442,1,9,1.0,10,0.1
48567446,3,7,3.0,10,0.3
48569136,1,8,1.0,9,0.1111111111111111
48569191,3,6,3.0,9,0.3333333333333333
48569322,2,17,2.0,19,0.10526315789473684
48569426,4,6,4.0,10,0.4
48569616,2,7,2.0,9,0.2222222222222222
48569666,3,6,3.0,9,0.3333333333333333
48571177,1,9,1.0,10,0.1
48585709,6,3,3.0,9,0.3333333333333333
48589428,4,4,4.0,8,0.5
48594302,2,7,2.0,9,0.2222222222222222
48595330,1,9,1.0,10,0.1
48600386,7,2,2.0,9,0.2222222222222222
48604242,3,6,3.0,9,0.3333333333333333
48604793,1,9,1.0,10,0.1
48641364,1,8,1.0,9,0.1111111111111111
48644057,3,6,3.0,9,0.3333333333333333
48644365,3,7,3.0,10,0.3
48648583,3,7,3.0,10,0.3
48668435,1,8,1.0,9,0.1111111111111111
48683776,2,8,2.0,10,0.2
48685677,3,6,3.0,9,0.3333333333333333
48694280,1,18,1.0,19,0.05263157894736842
48711975,1,9,1.0,10,0.1
48712838,1,9,1.0,10,0.1
48727155,2,8,2.0,10,0.2
48737838,1,8,1.0,9,0.1111111111111111
48739061,2,8,2.0,10,0.2
48745023,1,26,1.0,27,0.037037037037037035
48761709,1,7,1.0,8,0.125
48762803,1,8,1.0,9,0.1111111111111111
48763899,1,9,1.0,10,0.1
48768341,3,17,3.0,20,0.15
48771306,5,12,5.0,17,0.29411764705882354
48774323,2,15,2.0,17,0.11764705882352941
48774786,5,4,4.0,9,0.4444444444444444
48799710,1,9,1.0,10,0.1
48802612,1,26,1.0,27,0.037037037037037035
48804710,5,5,5.0,10,0.5
48805127,7,3,3.0,10,0.3
48805864,6,4,4.0,10,0.4
48806113,3,6,3.0,9,0.3333333333333333
48806301,2,7,2.0,9,0.2222222222222222
48807345,1,8,1.0,9,0.1111111111111111
48807913,3,6,3.0,9,0.3333333333333333
48810896,1,9,1.0,10,0.1
48829315,4,26,4.0,30,0.13333333333333333
48834494,6,4,4.0,10,0.4
48835504,1,9,1.0,10,0.1
48845796,1,9,1.0,10,0.1
48860603,3,16,3.0,19,0.15789473684210525
48865336,1,8,1.0,9,0.1111111111111111
48867877,2,8,2.0,10,0.2
48868479,1,8,1.0,9,0.1111111111111111
48870894,1,9,1.0,10,0.1
48882009,1,9,1.0,10,0.1
48895137,1,9,1.0,10,0.1
48902796,2,8,2.0,10,0.2
48909436,1,9,1.0,10,0.1
48916153,2,8,2.0,10,0.2
48916444,9,1,1.0,10,0.1
48917363,6,4,4.0,10,0.4
48930931,9,1,1.0,10,0.1
48932035,2,7,2.0,9,0.2222222222222222
48934537,1,8,1.0,9,0.1111111111111111
48936695,3,7,3.0,10,0.3
48937660,2,7,2.0,9,0.2222222222222222
48939287,2,8,2.0,10,0.2
48941796,1,29,1.0,30,0.03333333333333333
48959282,1,8,1.0,9,0.1111111111111111
48968257,3,7,3.0,10,0.3
48969223,1,9,1.0,10,0.1
48973652,4,5,4.0,9,0.4444444444444444
48993983,5,5,5.0,10,0.5
48995151,2,7,2.0,9,0.2222222222222222
49003330,7,1,1.0,8,0.125
49008485,1,16,1.0,17,0.058823529411764705
49008818,2,8,2.0,10,0.2
49016527,1,9,1.0,10,0.1
49016633,3,5,3.0,8,0.375
49029858,2,7,2.0,9,0.2222222222222222
49030394,1,8,1.0,9,0.1111111111111111
49032951,6,23,6.0,29,0.20689655172413793
49040864,6,4,4.0,10,0.4
49041229,1,7,1.0,8,0.125
49043363,11,18,11.0,29,0.3793103448275862
49044709,1,9,1.0,10,0.1
49046099,4,6,4.0,10,0.4
49052960,1,9,1.0,10,0.1
49056770,1,9,1.0,10,0.1
49080343,2,16,2.0,18,0.1111111111111111
49098842,7,23,7.0,30,0.23333333333333334
49117775,2,8,2.0,10,0.2
49118584,2,8,2.0,10,0.2
49120294,3,7,3.0,10,0.3
49120792,3,7,3.0,10,0.3
49121981,1,9,1.0,10,0.1
49127563,3,7,3.0,10,0.3
49136187,3,7,3.0,10,0.3
49163717,2,8,2.0,10,0.2
49164052,1,8,1.0,9,0.1111111111111111
49164806,5,5,5.0,10,0.5
49165402,4,6,4.0,10,0.4
49166772,2,8,2.0,10,0.2
49172926,3,7,3.0,10,0.3
49187630,1,9,1.0,10,0.1
49189066,2,23,2.0,25,0.08
49191422,2,8,2.0,10,0.2
49194358,1,9,1.0,10,0.1
49202203,5,5,5.0,10,0.5
49210533,6,4,4.0,10,0.4
49215587,1,8,1.0,9,0.1111111111111111
49215771,5,5,5.0,10,0.5
49216435,19,9,9.0,28,0.32142857142857145
49225472,10,9,9.0,19,0.47368421052631576
49232483,2,7,2.0,9,0.2222222222222222
49236495,5,13,5.0,18,0.2777777777777778
49240681,8,2,2.0,10,0.2
49245440,1,8,1.0,9,0.1111111111111111
49249873,2,8,2.0,10,0.2
49256374,4,6,4.0,10,0.4
49259474,2,7,2.0,9,0.2222222222222222
49267595,1,18,1.0,19,0.05263157894736842
49281093,2,17,2.0,19,0.10526315789473684
49289378,12,8,8.0,20,0.4
49315236,1,18,1.0,19,0.05263157894736842
49319786,2,17,2.0,19,0.10526315789473684
49327656,3,7,3.0,10,0.3
49333668,1,9,1.0,10,0.1
49335855,1,8,1.0,9,0.1111111111111111
49341500,2,16,2.0,18,0.1111111111111111
49348814,3,7,3.0,10,0.3
49360056,1,9,1.0,10,0.1
49397361,6,4,4.0,10,0.4
49407091,1,9,1.0,10,0.1
49407391,3,15,3.0,18,0.16666666666666666
49411666,1,18,1.0,19,0.05263157894736842
49415489,2,8,2.0,10,0.2
49455428,1,9,1.0,10,0.1
49465502,6,13,6.0,19,0.3157894736842105
49475757,1,15,1.0,16,0.0625
49484465,5,5,5.0,10,0.5
49485840,7,1,1.0,8,0.125
49509513,3,15,3.0,18,0.16666666666666666
49513515,1,7,1.0,8,0.125
49529853,1,17,1.0,18,0.05555555555555555
49538870,4,5,4.0,9,0.4444444444444444
49540453,1,16,1.0,17,0.058823529411764705
49541372,1,8,1.0,9,0.1111111111111111
49542444,1,7,1.0,8,0.125
49547024,1,18,1.0,19,0.05263157894736842
49560233,7,11,7.0,18,0.3888888888888889
49576224,3,7,3.0,10,0.3
49585460,3,7,3.0,10,0.3
49603378,6,4,4.0,10,0.4
49603605,5,3,3.0,8,0.375
49605945,8,2,2.0,10,0.2
49612947,1,9,1.0,10,0.1
49615695,3,7,3.0,10,0.3
49616154,6,14,6.0,20,0.3
49616989,5,14,5.0,19,0.2631578947368421
49617209,1,9,1.0,10,0.1
49617363,1,9,1.0,10,0.1
49636889,15,14,14.0,29,0.4827586206896552
49637247,1,7,1.0,8,0.125
49663773,3,7,3.0,10,0.3
49669231,2,16,2.0,18,0.1111111111111111
49673219,1,8,1.0,9,0.1111111111111111
49675951,2,8,2.0,10,0.2
49676798,5,5,5.0,10,0.5
49677312,2,8,2.0,10,0.2
49677537,4,15,4.0,19,0.21052631578947367
49677944,1,9,1.0,10,0.1
49685954,2,8,2.0,10,0.2
49692809,1,9,1.0,10,0.1
49697474,6,4,4.0,10,0.4
49713587,3,6,3.0,9,0.3333333333333333
49714536,1,8,1.0,9,0.1111111111111111
49719313,7,3,3.0,10,0.3
49724157,3,7,3.0,10,0.3
49729677,5,4,4.0,9,0.4444444444444444
49734435,1,9,1.0,10,0.1
49738070,4,15,4.0,19,0.21052631578947367
49738360,3,7,3.0,10,0.3
49742668,1,9,1.0,10,0.1
49743132,1,8,1.0,9,0.1111111111111111
49744356,2,8,2.0,10,0.2
49744610,5,4,4.0,9,0.4444444444444444
49745303,8,1,1.0,9,0.1111111111111111
49745853,4,6,4.0,10,0.4
49770994,1,9,1.0,10,0.1
49778391,1,9,1.0,10,0.1
49805185,1,9,1.0,10,0.1
49806559,2,8,2.0,10,0.2
49813811,1,9,1.0,10,0.1
49815273,2,8,2.0,10,0.2
49815525,2,8,2.0,10,0.2
49818991,3,6,3.0,9,0.3333333333333333
49824402,1,9,1.0,10,0.1
49824710,1,9,1.0,10,0.1
49840342,3,6,3.0,9,0.3333333333333333
49841170,1,9,1.0,10,0.1
49842241,2,27,2.0,29,0.06896551724137931
49853060,1,9,1.0,10,0.1
49854329,4,5,4.0,9,0.4444444444444444
49860363,1,28,1.0,29,0.034482758620689655
49868772,2,8,2.0,10,0.2
49873182,3,7,3.0,10,0.3
49878995,3,7,3.0,10,0.3
49884376,1,9,1.0,10,0.1
49885996,2,8,2.0,10,0.2
49886334,3,16,3.0,19,0.15789473684210525
49896987,1,17,1.0,18,0.05555555555555555
49907424,2,6,2.0,8,0.25
49916520,2,7,2.0,9,0.2222222222222222
49929342,2,8,2.0,10,0.2
49929551,1,8,1.0,9,0.1111111111111111
49929808,1,9,1.0,10,0.1
49945742,5,5,5.0,10,0.5
49946718,1,9,1.0,10,0.1
49947135,4,6,4.0,10,0.4
49947549,2,7,2.0,9,0.2222222222222222
49952534,1,9,1.0,10,0.1
49956544,1,9,1.0,10,0.1
49962551,5,5,5.0,10,0.5
49964773,5,4,4.0,9,0.4444444444444444
49965935,3,7,3.0,10,0.3
49971766,2,7,2.0,9,0.2222222222222222
49973011,1,17,1.0,18,0.05555555555555555
49973165,5,4,4.0,9,0.4444444444444444
49983511,7,1,1.0,8,0.125
49996096,1,8,1.0,9,0.1111111111111111
49997581,5,14,5.0,19,0.2631578947368421
50001927,10,19,10.0,29,0.3448275862068966
50011967,1,9,1.0,10,0.1
50020730,1,8,1.0,9,0.1111111111111111
50021460,6,3,3.0,9,0.3333333333333333
50021654,1,8,1.0,9,0.1111111111111111
50022453,5,4,4.0,9,0.4444444444444444
50023263,1,8,1.0,9,0.1111111111111111
50024386,7,3,3.0,10,0.3
50043446,1,8,1.0,9,0.1111111111111111
50050420,8,1,1.0,9,0.1111111111111111
50052372,1,8,1.0,9,0.1111111111111111
50056234,2,8,2.0,10,0.2
50059483,2,8,2.0,10,0.2
50061652,2,8,2.0,10,0.2
50077742,1,8,1.0,9,0.1111111111111111
50078085,11,8,8.0,19,0.42105263157894735
50088169,6,3,3.0,9,0.3333333333333333
50107911,1,19,1.0,20,0.05
50112582,1,19,1.0,20,0.05
50125834,1,9,1.0,10,0.1
50126101,7,3,3.0,10,0.3
50128335,1,8,1.0,9,0.1111111111111111
50131490,2,8,2.0,10,0.2
50132783,5,4,4.0,9,0.4444444444444444
50134514,12,16,12.0,28,0.42857142857142855
50142430,4,6,4.0,10,0.4
50142966,1,9,1.0,10,0.1
50149013,8,2,2.0,10,0.2
50149991,5,4,4.0,9,0.4444444444444444
50150493,7,3,3.0,10,0.3
50150660,1,8,1.0,9,0.1111111111111111
50151007,4,6,4.0,10,0.4
50151974,4,6,4.0,10,0.4
50161352,4,5,4.0,9,0.4444444444444444
50181961,3,7,3.0,10,0.3
50183812,1,9,1.0,10,0.1
50183924,1,9,1.0,10,0.1
50184786,1,9,1.0,10,0.1
50187202,1,9,1.0,10,0.1
50192356,1,8,1.0,9,0.1111111111111111
50217272,2,8,2.0,10,0.2
50222654,1,9,1.0,10,0.1
50233328,1,8,1.0,9,0.1111111111111111
50233628,1,9,1.0,10,0.1
50248581,1,9,1.0,10,0.1
50249729,1,18,1.0,19,0.05263157894736842
50260402,1,8,1.0,9,0.1111111111111111
50262648,2,8,2.0,10,0.2
50268356,1,8,1.0,9,0.1111111111111111
50302105,1,9,1.0,10,0.1
50304171,1,9,1.0,10,0.1
50314563,1,8,1.0,9,0.1111111111111111
50321195,2,8,2.0,10,0.2
50327941,3,7,3.0,10,0.3
50344697,1,9,1.0,10,0.1
50346907,1,7,1.0,8,0.125
50347140,1,9,1.0,10,0.1
50347441,2,8,2.0,10,0.2
50379764,1,8,1.0,9,0.1111111111111111
50384629,1,19,1.0,20,0.05
50391669,1,8,1.0,9,0.1111111111111111
50406153,5,5,5.0,10,0.5
50424308,1,7,1.0,8,0.125
50435713,6,21,6.0,27,0.2222222222222222
50435809,2,8,2.0,10,0.2
50438540,2,8,2.0,10,0.2
50466481,9,1,1.0,10,0.1
50472998,3,7,3.0,10,0.3
50484015,1,9,1.0,10,0.1
50487311,4,16,4.0,20,0.2
50522374,1,19,1.0,20,0.05
50523378,1,8,1.0,9,0.1111111111111111
50525461,2,8,2.0,10,0.2
50526848,2,8,2.0,10,0.2
50530231,2,8,2.0,10,0.2
50540587,4,15,4.0,19,0.21052631578947367
50543144,2,17,2.0,19,0.10526315789473684
50548148,2,8,2.0,10,0.2
50557964,1,8,1.0,9,0.1111111111111111
50582170,3,6,3.0,9,0.3333333333333333
50588652,1,17,1.0,18,0.05555555555555555
50596156,5,4,4.0,9,0.4444444444444444
50598536,14,12,12.0,26,0.46153846153846156
50605000,2,7,2.0,9,0.2222222222222222
50611919,4,4,4.0,8,0.5
50611957,4,6,4.0,10,0.4
50614803,7,2,2.0,9,0.2222222222222222
50620232,6,2,2.0,8,0.25
50621511,1,9,1.0,10,0.1
50651703,1,8,1.0,9,0.1111111111111111
50654878,5,5,5.0,10,0.5
50657715,1,9,1.0,10,0.1
50661516,2,8,2.0,10,0.2
50663533,3,6,3.0,9,0.3333333333333333
50667470,3,7,3.0,10,0.3
50667682,1,9,1.0,10,0.1
50667762,3,7,3.0,10,0.3
50669026,3,6,3.0,9,0.3333333333333333
50693832,3,7,3.0,10,0.3
50709807,1,19,1.0,20,0.05
50717161,1,9,1.0,10,0.1
50725513,1,9,1.0,10,0.1
50729303,1,9,1.0,10,0.1
50738542,1,9,1.0,10,0.1
50757533,1,8,1.0,9,0.1111111111111111
50758030,1,9,1.0,10,0.1
50763216,8,2,2.0,10,0.2
50763845,4,6,4.0,10,0.4
50779216,1,8,1.0,9,0.1111111111111111
50802980,1,8,1.0,9,0.1111111111111111
50807054,1,17,1.0,18,0.05555555555555555
50814367,1,8,1.0,9,0.1111111111111111
50814439,2,25,2.0,27,0.07407407407407407
50822686,1,8,1.0,9,0.1111111111111111
50854426,2,24,2.0,26,0.07692307692307693
50861595,1,9,1.0,10,0.1
50861708,1,15,1.0,16,0.0625
50862760,3,6,3.0,9,0.3333333333333333
50867027,4,6,4.0,10,0.4
50894457,5,15,5.0,20,0.25
50908835,4,6,4.0,10,0.4
50923416,2,8,2.0,10,0.2
50937578,1,8,1.0,9,0.1111111111111111
50949291,1,7,1.0,8,0.125
50961057,2,8,2.0,10,0.2
50964944,3,7,3.0,10,0.3
50973981,1,8,1.0,9,0.1111111111111111
50975613,4,15,4.0,19,0.21052631578947367
51004511,1,9,1.0,10,0.1
51005458,1,19,1.0,20,0.05
51009744,1,19,1.0,20,0.05
51023815,9,1,1.0,10,0.1
51035113,18,11,11.0,29,0.3793103448275862
51043944,2,7,2.0,9,0.2222222222222222
51044456,1,9,1.0,10,0.1
51061161,1,9,1.0,10,0.1
51068826,1,9,1.0,10,0.1
51088832,18,1,1.0,19,0.05263157894736842
51090628,3,5,3.0,8,0.375
51092637,2,16,2.0,18,0.1111111111111111
51096987,2,18,2.0,20,0.1
51098624,4,26,4.0,30,0.13333333333333333
51103513,2,6,2.0,8,0.25
51105511,3,6,3.0,9,0.3333333333333333
51109387,3,7,3.0,10,0.3
51112096,1,9,1.0,10,0.1
51113730,1,9,1.0,10,0.1
51114616,1,8,1.0,9,0.1111111111111111
51116900,2,8,2.0,10,0.2
51117464,1,8,1.0,9,0.1111111111111111
51117538,1,8,1.0,9,0.1111111111111111
51128854,1,9,1.0,10,0.1
51138239,1,9,1.0,10,0.1
51142857,1,8,1.0,9,0.1111111111111111
51171893,1,9,1.0,10,0.1
51172871,5,5,5.0,10,0.5
51175159,4,6,4.0,10,0.4
51175445,1,8,1.0,9,0.1111111111111111
51175666,3,7,3.0,10,0.3
51176662,5,5,5.0,10,0.5
51195446,15,13,13.0,28,0.4642857142857143
51200890,6,4,4.0,10,0.4
51201090,2,8,2.0,10,0.2
51222479,1,8,1.0,9,0.1111111111111111
51225286,20,10,10.0,30,0.3333333333333333
51226521,1,9,1.0,10,0.1
51244070,2,7,2.0,9,0.2222222222222222
51248778,2,8,2.0,10,0.2
51257331,1,9,1.0,10,0.1
51257432,1,9,1.0,10,0.1
51257772,1,28,1.0,29,0.034482758620689655
51261317,1,8,1.0,9,0.1111111111111111
51272121,1,9,1.0,10,0.1
51310235,2,7,2.0,9,0.2222222222222222
51321210,2,8,2.0,10,0.2
51339004,1,25,1.0,26,0.038461538461538464
51341415,1,9,1.0,10,0.1
51346240,1,8,1.0,9,0.1111111111111111
51354245,1,9,1.0,10,0.1
51364783,9,1,1.0,10,0.1
51367602,6,3,3.0,9,0.3333333333333333
51380389,3,6,3.0,9,0.3333333333333333
51389932,1,9,1.0,10,0.1
51390652,2,17,2.0,19,0.10526315789473684
51390871,1,9,1.0,10,0.1
51412817,2,17,2.0,19,0.10526315789473684
51415766,3,6,3.0,9,0.3333333333333333
51417088,4,14,4.0,18,0.2222222222222222
51418525,3,6,3.0,9,0.3333333333333333
51420896,1,8,1.0,9,0.1111111111111111
51425621,1,19,1.0,20,0.05
51459751,2,6,2.0,8,0.25
51463998,2,8,2.0,10,0.2
51466444,6,21,6.0,27,0.2222222222222222
51473927,2,8,2.0,10,0.2
51475741,1,17,1.0,18,0.05555555555555555
51478724,1,9,1.0,10,0.1
51480315,1,7,1.0,8,0.125
51482031,4,4,4.0,8,0.5
51482827,1,9,1.0,10,0.1
51483532,8,2,2.0,10,0.2
51483884,6,3,3.0,9,0.3333333333333333
51489105,10,10,10.0,20,0.5
51493193,3,7,3.0,10,0.3
51503950,4,4,4.0,8,0.5
51504059,6,4,4.0,10,0.4
51504291,4,6,4.0,10,0.4
51504440,4,6,4.0,10,0.4
51507862,8,1,1.0,9,0.1111111111111111
51520012,4,5,4.0,9,0.4444444444444444
51533555,8,2,2.0,10,0.2
51542621,1,17,1.0,18,0.05555555555555555
51559849,1,18,1.0,19,0.05263157894736842
51560374,2,7,2.0,9,0.2222222222222222
51561776,1,7,1.0,8,0.125
51562947,4,6,4.0,10,0.4
51563235,1,18,1.0,19,0.05263157894736842
51564840,4,5,4.0,9,0.4444444444444444
51575389,1,7,1.0,8,0.125
51587036,1,19,1.0,20,0.05
51592286,1,9,1.0,10,0.1
51592341,1,8,1.0,9,0.1111111111111111
51604713,1,9,1.0,10,0.1
51629043,1,9,1.0,10,0.1
51644859,6,4,4.0,10,0.4
51645631,4,5,4.0,9,0.4444444444444444
51645825,1,8,1.0,9,0.1111111111111111
51646605,3,7,3.0,10,0.3
51648154,1,9,1.0,10,0.1
51649654,1,8,1.0,9,0.1111111111111111
51659278,8,2,2.0,10,0.2
51674904,1,16,1.0,17,0.058823529411764705
51676880,5,5,5.0,10,0.5
51691021,1,19,1.0,20,0.05
51694050,1,9,1.0,10,0.1
51704458,3,6,3.0,9,0.3333333333333333
51714420,2,18,2.0,20,0.1
51716405,4,22,4.0,26,0.15384615384615385
51771559,5,5,5.0,10,0.5
51773771,5,25,5.0,30,0.16666666666666666
51780996,2,7,2.0,9,0.2222222222222222
51790532,1,9,1.0,10,0.1
51804304,2,8,2.0,10,0.2
51806496,3,15,3.0,18,0.16666666666666666
51810229,1,9,1.0,10,0.1
51832886,6,3,3.0,9,0.3333333333333333
51868345,1,9,1.0,10,0.1
51868768,1,9,1.0,10,0.1
51869244,1,9,1.0,10,0.1
51873615,1,8,1.0,9,0.1111111111111111
51874403,2,15,2.0,17,0.11764705882352941
51875025,4,5,4.0,9,0.4444444444444444
51875904,7,2,2.0,9,0.2222222222222222
51878253,2,7,2.0,9,0.2222222222222222
51879011,1,9,1.0,10,0.1
51879711,4,6,4.0,10,0.4
51881937,3,6,3.0,9,0.3333333333333333
51894781,1,8,1.0,9,0.1111111111111111
51900326,6,4,4.0,10,0.4
51904361,4,6,4.0,10,0.4
51905846,5,4,4.0,9,0.4444444444444444
51912470,2,26,2.0,28,0.07142857142857142
51914393,5,5,5.0,10,0.5
51915633,1,9,1.0,10,0.1
51925497,1,16,1.0,17,0.058823529411764705
51929790,6,3,3.0,9,0.3333333333333333
51935006,1,9,1.0,10,0.1
51935347,3,7,3.0,10,0.3
51935712,1,8,1.0,9,0.1111111111111111
51936485,3,25,3.0,28,0.10714285714285714
51951158,1,8,1.0,9,0.1111111111111111
51973463,1,7,1.0,8,0.125
51976481,1,18,1.0,19,0.05263157894736842
52053642,5,5,5.0,10,0.5
52058250,6,2,2.0,8,0.25
52062522,3,5,3.0,8,0.375
52062590,1,7,1.0,8,0.125
52116394,1,8,1.0,9,0.1111111111111111
52118537,1,7,1.0,8,0.125
52123004,2,7,2.0,9,0.2222222222222222
52135348,2,8,2.0,10,0.2
52136538,4,5,4.0,9,0.4444444444444444
52138295,1,18,1.0,19,0.05263157894736842
52166916,13,15,13.0,28,0.4642857142857143
52168957,3,7,3.0,10,0.3
52185261,3,16,3.0,19,0.15789473684210525
52187285,2,7,2.0,9,0.2222222222222222
52190982,4,6,4.0,10,0.4
52198675,7,3,3.0,10,0.3
52200695,1,9,1.0,10,0.1
52203450,3,6,3.0,9,0.3333333333333333
52203807,2,7,2.0,9,0.2222222222222222
52204459,1,9,1.0,10,0.1
52204998,4,5,4.0,9,0.4444444444444444
52205771,3,6,3.0,9,0.3333333333333333
52216098,1,7,1.0,8,0.125
52222891,1,7,1.0,8,0.125
52241896,3,5,3.0,8,0.375
52246275,1,9,1.0,10,0.1
52251954,1,9,1.0,10,0.1
52260330,3,7,3.0,10,0.3
52263843,1,9,1.0,10,0.1
52268848,1,9,1.0,10,0.1
52296764,1,9,1.0,10,0.1
52313240,8,1,1.0,9,0.1111111111111111
52332374,8,2,2.0,10,0.2
52333319,9,19,9.0,28,0.32142857142857145
52334663,3,5,3.0,8,0.375
52339003,5,5,5.0,10,0.5
52340244,3,7,3.0,10,0.3
52343479,6,2,2.0,8,0.25
52371324,3,7,3.0,10,0.3
52375924,1,16,1.0,17,0.058823529411764705
52380474,1,19,1.0,20,0.05
52382964,2,16,2.0,18,0.1111111111111111
52410744,1,9,1.0,10,0.1
52419537,3,6,3.0,9,0.3333333333333333
52432820,1,19,1.0,20,0.05
52458644,1,8,1.0,9,0.1111111111111111
52475905,1,26,1.0,27,0.037037037037037035
52504235,7,2,2.0,9,0.2222222222222222
52540603,1,9,1.0,10,0.1
52544135,2,8,2.0,10,0.2
52548977,1,9,1.0,10,0.1
52555974,1,9,1.0,10,0.1
52578674,2,7,2.0,9,0.2222222222222222
52592250,1,9,1.0,10,0.1
52600406,7,3,3.0,10,0.3
52650189,9,15,9.0,24,0.375
52658202,2,8,2.0,10,0.2
52696262,4,14,4.0,18,0.2222222222222222
52710913,1,9,1.0,10,0.1
52712561,9,1,1.0,10,0.1
52713979,13,3,3.0,16,0.1875
52717496,1,9,1.0,10,0.1
52763498,1,8,1.0,9,0.1111111111111111
52767043,4,5,4.0,9,0.4444444444444444
52769434,2,8,2.0,10,0.2
52775419,6,23,6.0,29,0.20689655172413793
52802200,8,12,8.0,20,0.4
52817027,2,8,2.0,10,0.2
52863456,4,6,4.0,10,0.4
52867188,1,9,1.0,10,0.1
52897702,9,1,1.0,10,0.1
52901275,11,9,9.0,20,0.45
52905788,1,18,1.0,19,0.05263157894736842
52915181,2,8,2.0,10,0.2
52926119,4,5,4.0,9,0.4444444444444444
52947182,6,4,4.0,10,0.4
52947183,1,7,1.0,8,0.125
52947512,7,3,3.0,10,0.3
52950271,1,9,1.0,10,0.1
52959806,1,9,1.0,10,0.1
52960439,4,6,4.0,10,0.4
52987862,3,7,3.0,10,0.3
52991802,2,8,2.0,10,0.2
52999028,1,9,1.0,10,0.1
53000579,3,7,3.0,10,0.3
53023390,2,8,2.0,10,0.2
53023824,2,8,2.0,10,0.2
53023869,2,8,2.0,10,0.2
53025576,1,7,1.0,8,0.125
53028985,4,6,4.0,10,0.4
53041462,3,6,3.0,9,0.3333333333333333
53042336,4,25,4.0,29,0.13793103448275862
53043555,1,8,1.0,9,0.1111111111111111
53043938,2,18,2.0,20,0.1
53044254,5,5,5.0,10,0.5
53080235,3,7,3.0,10,0.3
53081906,2,8,2.0,10,0.2
53082060,4,5,4.0,9,0.4444444444444444
53084075,3,6,3.0,9,0.3333333333333333
53084751,1,18,1.0,19,0.05263157894736842
53093208,2,17,2.0,19,0.10526315789473684
53106687,1,18,1.0,19,0.05263157894736842
53114437,11,9,9.0,20,0.45
53137379,1,9,1.0,10,0.1
53143438,1,9,1.0,10,0.1
53148188,3,5,3.0,8,0.375
53184977,1,9,1.0,10,0.1
53186531,1,9,1.0,10,0.1
53201024,1,18,1.0,19,0.05263157894736842
53203781,1,9,1.0,10,0.1
53204011,1,18,1.0,19,0.05263157894736842
53204393,1,8,1.0,9,0.1111111111111111
53208418,1,9,1.0,10,0.1
53219781,5,5,5.0,10,0.5
53225736,1,9,1.0,10,0.1
53226448,1,8,1.0,9,0.1111111111111111
53226949,2,7,2.0,9,0.2222222222222222
53227621,3,7,3.0,10,0.3
53229579,4,6,4.0,10,0.4
53232351,6,4,4.0,10,0.4
53239186,3,7,3.0,10,0.3
53242409,3,6,3.0,9,0.3333333333333333
53244150,2,8,2.0,10,0.2
53247609,5,5,5.0,10,0.5
53254506,4,5,4.0,9,0.4444444444444444
53259936,9,1,1.0,10,0.1
53264123,1,9,1.0,10,0.1
53268463,2,8,2.0,10,0.2
53272815,2,7,2.0,9,0.2222222222222222
53274505,1,9,1.0,10,0.1
53292971,2,8,2.0,10,0.2
53294416,1,9,1.0,10,0.1
53296129,2,8,2.0,10,0.2
53296232,5,5,5.0,10,0.5
53299105,1,8,1.0,9,0.1111111111111111
53356180,3,15,3.0,18,0.16666666666666666
53357872,1,19,1.0,20,0.05
53409577,9,1,1.0,10,0.1
53411020,6,4,4.0,10,0.4
53412921,1,8,1.0,9,0.1111111111111111
53429013,2,17,2.0,19,0.10526315789473684
53431707,1,8,1.0,9,0.1111111111111111
53434675,1,9,1.0,10,0.1
53436633,1,9,1.0,10,0.1
53448350,4,6,4.0,10,0.4
53449551,1,9,1.0,10,0.1
53450953,9,18,9.0,27,0.3333333333333333
53461154,2,7,2.0,9,0.2222222222222222
53461579,2,8,2.0,10,0.2
53466124,2,7,2.0,9,0.2222222222222222
53479119,2,8,2.0,10,0.2
53491713,1,9,1.0,10,0.1
53491911,2,7,2.0,9,0.2222222222222222
53497125,2,8,2.0,10,0.2
53499747,2,7,2.0,9,0.2222222222222222
53528823,1,9,1.0,10,0.1
53539949,7,3,3.0,10,0.3
53541325,3,6,3.0,9,0.3333333333333333
53547760,1,8,1.0,9,0.1111111111111111
53551194,2,8,2.0,10,0.2
53551661,3,6,3.0,9,0.3333333333333333
53558862,2,25,2.0,27,0.07407407407407407
53590322,3,7,3.0,10,0.3
53594568,1,9,1.0,10,0.1
53601654,6,4,4.0,10,0.4
53605811,1,9,1.0,10,0.1
53616050,1,9,1.0,10,0.1
53623838,1,8,1.0,9,0.1111111111111111
53624514,2,16,2.0,18,0.1111111111111111
53626596,1,8,1.0,9,0.1111111111111111
53631073,7,23,7.0,30,0.23333333333333334
53641880,2,7,2.0,9,0.2222222222222222
53645553,1,8,1.0,9,0.1111111111111111
53645677,1,8,1.0,9,0.1111111111111111
53647174,2,18,2.0,20,0.1
53652263,1,9,1.0,10,0.1
53689047,1,9,1.0,10,0.1
53691842,2,7,2.0,9,0.2222222222222222
53699122,8,2,2.0,10,0.2
53703097,1,19,1.0,20,0.05
53735906,7,3,3.0,10,0.3
53739913,3,6,3.0,9,0.3333333333333333
53742743,2,8,2.0,10,0.2
53747999,3,25,3.0,28,0.10714285714285714
53750831,1,8,1.0,9,0.1111111111111111
53751394,3,26,3.0,29,0.10344827586206896
53753932,2,7,2.0,9,0.2222222222222222
53754966,5,5,5.0,10,0.5
53756361,3,7,3.0,10,0.3
53760881,2,8,2.0,10,0.2
53761787,1,9,1.0,10,0.1
53765130,4,5,4.0,9,0.4444444444444444
53765473,3,6,3.0,9,0.3333333333333333
53767055,4,6,4.0,10,0.4
53784911,4,6,4.0,10,0.4
53791719,2,7,2.0,9,0.2222222222222222
53823512,1,9,1.0,10,0.1
53827328,1,9,1.0,10,0.1
53827972,1,9,1.0,10,0.1
53828491,2,8,2.0,10,0.2
53833670,5,5,5.0,10,0.5
53834616,2,7,2.0,9,0.2222222222222222
53865660,2,18,2.0,20,0.1
53871702,1,7,1.0,8,0.125
53887279,1,9,1.0,10,0.1
53891511,2,7,2.0,9,0.2222222222222222
53897043,1,18,1.0,19,0.05263157894736842
53897902,1,9,1.0,10,0.1
53924596,7,3,3.0,10,0.3
53938387,1,8,1.0,9,0.1111111111111111
53943452,1,8,1.0,9,0.1111111111111111
53943554,7,22,7.0,29,0.2413793103448276
53948655,1,18,1.0,19,0.05263157894736842
53948969,1,9,1.0,10,0.1
53958682,1,26,1.0,27,0.037037037037037035
53973622,1,7,1.0,8,0.125
53974279,1,27,1.0,28,0.03571428571428571
53984703,1,9,1.0,10,0.1
53985210,2,8,2.0,10,0.2
53986688,1,8,1.0,9,0.1111111111111111
53997186,1,9,1.0,10,0.1
54030048,1,8,1.0,9,0.1111111111111111
54057649,1,7,1.0,8,0.125
54059065,3,5,3.0,8,0.375
54060556,1,8,1.0,9,0.1111111111111111
54061071,1,19,1.0,20,0.05
54063009,1,19,1.0,20,0.05
54063010,1,27,1.0,28,0.03571428571428571
54064254,1,9,1.0,10,0.1
54084858,1,7,1.0,8,0.125
54088481,7,3,3.0,10,0.3
54089909,1,7,1.0,8,0.125
54122794,1,8,1.0,9,0.1111111111111111
54124492,3,7,3.0,10,0.3
54124701,1,8,1.0,9,0.1111111111111111
54124829,3,7,3.0,10,0.3
54126555,1,7,1.0,8,0.125
54143590,6,3,3.0,9,0.3333333333333333
54144330,4,6,4.0,10,0.4
54145986,1,8,1.0,9,0.1111111111111111
54151603,1,9,1.0,10,0.1
54158929,1,9,1.0,10,0.1
54176148,1,9,1.0,10,0.1
54211504,1,9,1.0,10,0.1
54216901,1,9,1.0,10,0.1
54262917,1,9,1.0,10,0.1
54266300,25,2,2.0,27,0.07407407407407407
54276120,2,8,2.0,10,0.2
54302882,2,27,2.0,29,0.06896551724137931
54303525,2,6,2.0,8,0.25
54324826,3,5,3.0,8,0.375
54329982,1,9,1.0,10,0.1
54355823,1,9,1.0,10,0.1
54356127,2,8,2.0,10,0.2
54356164,3,6,3.0,9,0.3333333333333333
54358028,3,6,3.0,9,0.3333333333333333
54358107,4,5,4.0,9,0.4444444444444444
54358653,5,4,4.0,9,0.4444444444444444
54360075,2,7,2.0,9,0.2222222222222222
54360387,1,27,1.0,28,0.03571428571428571
54361818,5,13,5.0,18,0.2777777777777778
54362406,6,4,4.0,10,0.4
54363002,2,26,2.0,28,0.07142857142857142
54363483,5,5,5.0,10,0.5
54363909,5,5,5.0,10,0.5
54366025,17,11,11.0,28,0.39285714285714285
54366291,5,3,3.0,8,0.375
54391631,1,19,1.0,20,0.05
54398947,4,5,4.0,9,0.4444444444444444
54400753,1,9,1.0,10,0.1
54413354,3,7,3.0,10,0.3
54415631,6,4,4.0,10,0.4
54421515,1,9,1.0,10,0.1
54446920,2,6,2.0,8,0.25
54448072,12,8,8.0,20,0.4
54449898,4,6,4.0,10,0.4
54450749,26,3,3.0,29,0.10344827586206896
54478799,3,16,3.0,19,0.15789473684210525
54481600,3,7,3.0,10,0.3
54481740,4,6,4.0,10,0.4
54490340,1,9,1.0,10,0.1
54499379,4,6,4.0,10,0.4
54513707,1,9,1.0,10,0.1
54514394,4,25,4.0,29,0.13793103448275862
54514989,1,9,1.0,10,0.1
54518024,1,7,1.0,8,0.125
54524196,4,6,4.0,10,0.4
54526559,7,2,2.0,9,0.2222222222222222
54531406,9,1,1.0,10,0.1
54531669,6,4,4.0,10,0.4
54556020,3,7,3.0,10,0.3
54557330,1,28,1.0,29,0.034482758620689655
54560876,1,9,1.0,10,0.1
54566047,3,7,3.0,10,0.3
54569702,1,9,1.0,10,0.1
54570488,5,3,3.0,8,0.375
54571637,2,7,2.0,9,0.2222222222222222
54571989,2,8,2.0,10,0.2
54581413,8,2,2.0,10,0.2
54633772,1,7,1.0,8,0.125
54653573,1,9,1.0,10,0.1
54659877,2,7,2.0,9,0.2222222222222222
54662704,1,9,1.0,10,0.1
54668339,1,19,1.0,20,0.05
54687863,2,18,2.0,20,0.1
54697995,6,2,2.0,8,0.25
54706974,1,17,1.0,18,0.05555555555555555
54718644,7,13,7.0,20,0.35
54719394,8,1,1.0,9,0.1111111111111111
54737748,1,18,1.0,19,0.05263157894736842
54739869,1,9,1.0,10,0.1
54767645,2,7,2.0,9,0.2222222222222222
54772341,7,1,1.0,8,0.125
54802438,1,9,1.0,10,0.1
54802699,1,9,1.0,10,0.1
54807501,1,8,1.0,9,0.1111111111111111
54809113,3,7,3.0,10,0.3
54811781,8,1,1.0,9,0.1111111111111111
54813014,1,8,1.0,9,0.1111111111111111
54814514,1,7,1.0,8,0.125
54814755,4,5,4.0,9,0.4444444444444444
54815168,3,7,3.0,10,0.3
54830603,3,7,3.0,10,0.3
54831096,8,2,2.0,10,0.2
54842823,9,1,1.0,10,0.1
54866299,9,1,1.0,10,0.1
54866477,2,8,2.0,10,0.2
54866977,3,7,3.0,10,0.3
54867492,9,1,1.0,10,0.1
54868258,7,1,1.0,8,0.125
54868348,6,3,3.0,9,0.3333333333333333
54874067,1,7,1.0,8,0.125
54917916,5,24,5.0,29,0.1724137931034483
54921638,4,6,4.0,10,0.4
54922901,2,7,2.0,9,0.2222222222222222
54923036,7,20,7.0,27,0.25925925925925924
54931908,27,2,2.0,29,0.06896551724137931
54933779,4,6,4.0,10,0.4
54950150,3,5,3.0,8,0.375
54952154,4,6,4.0,10,0.4
54961203,1,9,1.0,10,0.1
54968125,7,3,3.0,10,0.3
54968285,8,1,1.0,9,0.1111111111111111
54968764,7,3,3.0,10,0.3
54968989,7,3,3.0,10,0.3
54969590,1,9,1.0,10,0.1
54969621,7,3,3.0,10,0.3
54979232,1,8,1.0,9,0.1111111111111111
54979787,15,5,5.0,20,0.25
54980341,7,11,7.0,18,0.3888888888888889
54980887,3,5,3.0,8,0.375
54982120,5,5,5.0,10,0.5
54982324,1,8,1.0,9,0.1111111111111111
54982713,5,4,4.0,9,0.4444444444444444
54986354,2,7,2.0,9,0.2222222222222222
54988388,2,7,2.0,9,0.2222222222222222
54988770,1,9,1.0,10,0.1
54990106,2,8,2.0,10,0.2
54990264,2,7,2.0,9,0.2222222222222222
54990361,2,8,2.0,10,0.2
54990523,11,8,8.0,19,0.42105263157894735
54990599,8,2,2.0,10,0.2
54990741,1,8,1.0,9,0.1111111111111111
54990821,1,9,1.0,10,0.1
54991086,4,6,4.0,10,0.4
54991905,1,9,1.0,10,0.1
54992610,4,22,4.0,26,0.15384615384615385
54993478,6,4,4.0,10,0.4
55002919,4,16,4.0,20,0.2
55007440,3,7,3.0,10,0.3
55010118,1,9,1.0,10,0.1
55010518,2,8,2.0,10,0.2
55019020,1,8,1.0,9,0.1111111111111111
55019884,1,19,1.0,20,0.05
55020141,1,9,1.0,10,0.1
55022160,1,9,1.0,10,0.1
55025095,1,9,1.0,10,0.1
55025394,5,4,4.0,9,0.4444444444444444
55025603,1,9,1.0,10,0.1
55026555,5,4,4.0,9,0.4444444444444444
55033188,2,7,2.0,9,0.2222222222222222
55055484,1,9,1.0,10,0.1
55059400,2,7,2.0,9,0.2222222222222222
55060640,2,7,2.0,9,0.2222222222222222
55064120,1,18,1.0,19,0.05263157894736842
55065832,7,3,3.0,10,0.3
55074008,6,4,4.0,10,0.4
55074298,4,6,4.0,10,0.4
55078930,2,8,2.0,10,0.2
55081300,16,3,3.0,19,0.15789473684210525
55083119,2,7,2.0,9,0.2222222222222222
55103737,1,9,1.0,10,0.1
55107908,7,3,3.0,10,0.3
55110635,1,9,1.0,10,0.1
55117434,4,15,4.0,19,0.21052631578947367
55118048,4,6,4.0,10,0.4
55130032,1,17,1.0,18,0.05555555555555555
55132761,1,8,1.0,9,0.1111111111111111
55140066,2,8,2.0,10,0.2
55141779,1,26,1.0,27,0.037037037037037035
55145881,1,9,1.0,10,0.1
55152505,1,8,1.0,9,0.1111111111111111
55153744,1,7,1.0,8,0.125
55153784,2,8,2.0,10,0.2
55155472,2,8,2.0,10,0.2
55156750,2,18,2.0,20,0.1
55163547,5,4,4.0,9,0.4444444444444444
55165084,1,7,1.0,8,0.125
55169037,1,18,1.0,19,0.05263157894736842
55172717,6,21,6.0,27,0.2222222222222222
55173055,3,7,3.0,10,0.3
55174631,9,1,1.0,10,0.1
55174990,8,20,8.0,28,0.2857142857142857
55176115,1,8,1.0,9,0.1111111111111111
55177119,2,8,2.0,10,0.2
55195474,3,7,3.0,10,0.3
55200682,1,9,1.0,10,0.1
55211439,3,7,3.0,10,0.3
55215338,1,7,1.0,8,0.125
55222031,1,8,1.0,9,0.1111111111111111
55250057,3,7,3.0,10,0.3
55256446,2,8,2.0,10,0.2
55256794,6,4,4.0,10,0.4
55264435,2,7,2.0,9,0.2222222222222222
55267238,1,7,1.0,8,0.125
55267957,3,6,3.0,9,0.3333333333333333
55275439,2,8,2.0,10,0.2
55285245,3,6,3.0,9,0.3333333333333333
55289943,2,7,2.0,9,0.2222222222222222
55291249,3,6,3.0,9,0.3333333333333333
55292283,1,8,1.0,9,0.1111111111111111
55318671,1,9,1.0,10,0.1
55318854,3,7,3.0,10,0.3
55326751,5,5,5.0,10,0.5
55328678,3,7,3.0,10,0.3
55330636,4,6,4.0,10,0.4
55331243,1,8,1.0,9,0.1111111111111111
55331704,1,9,1.0,10,0.1
55332239,1,8,1.0,9,0.1111111111111111
55334635,4,5,4.0,9,0.4444444444444444
55335161,3,6,3.0,9,0.3333333333333333
55358988,1,18,1.0,19,0.05263157894736842
55363360,1,9,1.0,10,0.1
55365632,1,7,1.0,8,0.125
55383934,4,6,4.0,10,0.4
55384360,3,7,3.0,10,0.3
55386776,3,6,3.0,9,0.3333333333333333
55386974,2,7,2.0,9,0.2222222222222222
55418427,12,17,12.0,29,0.41379310344827586
55423695,1,9,1.0,10,0.1
55485378,1,9,1.0,10,0.1
55502985,2,6,2.0,8,0.25
55505578,3,17,3.0,20,0.15
55518696,4,6,4.0,10,0.4
55522882,2,8,2.0,10,0.2
55523441,3,7,3.0,10,0.3
55523542,1,7,1.0,8,0.125
55524005,1,9,1.0,10,0.1
55525166,1,9,1.0,10,0.1
55529040,1,9,1.0,10,0.1
55546173,8,1,1.0,9,0.1111111111111111
55551066,2,7,2.0,9,0.2222222222222222
55569046,4,5,4.0,9,0.4444444444444444
55574372,1,19,1.0,20,0.05
55583301,2,16,2.0,18,0.1111111111111111
55587675,1,9,1.0,10,0.1
55601379,2,28,2.0,30,0.06666666666666667
55641555,16,10,10.0,26,0.38461538461538464
55641701,4,5,4.0,9,0.4444444444444444
55643255,3,6,3.0,9,0.3333333333333333
55650249,3,6,3.0,9,0.3333333333333333
55659563,3,5,3.0,8,0.375
55669440,4,6,4.0,10,0.4
55671156,3,7,3.0,10,0.3
55675001,7,3,3.0,10,0.3
55691766,5,3,3.0,8,0.375
55691979,9,18,9.0,27,0.3333333333333333
55693570,4,25,4.0,29,0.13793103448275862
55761618,1,18,1.0,19,0.05263157894736842
55818950,2,8,2.0,10,0.2
55828257,2,7,2.0,9,0.2222222222222222
55835698,1,19,1.0,20,0.05
55857039,9,1,1.0,10,0.1
55864773,12,16,12.0,28,0.42857142857142855
55866713,1,7,1.0,8,0.125
55871769,4,25,4.0,29,0.13793103448275862
55874948,5,15,5.0,20,0.25
55884116,7,3,3.0,10,0.3
55887533,10,8,8.0,18,0.4444444444444444
55909031,1,19,1.0,20,0.05
55916903,1,9,1.0,10,0.1
55954850,2,8,2.0,10,0.2
55960873,3,7,3.0,10,0.3
55981195,12,7,7.0,19,0.3684210526315789
55989112,7,1,1.0,8,0.125
55993169,8,2,2.0,10,0.2
55993864,3,5,3.0,8,0.375
55997449,3,7,3.0,10,0.3
56000783,1,8,1.0,9,0.1111111111111111
56001737,1,9,1.0,10,0.1
56006698,5,5,5.0,10,0.5
56007290,1,7,1.0,8,0.125
56008088,4,6,4.0,10,0.4
56010828,3,7,3.0,10,0.3
56013028,4,5,4.0,9,0.4444444444444444
56014313,1,9,1.0,10,0.1
56015990,6,10,6.0,16,0.375
56029747,1,8,1.0,9,0.1111111111111111
56035338,5,5,5.0,10,0.5
56038957,2,8,2.0,10,0.2
56057000,7,1,1.0,8,0.125
56057107,2,8,2.0,10,0.2
56057606,24,3,3.0,27,0.1111111111111111
56058280,2,8,2.0,10,0.2
56071186,4,6,4.0,10,0.4
56073124,5,5,5.0,10,0.5
56076279,3,16,3.0,19,0.15789473684210525
56089815,27,1,1.0,28,0.03571428571428571
56103533,1,9,1.0,10,0.1
56151052,1,8,1.0,9,0.1111111111111111
56159426,1,9,1.0,10,0.1
56161955,1,9,1.0,10,0.1
56167169,3,6,3.0,9,0.3333333333333333
56167840,17,3,3.0,20,0.15
56175675,1,14,1.0,15,0.06666666666666667
56177673,6,2,2.0,8,0.25
56178206,9,1,1.0,10,0.1
56178968,6,3,3.0,9,0.3333333333333333
56179920,6,2,2.0,8,0.25
56187679,2,8,2.0,10,0.2
56190284,2,7,2.0,9,0.2222222222222222
56193368,14,20,14.0,34,0.4117647058823529
56199410,1,9,1.0,10,0.1
56209530,3,7,3.0,10,0.3
56223583,19,11,11.0,30,0.36666666666666664
56233652,5,5,5.0,10,0.5
56235219,14,6,6.0,20,0.3
56249971,5,14,5.0,19,0.2631578947368421
56250096,4,25,4.0,29,0.13793103448275862
56250639,7,3,3.0,10,0.3
56251421,2,8,2.0,10,0.2
56256353,3,15,3.0,18,0.16666666666666666
56260119,1,9,1.0,10,0.1
56260251,1,8,1.0,9,0.1111111111111111
56262771,1,16,1.0,17,0.058823529411764705
56270705,1,7,1.0,8,0.125
56271541,6,4,4.0,10,0.4
56289223,2,8,2.0,10,0.2
56295760,6,4,4.0,10,0.4
56297002,1,9,1.0,10,0.1
56311277,1,8,1.0,9,0.1111111111111111
56313684,1,8,1.0,9,0.1111111111111111
56334566,14,5,5.0,19,0.2631578947368421
56341004,8,2,2.0,10,0.2
56341257,1,9,1.0,10,0.1
56341669,2,8,2.0,10,0.2
56341992,3,6,3.0,9,0.3333333333333333
56342254,2,8,2.0,10,0.2
56347400,3,6,3.0,9,0.3333333333333333
56357830,2,7,2.0,9,0.2222222222222222
56358914,2,8,2.0,10,0.2
56362660,4,6,4.0,10,0.4
56399085,1,9,1.0,10,0.1
56405359,5,4,4.0,9,0.4444444444444444
56405407,6,2,2.0,8,0.25
56409012,3,6,3.0,9,0.3333333333333333
56413145,3,7,3.0,10,0.3
56429116,2,8,2.0,10,0.2
56433649,1,26,1.0,27,0.037037037037037035
56448429,1,9,1.0,10,0.1
56451990,1,9,1.0,10,0.1
56456407,3,5,3.0,8,0.375
56456691,8,2,2.0,10,0.2
56463491,1,8,1.0,9,0.1111111111111111
56476596,1,8,1.0,9,0.1111111111111111
56477342,6,3,3.0,9,0.3333333333333333
56482560,1,9,1.0,10,0.1
56484456,4,6,4.0,10,0.4
56489966,1,9,1.0,10,0.1
56490374,5,5,5.0,10,0.5
56497131,9,16,9.0,25,0.36
56501514,4,16,4.0,20,0.2
56506057,3,7,3.0,10,0.3
56510459,2,18,2.0,20,0.1
56510893,2,8,2.0,10,0.2
56515252,4,6,4.0,10,0.4
56517066,6,3,3.0,9,0.3333333333333333
56518182,20,9,9.0,29,0.3103448275862069
56518309,3,6,3.0,9,0.3333333333333333
56519602,6,4,4.0,10,0.4
56537307,12,7,7.0,19,0.3684210526315789
56547777,8,1,1.0,9,0.1111111111111111
56547864,3,7,3.0,10,0.3
56550197,8,1,1.0,9,0.1111111111111111
56552499,9,1,1.0,10,0.1
56560924,1,9,1.0,10,0.1
56561836,3,6,3.0,9,0.3333333333333333
56568336,5,5,5.0,10,0.5
56569627,5,5,5.0,10,0.5
56570023,1,9,1.0,10,0.1
56579779,1,8,1.0,9,0.1111111111111111
56587685,2,8,2.0,10,0.2
56588596,4,6,4.0,10,0.4
56608365,2,8,2.0,10,0.2
56609035,13,17,13.0,30,0.43333333333333335
56609197,1,9,1.0,10,0.1
56623085,1,8,1.0,9,0.1111111111111111
56628854,5,5,5.0,10,0.5
56631526,2,8,2.0,10,0.2
56632922,2,8,2.0,10,0.2
56642074,1,9,1.0,10,0.1
56642962,17,11,11.0,28,0.39285714285714285
56643415,1,9,1.0,10,0.1
56644221,5,5,5.0,10,0.5
56675109,9,1,1.0,10,0.1
56679802,1,9,1.0,10,0.1
56680139,3,7,3.0,10,0.3
56700409,9,1,1.0,10,0.1
56707594,2,17,2.0,19,0.10526315789473684
56714301,6,4,4.0,10,0.4
56718544,1,9,1.0,10,0.1
56719865,8,2,2.0,10,0.2
56719867,7,2,2.0,9,0.2222222222222222
56720688,2,8,2.0,10,0.2
56722376,1,9,1.0,10,0.1
56724782,3,16,3.0,19,0.15789473684210525
56739655,2,7,2.0,9,0.2222222222222222
56744861,1,7,1.0,8,0.125
56758418,8,1,1.0,9,0.1111111111111111
56758683,4,6,4.0,10,0.4
56759026,6,4,4.0,10,0.4
56760034,1,9,1.0,10,0.1
56760653,3,16,3.0,19,0.15789473684210525
56760734,4,6,4.0,10,0.4
56762608,2,8,2.0,10,0.2
56771470,6,4,4.0,10,0.4
56773250,2,8,2.0,10,0.2
56784773,6,3,3.0,9,0.3333333333333333
56787083,2,16,2.0,18,0.1111111111111111
56790767,6,4,4.0,10,0.4
56798136,1,8,1.0,9,0.1111111111111111
56801367,9,1,1.0,10,0.1
56806409,5,4,4.0,9,0.4444444444444444
56830761,3,7,3.0,10,0.3
56833267,2,8,2.0,10,0.2
56834780,1,8,1.0,9,0.1111111111111111
56835960,1,19,1.0,20,0.05
56836692,1,8,1.0,9,0.1111111111111111
56857102,8,2,2.0,10,0.2
56864622,3,6,3.0,9,0.3333333333333333
56877594,3,7,3.0,10,0.3
56877879,2,8,2.0,10,0.2
56877961,1,8,1.0,9,0.1111111111111111
56885002,5,5,5.0,10,0.5
56891432,5,4,4.0,9,0.4444444444444444
56891977,1,9,1.0,10,0.1
56897820,2,7,2.0,9,0.2222222222222222
56902943,5,5,5.0,10,0.5
56903977,3,7,3.0,10,0.3
56905469,1,17,1.0,18,0.05555555555555555
56905745,2,8,2.0,10,0.2
56906144,5,5,5.0,10,0.5
56906788,4,6,4.0,10,0.4
56917887,2,17,2.0,19,0.10526315789473684
56925781,7,2,2.0,9,0.2222222222222222
56926563,2,8,2.0,10,0.2
56931586,9,1,1.0,10,0.1
56947677,2,8,2.0,10,0.2
56948332,2,7,2.0,9,0.2222222222222222
56962508,2,8,2.0,10,0.2
56966559,1,17,1.0,18,0.05555555555555555
56966694,3,7,3.0,10,0.3
56967205,2,8,2.0,10,0.2
56967909,1,9,1.0,10,0.1
56974147,1,8,1.0,9,0.1111111111111111
56979971,1,9,1.0,10,0.1
56985529,8,1,1.0,9,0.1111111111111111
56995186,5,4,4.0,9,0.4444444444444444
56995879,1,27,1.0,28,0.03571428571428571
56996059,1,19,1.0,20,0.05
57011595,1,16,1.0,17,0.058823529411764705
57048145,5,13,5.0,18,0.2777777777777778
57048184,1,8,1.0,9,0.1111111111111111
57048645,1,9,1.0,10,0.1
57050131,1,9,1.0,10,0.1
57050392,9,1,1.0,10,0.1
57057790,3,7,3.0,10,0.3
57058021,4,6,4.0,10,0.4
57063201,2,16,2.0,18,0.1111111111111111
57065956,1,9,1.0,10,0.1
57067319,1,9,1.0,10,0.1
57076952,9,1,1.0,10,0.1
57077125,3,5,3.0,8,0.375
57081296,1,8,1.0,9,0.1111111111111111
57081635,1,9,1.0,10,0.1
57087843,7,3,3.0,10,0.3
57089327,3,7,3.0,10,0.3
57100317,1,9,1.0,10,0.1
57103482,2,8,2.0,10,0.2
57108627,1,9,1.0,10,0.1
57111115,21,7,7.0,28,0.25
57121727,1,17,1.0,18,0.05555555555555555
57125366,5,13,5.0,18,0.2777777777777778
57127954,1,9,1.0,10,0.1
57128436,2,8,2.0,10,0.2
57128996,1,9,1.0,10,0.1
57129923,2,8,2.0,10,0.2
57133568,13,16,13.0,29,0.4482758620689655
57135157,2,8,2.0,10,0.2
57137853,1,9,1.0,10,0.1
57143386,3,6,3.0,9,0.3333333333333333
57143608,1,19,1.0,20,0.05
57155196,1,18,1.0,19,0.05263157894736842
57156100,1,9,1.0,10,0.1
57161743,5,5,5.0,10,0.5
57162949,3,6,3.0,9,0.3333333333333333
57166444,1,7,1.0,8,0.125
57173213,1,18,1.0,19,0.05263157894736842
57181445,3,6,3.0,9,0.3333333333333333
57203772,1,9,1.0,10,0.1
57220692,1,8,1.0,9,0.1111111111111111
57236871,3,16,3.0,19,0.15789473684210525
57238979,1,9,1.0,10,0.1
57241656,2,7,2.0,9,0.2222222222222222
57244443,2,6,2.0,8,0.25
57248460,1,8,1.0,9,0.1111111111111111
57248576,2,8,2.0,10,0.2
57262688,3,5,3.0,8,0.375
57265400,1,9,1.0,10,0.1
57283474,1,9,1.0,10,0.1
57283656,1,9,1.0,10,0.1
57283716,11,8,8.0,19,0.42105263157894735
57283960,3,7,3.0,10,0.3
57288107,5,5,5.0,10,0.5
57289950,2,8,2.0,10,0.2
57294389,1,7,1.0,8,0.125
57294693,8,20,8.0,28,0.2857142857142857
57297672,1,9,1.0,10,0.1
57316608,1,9,1.0,10,0.1
57316622,3,7,3.0,10,0.3
57319142,1,9,1.0,10,0.1
57323156,4,4,4.0,8,0.5
57323339,2,8,2.0,10,0.2
57324735,1,8,1.0,9,0.1111111111111111
57339979,6,4,4.0,10,0.4
57342780,12,17,12.0,29,0.41379310344827586
57343129,3,6,3.0,9,0.3333333333333333
57344660,1,9,1.0,10,0.1
57345210,4,4,4.0,8,0.5
57352998,3,6,3.0,9,0.3333333333333333
57357520,1,9,1.0,10,0.1
57358689,5,5,5.0,10,0.5
57364389,1,9,1.0,10,0.1
57395904,5,14,5.0,19,0.2631578947368421
57397069,3,7,3.0,10,0.3
57399124,9,1,1.0,10,0.1
57404244,6,13,6.0,19,0.3157894736842105
57406174,4,6,4.0,10,0.4
57407250,2,8,2.0,10,0.2
57407294,8,1,1.0,9,0.1111111111111111
57422110,4,15,4.0,19,0.21052631578947367
57427478,13,15,13.0,28,0.4642857142857143
57430624,1,9,1.0,10,0.1
57433316,2,8,2.0,10,0.2
57434293,3,17,3.0,20,0.15
57435312,5,5,5.0,10,0.5
57436026,4,16,4.0,20,0.2
57436181,1,9,1.0,10,0.1
57438057,5,5,5.0,10,0.5
57438867,1,9,1.0,10,0.1
57446884,6,13,6.0,19,0.3157894736842105
57450409,6,4,4.0,10,0.4
57450698,1,8,1.0,9,0.1111111111111111
57454923,3,7,3.0,10,0.3
57455099,1,9,1.0,10,0.1
57465307,2,8,2.0,10,0.2
57468923,1,9,1.0,10,0.1
57480614,3,7,3.0,10,0.3
57491366,1,19,1.0,20,0.05
57537035,1,19,1.0,20,0.05
57538082,1,8,1.0,9,0.1111111111111111
57549034,1,8,1.0,9,0.1111111111111111
57549868,6,23,6.0,29,0.20689655172413793
57565385,8,2,2.0,10,0.2
57565507,1,9,1.0,10,0.1
57565999,7,3,3.0,10,0.3
57568069,7,22,7.0,29,0.2413793103448276
57578251,1,9,1.0,10,0.1
57578904,1,8,1.0,9,0.1111111111111111
57589672,3,7,3.0,10,0.3
57597379,1,9,1.0,10,0.1
57609623,1,9,1.0,10,0.1
57610450,3,6,3.0,9,0.3333333333333333
57610529,2,8,2.0,10,0.2
57612234,5,4,4.0,9,0.4444444444444444
57613296,1,9,1.0,10,0.1
57613925,2,7,2.0,9,0.2222222222222222
57619160,1,9,1.0,10,0.1
57620844,9,1,1.0,10,0.1
57620921,3,7,3.0,10,0.3
57621190,9,1,1.0,10,0.1
57623657,4,6,4.0,10,0.4
57625589,1,9,1.0,10,0.1
57626748,2,18,2.0,20,0.1
57628524,4,6,4.0,10,0.4
57630729,7,3,3.0,10,0.3
57635334,1,8,1.0,9,0.1111111111111111
57638346,1,18,1.0,19,0.05263157894736842
57638522,6,3,3.0,9,0.3333333333333333
57638895,3,7,3.0,10,0.3
57640394,3,26,3.0,29,0.10344827586206896
57641692,1,9,1.0,10,0.1
57669052,1,9,1.0,10,0.1
57671927,3,6,3.0,9,0.3333333333333333
57672584,3,7,3.0,10,0.3
57675807,2,18,2.0,20,0.1
57680901,6,3,3.0,9,0.3333333333333333
57681782,5,5,5.0,10,0.5
57682322,3,7,3.0,10,0.3
57689146,2,7,2.0,9,0.2222222222222222
57693132,3,7,3.0,10,0.3
57700148,6,4,4.0,10,0.4
57700459,5,5,5.0,10,0.5
57702297,3,25,3.0,28,0.10714285714285714
57709108,1,9,1.0,10,0.1
57718417,1,9,1.0,10,0.1
57719222,1,8,1.0,9,0.1111111111111111
57721935,1,9,1.0,10,0.1
57724941,3,7,3.0,10,0.3
57729350,4,4,4.0,8,0.5
57732491,1,9,1.0,10,0.1
57732694,1,8,1.0,9,0.1111111111111111
57733686,1,9,1.0,10,0.1
57737224,1,17,1.0,18,0.05555555555555555
57737546,3,7,3.0,10,0.3
57737847,3,6,3.0,9,0.3333333333333333
57738531,3,7,3.0,10,0.3
57741657,6,21,6.0,27,0.2222222222222222
57748824,1,9,1.0,10,0.1
57754816,8,1,1.0,9,0.1111111111111111
57755192,1,9,1.0,10,0.1
57765130,9,1,1.0,10,0.1
57767127,1,26,1.0,27,0.037037037037037035
57780434,3,7,3.0,10,0.3
57784127,1,8,1.0,9,0.1111111111111111
57787903,6,4,4.0,10,0.4
57789554,1,9,1.0,10,0.1
57802689,3,6,3.0,9,0.3333333333333333
57808023,2,8,2.0,10,0.2
57818526,2,8,2.0,10,0.2
57827943,7,22,7.0,29,0.2413793103448276
57838251,3,6,3.0,9,0.3333333333333333
57840252,6,2,2.0,8,0.25
57841667,5,15,5.0,20,0.25
57857195,5,5,5.0,10,0.5
57861113,6,2,2.0,8,0.25
57874157,5,23,5.0,28,0.17857142857142858
57894802,1,29,1.0,30,0.03333333333333333
57917221,7,2,2.0,9,0.2222222222222222
57918005,2,6,2.0,8,0.25
57921944,2,8,2.0,10,0.2
57942124,1,9,1.0,10,0.1
57950276,3,7,3.0,10,0.3
57998205,2,7,2.0,9,0.2222222222222222
58000749,1,17,1.0,18,0.05555555555555555
58031180,2,8,2.0,10,0.2
58072139,4,5,4.0,9,0.4444444444444444
58074945,1,9,1.0,10,0.1
58075433,1,8,1.0,9,0.1111111111111111
58084138,5,5,5.0,10,0.5
58084257,3,7,3.0,10,0.3
58098621,1,7,1.0,8,0.125
58102094,1,8,1.0,9,0.1111111111111111
58113568,1,9,1.0,10,0.1
58126455,7,2,2.0,9,0.2222222222222222
58126747,9,1,1.0,10,0.1
58127945,5,5,5.0,10,0.5
58129545,7,3,3.0,10,0.3
58130190,1,8,1.0,9,0.1111111111111111
58138705,2,7,2.0,9,0.2222222222222222
58140873,1,9,1.0,10,0.1
58141473,2,6,2.0,8,0.25
58144379,3,7,3.0,10,0.3
58145574,3,17,3.0,20,0.15
58146706,1,18,1.0,19,0.05263157894736842
58172404,1,9,1.0,10,0.1
58172920,4,6,4.0,10,0.4
58173067,9,1,1.0,10,0.1
58173200,5,5,5.0,10,0.5
58173343,1,9,1.0,10,0.1
58173397,1,9,1.0,10,0.1
58174037,2,7,2.0,9,0.2222222222222222
58175357,2,26,2.0,28,0.07142857142857142
58186171,1,17,1.0,18,0.05555555555555555
58215673,1,18,1.0,19,0.05263157894736842
58218143,1,8,1.0,9,0.1111111111111111
58222126,6,4,4.0,10,0.4
58224855,6,3,3.0,9,0.3333333333333333
58225657,24,4,4.0,28,0.14285714285714285
58244044,7,3,3.0,10,0.3
58255915,29,1,1.0,30,0.03333333333333333
58260189,1,9,1.0,10,0.1
58263286,6,4,4.0,10,0.4
58264823,2,8,2.0,10,0.2
58265055,8,2,2.0,10,0.2
58265254,3,7,3.0,10,0.3
58265700,1,8,1.0,9,0.1111111111111111
58268892,9,1,1.0,10,0.1
58275519,2,8,2.0,10,0.2
58275712,2,8,2.0,10,0.2
58285029,6,3,3.0,9,0.3333333333333333
58287781,2,6,2.0,8,0.25
58289666,2,8,2.0,10,0.2
58294731,1,18,1.0,19,0.05263157894736842
58295599,2,18,2.0,20,0.1
58317261,7,3,3.0,10,0.3
58319167,1,9,1.0,10,0.1
58320175,2,8,2.0,10,0.2
58329165,1,9,1.0,10,0.1
58329287,1,9,1.0,10,0.1
58329379,1,26,1.0,27,0.037037037037037035
58346799,3,26,3.0,29,0.10344827586206896
58348141,3,17,3.0,20,0.15
58354335,4,6,4.0,10,0.4
58376994,1,19,1.0,20,0.05
58405689,1,9,1.0,10,0.1
58414454,9,1,1.0,10,0.1
58414749,2,8,2.0,10,0.2
58424088,1,19,1.0,20,0.05
58445205,1,9,1.0,10,0.1
58456205,1,9,1.0,10,0.1
58456449,12,16,12.0,28,0.42857142857142855
58456783,1,8,1.0,9,0.1111111111111111
58463093,2,7,2.0,9,0.2222222222222222
58465204,5,5,5.0,10,0.5
58476633,1,8,1.0,9,0.1111111111111111
58479025,1,8,1.0,9,0.1111111111111111
58494496,5,5,5.0,10,0.5
58499947,3,7,3.0,10,0.3
58500085,5,12,5.0,17,0.29411764705882354
58512643,1,19,1.0,20,0.05
58529310,2,7,2.0,9,0.2222222222222222
58534633,2,8,2.0,10,0.2
58544399,3,17,3.0,20,0.15
58544495,1,9,1.0,10,0.1
58546742,2,8,2.0,10,0.2
58569909,4,4,4.0,8,0.5
58591075,4,6,4.0,10,0.4
58591379,5,4,4.0,9,0.4444444444444444
58596207,1,18,1.0,19,0.05263157894736842
58602023,2,8,2.0,10,0.2
58602903,5,3,3.0,8,0.375
58606292,2,7,2.0,9,0.2222222222222222
58608580,4,15,4.0,19,0.21052631578947367
58620513,2,8,2.0,10,0.2
58628005,4,4,4.0,8,0.5
58628983,8,2,2.0,10,0.2
58629135,2,7,2.0,9,0.2222222222222222
58630587,1,7,1.0,8,0.125
58631940,4,6,4.0,10,0.4
58635999,2,7,2.0,9,0.2222222222222222
58637300,1,9,1.0,10,0.1
58640557,13,15,13.0,28,0.4642857142857143
58643600,10,9,9.0,19,0.47368421052631576
58646304,6,4,4.0,10,0.4
58646697,1,9,1.0,10,0.1
58648428,1,19,1.0,20,0.05
58648940,3,17,3.0,20,0.15
58662149,1,9,1.0,10,0.1
58672134,1,9,1.0,10,0.1
58672731,8,1,1.0,9,0.1111111111111111
58673047,7,2,2.0,9,0.2222222222222222
58673857,5,5,5.0,10,0.5
58675153,2,7,2.0,9,0.2222222222222222
58675766,1,8,1.0,9,0.1111111111111111
58676400,1,9,1.0,10,0.1
58676760,2,7,2.0,9,0.2222222222222222
58679228,2,7,2.0,9,0.2222222222222222
58680879,3,6,3.0,9,0.3333333333333333
58682392,2,7,2.0,9,0.2222222222222222
58685584,1,9,1.0,10,0.1
58692106,6,3,3.0,9,0.3333333333333333
58692979,9,1,1.0,10,0.1
58693602,5,4,4.0,9,0.4444444444444444
58694769,3,6,3.0,9,0.3333333333333333
58694869,2,8,2.0,10,0.2
58696144,3,7,3.0,10,0.3
58700710,2,8,2.0,10,0.2
58705705,9,1,1.0,10,0.1
58709494,8,2,2.0,10,0.2
58709654,18,1,1.0,19,0.05263157894736842
58711691,9,1,1.0,10,0.1
58714048,1,9,1.0,10,0.1
58715368,4,6,4.0,10,0.4
58715556,1,9,1.0,10,0.1
58719345,3,6,3.0,9,0.3333333333333333
58719832,7,3,3.0,10,0.3
58720204,16,13,13.0,29,0.4482758620689655
58721005,2,8,2.0,10,0.2
58725185,5,5,5.0,10,0.5
58727483,1,9,1.0,10,0.1
58739400,3,7,3.0,10,0.3
58751209,1,9,1.0,10,0.1
58751344,1,9,1.0,10,0.1
58757657,1,18,1.0,19,0.05263157894736842
58761679,1,8,1.0,9,0.1111111111111111
58769057,1,9,1.0,10,0.1
58773879,3,6,3.0,9,0.3333333333333333
58780152,1,9,1.0,10,0.1
58781794,3,7,3.0,10,0.3
58785678,4,16,4.0,20,0.2
58809761,2,7,2.0,9,0.2222222222222222
58815743,1,8,1.0,9,0.1111111111111111
58816275,1,9,1.0,10,0.1
58816960,3,7,3.0,10,0.3
58851875,23,7,7.0,30,0.23333333333333334
58852167,1,9,1.0,10,0.1
58852242,6,4,4.0,10,0.4
58858223,9,1,1.0,10,0.1
58860882,1,9,1.0,10,0.1
58866571,3,7,3.0,10,0.3
58867483,4,6,4.0,10,0.4
58868487,8,1,1.0,9,0.1111111111111111
58869131,1,8,1.0,9,0.1111111111111111
58872378,1,8,1.0,9,0.1111111111111111
58873643,1,19,1.0,20,0.05
58881461,1,18,1.0,19,0.05263157894736842
58893407,3,7,3.0,10,0.3
58893612,2,8,2.0,10,0.2
58897882,2,8,2.0,10,0.2
58913660,4,4,4.0,8,0.5
58916520,2,6,2.0,8,0.25
58917644,3,6,3.0,9,0.3333333333333333
58925513,1,8,1.0,9,0.1111111111111111
58932037,11,17,11.0,28,0.39285714285714285
58938361,3,5,3.0,8,0.375
58944740,1,19,1.0,20,0.05
58945656,1,7,1.0,8,0.125
58966195,1,19,1.0,20,0.05
58966276,6,4,4.0,10,0.4
58966873,6,4,4.0,10,0.4
58968255,8,2,2.0,10,0.2
58977240,15,15,15.0,30,0.5
58984894,4,6,4.0,10,0.4
58993250,2,8,2.0,10,0.2
58994378,1,8,1.0,9,0.1111111111111111
58994481,2,18,2.0,20,0.1
59006376,2,7,2.0,9,0.2222222222222222
59010250,3,5,3.0,8,0.375
59010911,3,7,3.0,10,0.3
59012786,5,5,5.0,10,0.5
59014576,4,6,4.0,10,0.4
59027989,2,8,2.0,10,0.2
59032823,4,6,4.0,10,0.4
59033196,2,8,2.0,10,0.2
59040970,1,8,1.0,9,0.1111111111111111
59047333,2,18,2.0,20,0.1
59053219,8,21,8.0,29,0.27586206896551724
59079945,1,7,1.0,8,0.125
59081902,2,8,2.0,10,0.2
59088800,1,7,1.0,8,0.125
59092227,1,9,1.0,10,0.1
59092537,1,17,1.0,18,0.05555555555555555
59099343,1,9,1.0,10,0.1
59111195,5,4,4.0,9,0.4444444444444444
59113582,1,8,1.0,9,0.1111111111111111
59125445,1,7,1.0,8,0.125
59146917,4,6,4.0,10,0.4
59148006,1,9,1.0,10,0.1
59148429,1,7,1.0,8,0.125
59151772,1,9,1.0,10,0.1
59163207,2,17,2.0,19,0.10526315789473684
59166333,1,8,1.0,9,0.1111111111111111
59180289,1,9,1.0,10,0.1
59181275,1,9,1.0,10,0.1
59190397,4,6,4.0,10,0.4
59192497,2,7,2.0,9,0.2222222222222222
59204149,4,6,4.0,10,0.4
59215219,1,9,1.0,10,0.1
59234153,1,9,1.0,10,0.1
59248613,1,17,1.0,18,0.05555555555555555
59265351,3,7,3.0,10,0.3
59269418,1,9,1.0,10,0.1
59272487,3,7,3.0,10,0.3
59273228,2,8,2.0,10,0.2
59277118,2,8,2.0,10,0.2
59310352,2,8,2.0,10,0.2
59315604,4,6,4.0,10,0.4
59317004,2,8,2.0,10,0.2
59317867,1,8,1.0,9,0.1111111111111111
59320913,1,9,1.0,10,0.1
59337095,5,3,3.0,8,0.375
59356931,3,6,3.0,9,0.3333333333333333
59357576,7,2,2.0,9,0.2222222222222222
59362449,3,5,3.0,8,0.375
59362968,1,28,1.0,29,0.034482758620689655
59364888,5,5,5.0,10,0.5
59381608,2,8,2.0,10,0.2
59393179,3,6,3.0,9,0.3333333333333333
59397236,2,8,2.0,10,0.2
59397669,1,9,1.0,10,0.1
59399054,1,9,1.0,10,0.1
59399246,1,8,1.0,9,0.1111111111111111
59400514,1,7,1.0,8,0.125
59402021,3,7,3.0,10,0.3
59403490,2,8,2.0,10,0.2
59407042,4,6,4.0,10,0.4
59408045,2,8,2.0,10,0.2
59427624,7,3,3.0,10,0.3
59428016,3,7,3.0,10,0.3
59430388,3,7,3.0,10,0.3
59432332,4,6,4.0,10,0.4
59432926,3,7,3.0,10,0.3
59444706,6,3,3.0,9,0.3333333333333333
59448252,3,7,3.0,10,0.3
59451285,7,12,7.0,19,0.3684210526315789
59454475,1,9,1.0,10,0.1
59458665,4,6,4.0,10,0.4
59458934,6,4,4.0,10,0.4
59460244,8,2,2.0,10,0.2
59463603,2,7,2.0,9,0.2222222222222222
59466795,7,2,2.0,9,0.2222222222222222
59471083,1,7,1.0,8,0.125
59472185,3,7,3.0,10,0.3
59473919,5,4,4.0,9,0.4444444444444444
59474228,2,8,2.0,10,0.2
59492544,1,8,1.0,9,0.1111111111111111
59518090,4,6,4.0,10,0.4
59524028,4,5,4.0,9,0.4444444444444444
59528596,7,2,2.0,9,0.2222222222222222
59529504,4,6,4.0,10,0.4
59531487,2,8,2.0,10,0.2
59531909,7,12,7.0,19,0.3684210526315789
59541739,3,7,3.0,10,0.3
59542014,1,18,1.0,19,0.05263157894736842
59559029,20,8,8.0,28,0.2857142857142857
59559294,6,4,4.0,10,0.4
59561381,2,7,2.0,9,0.2222222222222222
59564797,3,7,3.0,10,0.3
59583987,1,8,1.0,9,0.1111111111111111
59585477,3,7,3.0,10,0.3
59586063,2,17,2.0,19,0.10526315789473684
59586172,1,7,1.0,8,0.125
59588560,3,6,3.0,9,0.3333333333333333
59594146,1,9,1.0,10,0.1
59597870,4,6,4.0,10,0.4
59611256,3,7,3.0,10,0.3
59641595,1,16,1.0,17,0.058823529411764705
59648603,14,11,11.0,25,0.44
59651578,4,4,4.0,8,0.5
59654983,1,9,1.0,10,0.1
59655395,1,8,1.0,9,0.1111111111111111
59655878,4,15,4.0,19,0.21052631578947367
59660155,1,9,1.0,10,0.1
59671135,1,9,1.0,10,0.1
59673442,1,9,1.0,10,0.1
59673485,3,6,3.0,9,0.3333333333333333
59684509,1,9,1.0,10,0.1
59697217,2,8,2.0,10,0.2
59698097,20,9,9.0,29,0.3103448275862069
59698298,2,8,2.0,10,0.2
59700267,2,8,2.0,10,0.2
59724285,2,8,2.0,10,0.2
59724559,3,5,3.0,8,0.375
59729352,23,5,5.0,28,0.17857142857142858
59729658,1,8,1.0,9,0.1111111111111111
59731999,1,8,1.0,9,0.1111111111111111
59732631,2,8,2.0,10,0.2
59732743,4,6,4.0,10,0.4
59733185,11,17,11.0,28,0.39285714285714285
59733312,2,7,2.0,9,0.2222222222222222
59736087,3,6,3.0,9,0.3333333333333333
59737744,1,9,1.0,10,0.1
59753812,2,17,2.0,19,0.10526315789473684
59759651,4,6,4.0,10,0.4
59761957,12,7,7.0,19,0.3684210526315789
59768804,5,3,3.0,8,0.375
59769909,7,3,3.0,10,0.3
59774945,9,1,1.0,10,0.1
59786576,7,17,7.0,24,0.2916666666666667
59788159,15,14,14.0,29,0.4827586206896552
59788503,3,7,3.0,10,0.3
59792160,1,9,1.0,10,0.1
59793126,1,8,1.0,9,0.1111111111111111
59847528,1,9,1.0,10,0.1
59847778,8,19,8.0,27,0.2962962962962963
59852847,5,14,5.0,19,0.2631578947368421
59855575,1,9,1.0,10,0.1
59856561,2,8,2.0,10,0.2
59857359,3,7,3.0,10,0.3
59872256,1,17,1.0,18,0.05555555555555555
59879787,4,4,4.0,8,0.5
59895249,4,6,4.0,10,0.4
59906204,1,19,1.0,20,0.05
59912933,2,8,2.0,10,0.2
59916045,2,8,2.0,10,0.2
59940745,16,3,3.0,19,0.15789473684210525
59955795,27,1,1.0,28,0.03571428571428571
59969603,3,6,3.0,9,0.3333333333333333
59969810,2,6,2.0,8,0.25
59972201,2,8,2.0,10,0.2
59998973,1,19,1.0,20,0.05
60008479,3,5,3.0,8,0.375
60009144,1,7,1.0,8,0.125
60029333,1,16,1.0,17,0.058823529411764705
60031210,6,3,3.0,9,0.3333333333333333
60042904,5,15,5.0,20,0.25
60048237,1,8,1.0,9,0.1111111111111111
60048791,1,8,1.0,9,0.1111111111111111
60049548,3,5,3.0,8,0.375
60049629,1,9,1.0,10,0.1
60050714,1,9,1.0,10,0.1
60053521,1,9,1.0,10,0.1
60054864,2,6,2.0,8,0.25
60055238,4,23,4.0,27,0.14814814814814814
60060354,1,9,1.0,10,0.1
60064228,5,21,5.0,26,0.19230769230769232
60064296,3,7,3.0,10,0.3
60064399,2,8,2.0,10,0.2
60065271,1,9,1.0,10,0.1
60065460,6,2,2.0,8,0.25
60076123,1,18,1.0,19,0.05263157894736842
60079827,3,7,3.0,10,0.3
60098185,1,19,1.0,20,0.05
60098840,2,7,2.0,9,0.2222222222222222
60099664,4,5,4.0,9,0.4444444444444444
60107855,4,6,4.0,10,0.4
60109753,4,6,4.0,10,0.4
60111455,2,8,2.0,10,0.2
60111730,1,19,1.0,20,0.05
60112556,15,14,14.0,29,0.4827586206896552
60113625,2,7,2.0,9,0.2222222222222222
60118501,2,8,2.0,10,0.2
60136573,4,6,4.0,10,0.4
60137771,1,9,1.0,10,0.1
60138615,6,22,6.0,28,0.21428571428571427
60139062,2,6,2.0,8,0.25
60139326,3,6,3.0,9,0.3333333333333333
60142897,1,18,1.0,19,0.05263157894736842
60147143,1,7,1.0,8,0.125
60152925,6,3,3.0,9,0.3333333333333333
60154562,3,7,3.0,10,0.3
60155412,1,8,1.0,9,0.1111111111111111
60156860,5,5,5.0,10,0.5
60183469,4,5,4.0,9,0.4444444444444444
60183526,1,9,1.0,10,0.1
60188404,1,9,1.0,10,0.1
60189596,2,17,2.0,19,0.10526315789473684
60210025,1,19,1.0,20,0.05
60226622,1,9,1.0,10,0.1
60240343,12,15,12.0,27,0.4444444444444444
60251532,1,7,1.0,8,0.125
60251645,3,7,3.0,10,0.3
60252608,1,7,1.0,8,0.125
60262328,1,17,1.0,18,0.05555555555555555
60263378,1,8,1.0,9,0.1111111111111111
60273827,1,9,1.0,10,0.1
60277491,4,5,4.0,9,0.4444444444444444
60289392,1,8,1.0,9,0.1111111111111111
60295369,1,9,1.0,10,0.1
60296601,2,7,2.0,9,0.2222222222222222
60303074,1,8,1.0,9,0.1111111111111111
60304894,9,11,9.0,20,0.45
60307623,3,16,3.0,19,0.15789473684210525
60318025,2,8,2.0,10,0.2
60348492,1,8,1.0,9,0.1111111111111111
60354332,1,8,1.0,9,0.1111111111111111
60357156,5,5,5.0,10,0.5
60357195,1,9,1.0,10,0.1
60358958,1,18,1.0,19,0.05263157894736842
60363879,8,2,2.0,10,0.2
60369512,2,7,2.0,9,0.2222222222222222
60370853,2,8,2.0,10,0.2
60371719,5,5,5.0,10,0.5
60382409,5,4,4.0,9,0.4444444444444444
60399500,3,6,3.0,9,0.3333333333333333
60406736,3,7,3.0,10,0.3
60437258,1,9,1.0,10,0.1
60449193,3,7,3.0,10,0.3
60451911,1,9,1.0,10,0.1
60483560,5,5,5.0,10,0.5
60493649,1,8,1.0,9,0.1111111111111111
60522611,1,9,1.0,10,0.1
60530785,3,7,3.0,10,0.3
60531037,2,18,2.0,20,0.1
60533466,1,7,1.0,8,0.125
60538547,1,9,1.0,10,0.1
60550229,1,7,1.0,8,0.125
60552923,1,8,1.0,9,0.1111111111111111
60554077,1,9,1.0,10,0.1
60562816,1,9,1.0,10,0.1
60575459,1,18,1.0,19,0.05263157894736842
60591676,4,6,4.0,10,0.4
60593215,8,2,2.0,10,0.2
60593323,2,8,2.0,10,0.2
60594723,3,6,3.0,9,0.3333333333333333
60595431,1,18,1.0,19,0.05263157894736842
60597019,3,7,3.0,10,0.3
60607710,1,8,1.0,9,0.1111111111111111
60608561,3,7,3.0,10,0.3
60617527,7,3,3.0,10,0.3
60649012,1,9,1.0,10,0.1
60656786,1,9,1.0,10,0.1
60673038,1,9,1.0,10,0.1
60673360,1,9,1.0,10,0.1
60673449,2,8,2.0,10,0.2
60675259,1,9,1.0,10,0.1
60676164,4,6,4.0,10,0.4
60676914,5,4,4.0,9,0.4444444444444444
60677332,5,5,5.0,10,0.5
60678025,5,5,5.0,10,0.5
60678713,3,7,3.0,10,0.3
60678964,1,9,1.0,10,0.1
60680142,1,8,1.0,9,0.1111111111111111
60690818,1,16,1.0,17,0.058823529411764705
60692099,3,5,3.0,8,0.375
60692366,2,8,2.0,10,0.2
60700921,3,7,3.0,10,0.3
60703167,1,9,1.0,10,0.1
60703428,3,7,3.0,10,0.3
60710852,1,9,1.0,10,0.1
60717351,8,2,2.0,10,0.2
60731514,6,3,3.0,9,0.3333333333333333
60738355,1,9,1.0,10,0.1
60739313,4,6,4.0,10,0.4
60739984,6,22,6.0,28,0.21428571428571427
60769861,2,8,2.0,10,0.2
60770146,1,28,1.0,29,0.034482758620689655
60776844,7,1,1.0,8,0.125
60777255,1,9,1.0,10,0.1
60778759,8,2,2.0,10,0.2
60778857,2,8,2.0,10,0.2
60779626,1,8,1.0,9,0.1111111111111111
60794082,1,18,1.0,19,0.05263157894736842
60807484,1,17,1.0,18,0.05555555555555555
60823351,1,16,1.0,17,0.058823529411764705
60824426,5,13,5.0,18,0.2777777777777778
60826323,4,6,4.0,10,0.4
60843127,1,8,1.0,9,0.1111111111111111
60851366,1,9,1.0,10,0.1
60859055,3,7,3.0,10,0.3
60875503,1,9,1.0,10,0.1
60876766,1,9,1.0,10,0.1
60879025,2,8,2.0,10,0.2
60894814,2,7,2.0,9,0.2222222222222222
60897567,2,7,2.0,9,0.2222222222222222
60912490,1,18,1.0,19,0.05263157894736842
60913267,1,8,1.0,9,0.1111111111111111
60913431,1,9,1.0,10,0.1
60924245,9,1,1.0,10,0.1
60925293,6,3,3.0,9,0.3333333333333333
60933889,2,7,2.0,9,0.2222222222222222
60942754,3,7,3.0,10,0.3
60949145,2,8,2.0,10,0.2
60952338,2,8,2.0,10,0.2
60955009,1,8,1.0,9,0.1111111111111111
60960299,2,8,2.0,10,0.2
60966048,9,1,1.0,10,0.1
60979849,1,9,1.0,10,0.1
60981786,1,8,1.0,9,0.1111111111111111
60995509,1,9,1.0,10,0.1
61002665,1,8,1.0,9,0.1111111111111111
61003554,3,6,3.0,9,0.3333333333333333
61008316,4,25,4.0,29,0.13793103448275862
61018686,9,1,1.0,10,0.1
61030252,1,9,1.0,10,0.1
61031261,4,5,4.0,9,0.4444444444444444
61044832,2,8,2.0,10,0.2
61045213,1,9,1.0,10,0.1
61046932,1,19,1.0,20,0.05
61047605,1,9,1.0,10,0.1
61052429,2,8,2.0,10,0.2
61071099,2,7,2.0,9,0.2222222222222222
61075626,2,16,2.0,18,0.1111111111111111
61087557,1,9,1.0,10,0.1
61089396,1,18,1.0,19,0.05263157894736842
61100864,1,18,1.0,19,0.05263157894736842
61127410,1,8,1.0,9,0.1111111111111111
61128748,4,6,4.0,10,0.4
61148562,2,17,2.0,19,0.10526315789473684
61158655,2,8,2.0,10,0.2
61175268,2,8,2.0,10,0.2
61175589,1,9,1.0,10,0.1
61175716,1,9,1.0,10,0.1
61183937,1,8,1.0,9,0.1111111111111111
61192380,1,8,1.0,9,0.1111111111111111
61195553,4,5,4.0,9,0.4444444444444444
61197148,1,19,1.0,20,0.05
61199346,1,19,1.0,20,0.05
61199805,7,2,2.0,9,0.2222222222222222
61200429,4,6,4.0,10,0.4
61200951,7,3,3.0,10,0.3
61206527,2,8,2.0,10,0.2
61206927,2,8,2.0,10,0.2
61211412,2,6,2.0,8,0.25
61211591,5,5,5.0,10,0.5
61214717,5,5,5.0,10,0.5
61214961,2,8,2.0,10,0.2
61217450,1,9,1.0,10,0.1
61220305,2,17,2.0,19,0.10526315789473684
61223918,1,9,1.0,10,0.1
61229006,5,5,5.0,10,0.5
61229662,6,14,6.0,20,0.3
61253430,3,7,3.0,10,0.3
61253649,1,9,1.0,10,0.1
61257312,1,8,1.0,9,0.1111111111111111
61263627,4,5,4.0,9,0.4444444444444444
61263909,2,7,2.0,9,0.2222222222222222
61266044,1,18,1.0,19,0.05263157894736842
61275166,4,6,4.0,10,0.4
61288249,1,9,1.0,10,0.1
61295817,1,17,1.0,18,0.05555555555555555
61304289,2,15,2.0,17,0.11764705882352941
61306818,1,9,1.0,10,0.1
61307371,1,9,1.0,10,0.1
61319092,2,7,2.0,9,0.2222222222222222
61323061,7,3,3.0,10,0.3
61348443,7,1,1.0,8,0.125
61351579,5,15,5.0,20,0.25
61377261,2,28,2.0,30,0.06666666666666667
61378825,3,6,3.0,9,0.3333333333333333
61380610,4,6,4.0,10,0.4
61391460,1,9,1.0,10,0.1
61405805,1,8,1.0,9,0.1111111111111111
61406644,3,6,3.0,9,0.3333333333333333
61422273,1,8,1.0,9,0.1111111111111111
61433041,3,6,3.0,9,0.3333333333333333
61433725,1,9,1.0,10,0.1
61447687,1,8,1.0,9,0.1111111111111111
61475562,1,9,1.0,10,0.1
61511574,1,7,1.0,8,0.125
61513044,2,8,2.0,10,0.2
61514843,5,4,4.0,9,0.4444444444444444
61515189,1,9,1.0,10,0.1
61515569,2,27,2.0,29,0.06896551724137931
61515875,2,8,2.0,10,0.2
61518220,3,7,3.0,10,0.3
61527192,2,8,2.0,10,0.2
61527456,2,8,2.0,10,0.2
61527923,4,5,4.0,9,0.4444444444444444
61531622,1,9,1.0,10,0.1
61534142,2,8,2.0,10,0.2
61537144,2,8,2.0,10,0.2
61540151,2,16,2.0,18,0.1111111111111111
61552319,1,9,1.0,10,0.1
61556228,5,4,4.0,9,0.4444444444444444
61577147,1,7,1.0,8,0.125
61581988,3,16,3.0,19,0.15789473684210525
61588590,1,9,1.0,10,0.1
61590692,1,9,1.0,10,0.1
61593641,1,19,1.0,20,0.05
61603922,6,4,4.0,10,0.4
61611400,3,7,3.0,10,0.3
61632972,4,16,4.0,20,0.2
61639888,1,19,1.0,20,0.05
61644182,7,3,3.0,10,0.3
61669919,2,8,2.0,10,0.2
61669972,1,9,1.0,10,0.1
61698256,1,9,1.0,10,0.1
61708481,2,7,2.0,9,0.2222222222222222
61754738,8,2,2.0,10,0.2
61764012,1,18,1.0,19,0.05263157894736842
61766370,1,19,1.0,20,0.05
61773150,2,7,2.0,9,0.2222222222222222
61773438,9,1,1.0,10,0.1
61781605,2,8,2.0,10,0.2
61785908,2,6,2.0,8,0.25
61798113,2,7,2.0,9,0.2222222222222222
61837183,1,8,1.0,9,0.1111111111111111
61837639,6,3,3.0,9,0.3333333333333333
61837901,4,6,4.0,10,0.4
61838124,9,1,1.0,10,0.1
61839098,2,17,2.0,19,0.10526315789473684
61846543,2,7,2.0,9,0.2222222222222222
61848046,3,6,3.0,9,0.3333333333333333
61849532,2,6,2.0,8,0.25
61870469,6,12,6.0,18,0.3333333333333333
61876388,24,6,6.0,30,0.2
61878365,5,3,3.0,8,0.375
61889752,1,9,1.0,10,0.1
61890195,1,9,1.0,10,0.1
61890754,1,18,1.0,19,0.05263157894736842
61906758,3,17,3.0,20,0.15
61921892,2,7,2.0,9,0.2222222222222222
61922394,15,10,10.0,25,0.4
61932465,1,7,1.0,8,0.125
61947744,3,6,3.0,9,0.3333333333333333
61948172,5,4,4.0,9,0.4444444444444444
61948236,3,7,3.0,10,0.3
61948540,5,5,5.0,10,0.5
61948853,7,3,3.0,10,0.3
61949286,9,1,1.0,10,0.1
61954991,2,18,2.0,20,0.1
61979520,1,9,1.0,10,0.1
61990989,2,8,2.0,10,0.2
61991542,3,6,3.0,9,0.3333333333333333
61991796,5,4,4.0,9,0.4444444444444444
61992202,4,6,4.0,10,0.4
61992462,1,29,1.0,30,0.03333333333333333
61993915,5,5,5.0,10,0.5
62002482,2,8,2.0,10,0.2
62038857,1,9,1.0,10,0.1
62039103,1,8,1.0,9,0.1111111111111111
62042856,2,17,2.0,19,0.10526315789473684
62046082,8,2,2.0,10,0.2
62048748,12,18,12.0,30,0.4
62063679,8,1,1.0,9,0.1111111111111111
62074404,1,18,1.0,19,0.05263157894736842
62106866,1,9,1.0,10,0.1
62118800,4,6,4.0,10,0.4
62123337,8,2,2.0,10,0.2
62125264,2,6,2.0,8,0.25
62126463,1,28,1.0,29,0.034482758620689655
62150867,1,9,1.0,10,0.1
62153906,2,8,2.0,10,0.2
62156317,1,8,1.0,9,0.1111111111111111
62160086,9,17,9.0,26,0.34615384615384615
62163977,24,1,1.0,25,0.04
62172549,9,1,1.0,10,0.1
62172644,9,1,1.0,10,0.1
62185549,2,6,2.0,8,0.25
62185726,2,27,2.0,29,0.06896551724137931
62195185,1,7,1.0,8,0.125
62204658,1,9,1.0,10,0.1
62220248,1,18,1.0,19,0.05263157894736842
62264021,1,8,1.0,9,0.1111111111111111
62277793,6,4,4.0,10,0.4
62283299,4,4,4.0,8,0.5
62288308,7,3,3.0,10,0.3
62301825,2,8,2.0,10,0.2
62307547,1,7,1.0,8,0.125
62308681,1,9,1.0,10,0.1
62309968,1,18,1.0,19,0.05263157894736842
62330315,4,6,4.0,10,0.4
62331473,1,9,1.0,10,0.1
62332831,16,3,3.0,19,0.15789473684210525
62348131,1,7,1.0,8,0.125
62352695,3,6,3.0,9,0.3333333333333333
62369214,14,13,13.0,27,0.48148148148148145
62377409,2,7,2.0,9,0.2222222222222222
62380317,1,9,1.0,10,0.1
62393375,5,5,5.0,10,0.5
62394666,1,9,1.0,10,0.1
62420424,7,3,3.0,10,0.3
62432434,3,7,3.0,10,0.3
62443818,7,12,7.0,19,0.3684210526315789
62443819,4,14,4.0,18,0.2222222222222222
62448470,1,15,1.0,16,0.0625
62470864,2,7,2.0,9,0.2222222222222222
62478879,4,6,4.0,10,0.4
62494986,2,16,2.0,18,0.1111111111111111
62510443,1,9,1.0,10,0.1
62531882,1,8,1.0,9,0.1111111111111111
62532643,1,7,1.0,8,0.125
62533555,3,7,3.0,10,0.3
62533717,7,1,1.0,8,0.125
62541337,9,1,1.0,10,0.1
62560674,2,8,2.0,10,0.2
62582721,1,9,1.0,10,0.1
62591521,1,9,1.0,10,0.1
62600466,1,29,1.0,30,0.03333333333333333
62603587,2,28,2.0,30,0.06666666666666667
62604279,3,5,3.0,8,0.375
62621373,1,8,1.0,9,0.1111111111111111
62621901,4,6,4.0,10,0.4
62622240,1,9,1.0,10,0.1
62662740,1,9,1.0,10,0.1
62664961,2,8,2.0,10,0.2
62665266,3,7,3.0,10,0.3
62666192,2,8,2.0,10,0.2
62667543,1,8,1.0,9,0.1111111111111111
62669485,1,9,1.0,10,0.1
62681881,5,4,4.0,9,0.4444444444444444
62689945,2,8,2.0,10,0.2
62716425,1,9,1.0,10,0.1
62736258,6,4,4.0,10,0.4
62736380,2,16,2.0,18,0.1111111111111111
62738228,16,8,8.0,24,0.3333333333333333
62738734,2,8,2.0,10,0.2
62739690,2,7,2.0,9,0.2222222222222222
62755240,3,6,3.0,9,0.3333333333333333
62755814,2,8,2.0,10,0.2
62755931,1,18,1.0,19,0.05263157894736842
62756499,2,8,2.0,10,0.2
62758422,5,4,4.0,9,0.4444444444444444
62767831,18,12,12.0,30,0.4
62767905,1,9,1.0,10,0.1
62777286,1,9,1.0,10,0.1
62785327,2,8,2.0,10,0.2
62785554,17,12,12.0,29,0.41379310344827586
62788965,5,5,5.0,10,0.5
62800773,2,15,2.0,17,0.11764705882352941
62812866,4,6,4.0,10,0.4
62815786,4,5,4.0,9,0.4444444444444444
62820899,4,6,4.0,10,0.4
62823489,5,5,5.0,10,0.5
62837453,4,5,4.0,9,0.4444444444444444
62861512,1,27,1.0,28,0.03571428571428571
62868159,1,9,1.0,10,0.1
62880311,1,9,1.0,10,0.1
62884017,1,7,1.0,8,0.125
62901980,1,18,1.0,19,0.05263157894736842
62907351,7,3,3.0,10,0.3
62907760,2,8,2.0,10,0.2
62916095,1,9,1.0,10,0.1
62945259,6,2,2.0,8,0.25
62957254,1,19,1.0,20,0.05
62962068,1,9,1.0,10,0.1
62962594,4,25,4.0,29,0.13793103448275862
62971649,5,5,5.0,10,0.5
62984341,7,23,7.0,30,0.23333333333333334
62986902,1,19,1.0,20,0.05
62986913,2,7,2.0,9,0.2222222222222222
63031168,9,1,1.0,10,0.1
63031507,3,7,3.0,10,0.3
63036107,1,9,1.0,10,0.1
63038380,5,5,5.0,10,0.5
63066981,1,9,1.0,10,0.1
63070551,1,8,1.0,9,0.1111111111111111
63071399,1,18,1.0,19,0.05263157894736842
63072333,1,9,1.0,10,0.1
63082223,7,2,2.0,9,0.2222222222222222
63086330,2,7,2.0,9,0.2222222222222222
63086969,2,7,2.0,9,0.2222222222222222
63093859,1,8,1.0,9,0.1111111111111111
63095445,13,6,6.0,19,0.3157894736842105
63116039,1,9,1.0,10,0.1
63116823,1,18,1.0,19,0.05263157894736842
63134299,1,8,1.0,9,0.1111111111111111
63137070,1,8,1.0,9,0.1111111111111111
63137551,5,5,5.0,10,0.5
63156652,6,4,4.0,10,0.4
63161273,1,9,1.0,10,0.1
63167514,2,8,2.0,10,0.2
63172189,1,9,1.0,10,0.1
63176450,1,8,1.0,9,0.1111111111111111
63182948,1,9,1.0,10,0.1
63184142,4,6,4.0,10,0.4
63209028,1,9,1.0,10,0.1
63228449,8,2,2.0,10,0.2
63228848,1,26,1.0,27,0.037037037037037035
63230244,9,1,1.0,10,0.1
63235576,7,2,2.0,9,0.2222222222222222
63237041,2,8,2.0,10,0.2
63246167,1,18,1.0,19,0.05263157894736842
63252003,3,7,3.0,10,0.3
63264081,1,9,1.0,10,0.1
63266604,1,8,1.0,9,0.1111111111111111
63266765,1,18,1.0,19,0.05263157894736842
63268934,1,9,1.0,10,0.1
63275699,3,6,3.0,9,0.3333333333333333
63292559,5,14,5.0,19,0.2631578947368421
63301763,1,9,1.0,10,0.1
63305816,1,29,1.0,30,0.03333333333333333
63313701,1,18,1.0,19,0.05263157894736842
63315087,2,17,2.0,19,0.10526315789473684
63328362,6,10,6.0,16,0.375
63338954,2,7,2.0,9,0.2222222222222222
63340380,1,9,1.0,10,0.1
63341202,3,7,3.0,10,0.3
63341319,2,8,2.0,10,0.2
63342681,1,9,1.0,10,0.1
63343613,3,7,3.0,10,0.3
63347445,6,3,3.0,9,0.3333333333333333
63347890,8,20,8.0,28,0.2857142857142857
63348001,1,9,1.0,10,0.1
63348420,1,8,1.0,9,0.1111111111111111
63349055,1,9,1.0,10,0.1
63349373,4,4,4.0,8,0.5
63349907,1,8,1.0,9,0.1111111111111111
63350663,21,9,9.0,30,0.3
63356946,2,27,2.0,29,0.06896551724137931
63360205,1,8,1.0,9,0.1111111111111111
63377132,2,8,2.0,10,0.2
63380690,7,2,2.0,9,0.2222222222222222
63380781,2,8,2.0,10,0.2
63381594,1,9,1.0,10,0.1
63393036,1,9,1.0,10,0.1
63395195,10,9,9.0,19,0.47368421052631576
63396883,7,3,3.0,10,0.3
63396888,1,8,1.0,9,0.1111111111111111
63397000,3,6,3.0,9,0.3333333333333333
63397043,2,8,2.0,10,0.2
63398493,6,4,4.0,10,0.4
63402884,4,6,4.0,10,0.4
63403930,2,8,2.0,10,0.2
63404348,1,18,1.0,19,0.05263157894736842
63406243,2,8,2.0,10,0.2
63408971,2,7,2.0,9,0.2222222222222222
63411210,3,25,3.0,28,0.10714285714285714
63411427,3,5,3.0,8,0.375
63418454,7,3,3.0,10,0.3
63419982,3,7,3.0,10,0.3
63424011,1,9,1.0,10,0.1
63425146,4,6,4.0,10,0.4
63431624,3,7,3.0,10,0.3
63432497,2,7,2.0,9,0.2222222222222222
63433542,2,8,2.0,10,0.2
63434240,1,17,1.0,18,0.05555555555555555
63445041,2,7,2.0,9,0.2222222222222222
63445053,8,1,1.0,9,0.1111111111111111
63445372,2,17,2.0,19,0.10526315789473684
63454857,4,6,4.0,10,0.4
63469965,1,8,1.0,9,0.1111111111111111
63470478,1,9,1.0,10,0.1
63471855,2,8,2.0,10,0.2
63473545,3,7,3.0,10,0.3
63490819,2,7,2.0,9,0.2222222222222222
63497624,3,7,3.0,10,0.3
63502309,3,6,3.0,9,0.3333333333333333
63504174,2,8,2.0,10,0.2
63504786,1,8,1.0,9,0.1111111111111111
63517780,3,6,3.0,9,0.3333333333333333
63518313,2,8,2.0,10,0.2
63518929,3,7,3.0,10,0.3
63521276,6,12,6.0,18,0.3333333333333333
63522153,2,8,2.0,10,0.2
63523580,5,3,3.0,8,0.375
63525995,1,8,1.0,9,0.1111111111111111
63534980,1,19,1.0,20,0.05
63537398,5,5,5.0,10,0.5
63555180,1,18,1.0,19,0.05263157894736842
63571006,2,18,2.0,20,0.1
63571447,1,9,1.0,10,0.1
63589900,4,24,4.0,28,0.14285714285714285
63596264,6,2,2.0,8,0.25
63599509,1,9,1.0,10,0.1
63604026,1,9,1.0,10,0.1
63604094,1,19,1.0,20,0.05
63606285,1,9,1.0,10,0.1
63610708,1,19,1.0,20,0.05
63611011,9,1,1.0,10,0.1
63615528,1,9,1.0,10,0.1
63616021,2,6,2.0,8,0.25
63623048,2,8,2.0,10,0.2
63623618,3,7,3.0,10,0.3
63624163,2,8,2.0,10,0.2
63634617,1,9,1.0,10,0.1
63660954,1,8,1.0,9,0.1111111111111111
63673243,1,8,1.0,9,0.1111111111111111
63673605,6,3,3.0,9,0.3333333333333333
63673808,5,4,4.0,9,0.4444444444444444
63674199,6,2,2.0,8,0.25
63676596,1,8,1.0,9,0.1111111111111111
63684074,1,8,1.0,9,0.1111111111111111
63689527,1,9,1.0,10,0.1
63699391,4,6,4.0,10,0.4
63702515,2,8,2.0,10,0.2
63733400,6,4,4.0,10,0.4
63736821,3,7,3.0,10,0.3
63737376,2,8,2.0,10,0.2
63737665,8,1,1.0,9,0.1111111111111111
63738071,3,7,3.0,10,0.3
63751916,4,6,4.0,10,0.4
63773041,1,18,1.0,19,0.05263157894736842
63779108,1,17,1.0,18,0.05555555555555555
63789921,1,19,1.0,20,0.05
63793191,1,9,1.0,10,0.1
63798949,2,7,2.0,9,0.2222222222222222
63801128,4,16,4.0,20,0.2
63801772,6,4,4.0,10,0.4
63801980,2,7,2.0,9,0.2222222222222222
63802585,1,9,1.0,10,0.1
63810257,5,5,5.0,10,0.5
63811004,2,8,2.0,10,0.2
63812779,3,5,3.0,8,0.375
63813755,1,19,1.0,20,0.05
63820329,2,8,2.0,10,0.2
63838038,6,3,3.0,9,0.3333333333333333
63868949,2,8,2.0,10,0.2
63881453,7,3,3.0,10,0.3
63882639,1,9,1.0,10,0.1
63897093,6,2,2.0,8,0.25
63900311,2,7,2.0,9,0.2222222222222222
63905776,2,8,2.0,10,0.2
63910676,8,1,1.0,9,0.1111111111111111
63910813,3,7,3.0,10,0.3
63924146,4,4,4.0,8,0.5
63925069,1,8,1.0,9,0.1111111111111111
63926779,1,8,1.0,9,0.1111111111111111
63940229,1,17,1.0,18,0.05555555555555555
63940288,1,9,1.0,10,0.1
63948514,1,8,1.0,9,0.1111111111111111
63973182,3,6,3.0,9,0.3333333333333333
63976302,5,5,5.0,10,0.5
63977113,1,19,1.0,20,0.05
63977257,3,6,3.0,9,0.3333333333333333
64000441,4,5,4.0,9,0.4444444444444444
64005770,1,29,1.0,30,0.03333333333333333
64007146,1,19,1.0,20,0.05
64012911,2,7,2.0,9,0.2222222222222222
64017752,1,9,1.0,10,0.1
64018000,1,18,1.0,19,0.05263157894736842
64019781,1,19,1.0,20,0.05
64025268,1,9,1.0,10,0.1
64025388,1,9,1.0,10,0.1
64027069,1,18,1.0,19,0.05263157894736842
64033466,8,1,1.0,9,0.1111111111111111
64033807,2,7,2.0,9,0.2222222222222222
64034218,9,1,1.0,10,0.1
64034654,7,1,1.0,8,0.125
64035267,6,3,3.0,9,0.3333333333333333
64035385,1,8,1.0,9,0.1111111111111111
64035949,5,15,5.0,20,0.25
64036141,1,7,1.0,8,0.125
64043278,5,5,5.0,10,0.5
64053943,2,18,2.0,20,0.1
64065213,9,1,1.0,10,0.1
64065637,21,9,9.0,30,0.3
64078602,1,8,1.0,9,0.1111111111111111
64082919,3,16,3.0,19,0.15789473684210525
64086947,2,6,2.0,8,0.25
64090471,2,8,2.0,10,0.2
64090658,7,1,1.0,8,0.125
64090888,2,6,2.0,8,0.25
64104331,1,9,1.0,10,0.1
64106278,1,9,1.0,10,0.1
64107011,3,7,3.0,10,0.3
64117951,1,9,1.0,10,0.1
64120618,3,7,3.0,10,0.3
64125166,5,24,5.0,29,0.1724137931034483
64131340,1,9,1.0,10,0.1
64133873,5,15,5.0,20,0.25
64138401,2,8,2.0,10,0.2
64139103,1,8,1.0,9,0.1111111111111111
64143399,2,8,2.0,10,0.2
64150057,2,8,2.0,10,0.2
64177820,1,9,1.0,10,0.1
64185478,8,2,2.0,10,0.2
64185586,1,19,1.0,20,0.05
64200647,1,9,1.0,10,0.1
64211197,1,17,1.0,18,0.05555555555555555
64211369,1,8,1.0,9,0.1111111111111111
64211804,1,8,1.0,9,0.1111111111111111
64213071,3,6,3.0,9,0.3333333333333333
64227824,7,19,7.0,26,0.2692307692307692
64228659,4,4,4.0,8,0.5
64229858,4,4,4.0,8,0.5
64232042,5,4,4.0,9,0.4444444444444444
64233385,1,9,1.0,10,0.1
64236120,17,12,12.0,29,0.41379310344827586
64247446,7,3,3.0,10,0.3
64248022,2,8,2.0,10,0.2
64248109,7,20,7.0,27,0.25925925925925924
64257342,1,9,1.0,10,0.1
64259974,5,5,5.0,10,0.5
64263820,2,6,2.0,8,0.25
64271331,1,18,1.0,19,0.05263157894736842
64279424,1,8,1.0,9,0.1111111111111111
64282559,1,8,1.0,9,0.1111111111111111
64288805,2,25,2.0,27,0.07407407407407407
64289274,5,5,5.0,10,0.5
64302597,1,8,1.0,9,0.1111111111111111
64306044,1,9,1.0,10,0.1
64312224,5,4,4.0,9,0.4444444444444444
64312516,9,1,1.0,10,0.1
64313003,4,6,4.0,10,0.4
64313316,1,19,1.0,20,0.05
64318792,8,2,2.0,10,0.2
64324841,6,21,6.0,27,0.2222222222222222
64325255,2,8,2.0,10,0.2
64326161,2,8,2.0,10,0.2
64326413,2,8,2.0,10,0.2
64326752,2,8,2.0,10,0.2
64328885,9,1,1.0,10,0.1
64334352,2,8,2.0,10,0.2
64335505,3,7,3.0,10,0.3
64341030,8,2,2.0,10,0.2
64341238,1,9,1.0,10,0.1
64342723,4,6,4.0,10,0.4
64344920,3,7,3.0,10,0.3
64355396,3,16,3.0,19,0.15789473684210525
64355942,9,1,1.0,10,0.1
64381212,3,5,3.0,8,0.375
64381358,7,3,3.0,10,0.3
64382584,4,6,4.0,10,0.4
64386265,5,4,4.0,9,0.4444444444444444
64399823,3,6,3.0,9,0.3333333333333333
64407232,3,7,3.0,10,0.3
64410815,9,1,1.0,10,0.1
64410880,2,8,2.0,10,0.2
64421596,2,8,2.0,10,0.2
64424348,1,9,1.0,10,0.1
64429408,2,7,2.0,9,0.2222222222222222
64432044,1,8,1.0,9,0.1111111111111111
64452444,1,18,1.0,19,0.05263157894736842
64473707,2,16,2.0,18,0.1111111111111111
64474954,1,18,1.0,19,0.05263157894736842
64477268,5,5,5.0,10,0.5
64477915,3,17,3.0,20,0.15
64483175,3,7,3.0,10,0.3
64490768,1,9,1.0,10,0.1
64495949,5,12,5.0,17,0.29411764705882354
64496365,1,9,1.0,10,0.1
64499142,1,9,1.0,10,0.1
64502351,7,3,3.0,10,0.3
64503029,4,6,4.0,10,0.4
64503783,1,8,1.0,9,0.1111111111111111
64505094,2,8,2.0,10,0.2
64509578,1,8,1.0,9,0.1111111111111111
64509842,7,3,3.0,10,0.3
64518026,5,5,5.0,10,0.5
64518056,6,3,3.0,9,0.3333333333333333
64523045,2,8,2.0,10,0.2
64528023,1,17,1.0,18,0.05555555555555555
64531469,1,9,1.0,10,0.1
64532576,1,9,1.0,10,0.1
64538835,2,17,2.0,19,0.10526315789473684
64544148,1,18,1.0,19,0.05263157894736842
64546130,1,8,1.0,9,0.1111111111111111
64550147,1,26,1.0,27,0.037037037037037035
64551402,3,26,3.0,29,0.10344827586206896
64570705,3,6,3.0,9,0.3333333333333333
64571918,9,1,1.0,10,0.1
64573371,16,13,13.0,29,0.4482758620689655
64575056,7,3,3.0,10,0.3
64576828,2,8,2.0,10,0.2
64577146,8,1,1.0,9,0.1111111111111111
64577700,9,1,1.0,10,0.1
64602027,6,3,3.0,9,0.3333333333333333
64602274,1,8,1.0,9,0.1111111111111111
64605935,5,5,5.0,10,0.5
64608512,4,6,4.0,10,0.4
64628845,3,6,3.0,9,0.3333333333333333
64646064,1,18,1.0,19,0.05263157894736842
64669243,1,9,1.0,10,0.1
64669673,5,4,4.0,9,0.4444444444444444
64679181,1,8,1.0,9,0.1111111111111111
64679839,4,5,4.0,9,0.4444444444444444
64681307,7,2,2.0,9,0.2222222222222222
64681585,3,7,3.0,10,0.3
64681886,3,15,3.0,18,0.16666666666666666
64683404,1,9,1.0,10,0.1
64684082,3,6,3.0,9,0.3333333333333333
64712423,3,7,3.0,10,0.3
64713260,1,9,1.0,10,0.1
64717292,7,2,2.0,9,0.2222222222222222
64735612,1,8,1.0,9,0.1111111111111111
64736797,8,2,2.0,10,0.2
64739958,8,2,2.0,10,0.2
64746459,1,8,1.0,9,0.1111111111111111
64754639,3,15,3.0,18,0.16666666666666666
64767845,4,13,4.0,17,0.23529411764705882
64783722,2,7,2.0,9,0.2222222222222222
64786792,7,2,2.0,9,0.2222222222222222
64787333,2,7,2.0,9,0.2222222222222222
64803442,1,9,1.0,10,0.1
64807069,2,8,2.0,10,0.2
64816403,1,8,1.0,9,0.1111111111111111
64817118,3,6,3.0,9,0.3333333333333333
64818687,3,7,3.0,10,0.3
64841038,2,8,2.0,10,0.2
64846797,1,7,1.0,8,0.125
64850022,1,8,1.0,9,0.1111111111111111
64850410,2,18,2.0,20,0.1
64858691,5,23,5.0,28,0.17857142857142858
64859220,8,2,2.0,10,0.2
64860905,6,4,4.0,10,0.4
64868259,1,8,1.0,9,0.1111111111111111
64868586,15,13,13.0,28,0.4642857142857143
64875023,7,3,3.0,10,0.3
64875220,1,8,1.0,9,0.1111111111111111
64875360,1,9,1.0,10,0.1
64882119,2,8,2.0,10,0.2
64882475,3,7,3.0,10,0.3
64886948,3,7,3.0,10,0.3
64908711,1,9,1.0,10,0.1
64914268,5,15,5.0,20,0.25
64916751,4,6,4.0,10,0.4
64918424,5,12,5.0,17,0.29411764705882354
64919203,2,8,2.0,10,0.2
64935971,5,3,3.0,8,0.375
64936096,26,2,2.0,28,0.07142857142857142
64937195,6,3,3.0,9,0.3333333333333333
64940615,6,4,4.0,10,0.4
64940765,3,5,3.0,8,0.375
64946334,3,7,3.0,10,0.3
64946617,6,2,2.0,8,0.25
64947981,9,1,1.0,10,0.1
64948112,2,28,2.0,30,0.06666666666666667
64952190,4,14,4.0,18,0.2222222222222222
64953226,1,9,1.0,10,0.1
64953943,1,8,1.0,9,0.1111111111111111
64955356,9,19,9.0,28,0.32142857142857145
64956357,2,8,2.0,10,0.2
64956717,1,8,1.0,9,0.1111111111111111
64957112,1,8,1.0,9,0.1111111111111111
64958445,5,5,5.0,10,0.5
64959025,4,5,4.0,9,0.4444444444444444
64960437,1,29,1.0,30,0.03333333333333333
64961576,3,7,3.0,10,0.3
64962242,4,6,4.0,10,0.4
64962553,8,2,2.0,10,0.2
64963167,7,2,2.0,9,0.2222222222222222
64963341,6,3,3.0,9,0.3333333333333333
64963532,1,9,1.0,10,0.1
64970119,3,7,3.0,10,0.3
64973420,1,9,1.0,10,0.1
64980291,1,9,1.0,10,0.1
64995117,1,19,1.0,20,0.05
64996328,1,8,1.0,9,0.1111111111111111
65015241,4,5,4.0,9,0.4444444444444444
65022606,3,7,3.0,10,0.3
65052490,1,19,1.0,20,0.05
65067534,1,8,1.0,9,0.1111111111111111
65067910,1,8,1.0,9,0.1111111111111111
65103863,3,7,3.0,10,0.3
65116457,8,2,2.0,10,0.2
65116641,3,7,3.0,10,0.3
65117191,4,6,4.0,10,0.4
65124334,1,9,1.0,10,0.1
65136104,5,4,4.0,9,0.4444444444444444
65141443,7,3,3.0,10,0.3
65143574,1,9,1.0,10,0.1
65144751,2,18,2.0,20,0.1
65145927,3,7,3.0,10,0.3
65168087,1,8,1.0,9,0.1111111111111111
65171487,2,7,2.0,9,0.2222222222222222
65174197,8,12,8.0,20,0.4
65184537,2,8,2.0,10,0.2
65184820,4,6,4.0,10,0.4
65191806,1,17,1.0,18,0.05555555555555555
65197192,2,8,2.0,10,0.2
65205248,6,3,3.0,9,0.3333333333333333
65205310,3,7,3.0,10,0.3
65206830,1,19,1.0,20,0.05
65214696,2,6,2.0,8,0.25
65220714,4,5,4.0,9,0.4444444444444444
65226446,1,18,1.0,19,0.05263157894736842
65230811,9,20,9.0,29,0.3103448275862069
65237840,5,5,5.0,10,0.5
65243965,2,8,2.0,10,0.2
65244604,6,3,3.0,9,0.3333333333333333
65244710,3,7,3.0,10,0.3
65259751,4,5,4.0,9,0.4444444444444444
65277443,4,13,4.0,17,0.23529411764705882
65278025,5,5,5.0,10,0.5
65278232,1,8,1.0,9,0.1111111111111111
65279106,4,6,4.0,10,0.4
65284123,3,7,3.0,10,0.3
65290998,1,9,1.0,10,0.1
65291100,1,9,1.0,10,0.1
65293580,2,7,2.0,9,0.2222222222222222
65295119,3,6,3.0,9,0.3333333333333333
65309750,3,7,3.0,10,0.3
65312953,7,3,3.0,10,0.3
65313721,5,3,3.0,8,0.375
65313985,3,7,3.0,10,0.3
65318338,16,4,4.0,20,0.2
65327142,3,6,3.0,9,0.3333333333333333
65328499,9,1,1.0,10,0.1
65328737,3,7,3.0,10,0.3
65332784,2,7,2.0,9,0.2222222222222222
65333356,2,7,2.0,9,0.2222222222222222
65336531,7,2,2.0,9,0.2222222222222222
65336848,1,9,1.0,10,0.1
65336901,5,5,5.0,10,0.5
65337116,6,4,4.0,10,0.4
65343364,4,6,4.0,10,0.4
65345449,1,9,1.0,10,0.1
65345647,2,8,2.0,10,0.2
65347818,4,25,4.0,29,0.13793103448275862
65348542,14,6,6.0,20,0.3
65350376,1,8,1.0,9,0.1111111111111111
65351931,2,8,2.0,10,0.2
65352013,1,9,1.0,10,0.1
65352291,3,7,3.0,10,0.3
65361660,5,5,5.0,10,0.5
65365746,2,8,2.0,10,0.2
65377282,1,8,1.0,9,0.1111111111111111
65378752,3,7,3.0,10,0.3
65383875,4,6,4.0,10,0.4
65387190,4,6,4.0,10,0.4
65404452,4,6,4.0,10,0.4
65405389,3,7,3.0,10,0.3
65405586,2,8,2.0,10,0.2
65409623,2,8,2.0,10,0.2
65411773,2,28,2.0,30,0.06666666666666667
65415796,1,9,1.0,10,0.1
65423927,1,18,1.0,19,0.05263157894736842
65429415,1,9,1.0,10,0.1
65431616,2,8,2.0,10,0.2
65439104,3,7,3.0,10,0.3
65439513,8,2,2.0,10,0.2
65441274,2,7,2.0,9,0.2222222222222222
65444234,6,24,6.0,30,0.2
65448277,1,9,1.0,10,0.1
65456308,1,8,1.0,9,0.1111111111111111
65460473,1,7,1.0,8,0.125
65460646,1,8,1.0,9,0.1111111111111111
65463046,23,6,6.0,29,0.20689655172413793
65464049,6,3,3.0,9,0.3333333333333333
65467502,6,3,3.0,9,0.3333333333333333
65471177,1,9,1.0,10,0.1
65471440,15,4,4.0,19,0.21052631578947367
65471729,1,9,1.0,10,0.1
65472576,1,9,1.0,10,0.1
65473374,8,1,1.0,9,0.1111111111111111
65478229,2,8,2.0,10,0.2
65479660,2,8,2.0,10,0.2
65487118,1,8,1.0,9,0.1111111111111111
65488216,5,24,5.0,29,0.1724137931034483
65493210,8,2,2.0,10,0.2
65496188,1,7,1.0,8,0.125
65497147,1,8,1.0,9,0.1111111111111111
65497792,3,7,3.0,10,0.3
65503777,1,9,1.0,10,0.1
65510573,6,22,6.0,28,0.21428571428571427
65512892,1,9,1.0,10,0.1
65516256,1,19,1.0,20,0.05
65518772,1,8,1.0,9,0.1111111111111111
65529489,1,8,1.0,9,0.1111111111111111
65554924,1,9,1.0,10,0.1
65555106,2,8,2.0,10,0.2
65556214,1,8,1.0,9,0.1111111111111111
65558930,2,8,2.0,10,0.2
65559638,1,8,1.0,9,0.1111111111111111
65565474,7,3,3.0,10,0.3
65575328,2,7,2.0,9,0.2222222222222222
65589791,1,9,1.0,10,0.1
65590622,2,7,2.0,9,0.2222222222222222
65593791,10,18,10.0,28,0.35714285714285715
65595972,2,8,2.0,10,0.2
65597131,2,8,2.0,10,0.2
65597318,5,5,5.0,10,0.5
65598226,11,17,11.0,28,0.39285714285714285
65598775,2,6,2.0,8,0.25
65599644,23,7,7.0,30,0.23333333333333334
65603720,4,6,4.0,10,0.4
65619477,3,7,3.0,10,0.3
65622187,2,8,2.0,10,0.2
65627797,6,3,3.0,9,0.3333333333333333
65630382,2,17,2.0,19,0.10526315789473684
65630386,1,8,1.0,9,0.1111111111111111
65637741,3,7,3.0,10,0.3
65637973,3,6,3.0,9,0.3333333333333333
65641019,2,8,2.0,10,0.2
65643388,18,2,2.0,20,0.1
65644388,3,7,3.0,10,0.3
65646679,1,8,1.0,9,0.1111111111111111
65647345,7,3,3.0,10,0.3
65648873,1,19,1.0,20,0.05
65659427,3,7,3.0,10,0.3
65660894,1,9,1.0,10,0.1
65661837,2,8,2.0,10,0.2
65663556,9,1,1.0,10,0.1
65664787,8,1,1.0,9,0.1111111111111111
65667032,4,6,4.0,10,0.4
65667601,2,8,2.0,10,0.2
65668792,6,3,3.0,9,0.3333333333333333
65671075,1,7,1.0,8,0.125
65671385,2,8,2.0,10,0.2
65673564,8,1,1.0,9,0.1111111111111111
65673768,1,8,1.0,9,0.1111111111111111
65674532,3,23,3.0,26,0.11538461538461539
65674664,1,8,1.0,9,0.1111111111111111
65675550,4,6,4.0,10,0.4
65676371,1,9,1.0,10,0.1
65678006,4,5,4.0,9,0.4444444444444444
65679807,7,3,3.0,10,0.3
65695087,4,5,4.0,9,0.4444444444444444
65696880,1,9,1.0,10,0.1
65701018,1,7,1.0,8,0.125
65703850,6,3,3.0,9,0.3333333333333333
65703865,4,6,4.0,10,0.4
65703950,6,3,3.0,9,0.3333333333333333
65705828,2,8,2.0,10,0.2
65711951,10,9,9.0,19,0.47368421052631576
65739381,2,8,2.0,10,0.2
65759667,1,9,1.0,10,0.1
65761048,1,9,1.0,10,0.1
65770335,8,2,2.0,10,0.2
65770909,9,1,1.0,10,0.1
65772274,3,6,3.0,9,0.3333333333333333
65773207,2,8,2.0,10,0.2
65776189,2,16,2.0,18,0.1111111111111111
65779044,1,9,1.0,10,0.1
65787491,1,9,1.0,10,0.1
65789543,3,6,3.0,9,0.3333333333333333
65789800,3,7,3.0,10,0.3
65793639,9,1,1.0,10,0.1
65802696,9,1,1.0,10,0.1
65803078,3,6,3.0,9,0.3333333333333333
65804601,4,6,4.0,10,0.4
65813641,2,8,2.0,10,0.2
65817586,1,8,1.0,9,0.1111111111111111
65843110,2,8,2.0,10,0.2
65844882,7,1,1.0,8,0.125
65849139,6,3,3.0,9,0.3333333333333333
65870719,4,6,4.0,10,0.4
65873736,1,9,1.0,10,0.1
65874437,1,8,1.0,9,0.1111111111111111
65874617,2,8,2.0,10,0.2
65874814,2,8,2.0,10,0.2
65880214,2,18,2.0,20,0.1
65898543,1,9,1.0,10,0.1
65899155,1,9,1.0,10,0.1
65901122,3,6,3.0,9,0.3333333333333333
65901397,5,5,5.0,10,0.5
65907451,1,9,1.0,10,0.1
65907840,2,7,2.0,9,0.2222222222222222
65915949,2,27,2.0,29,0.06896551724137931
65927487,11,17,11.0,28,0.39285714285714285
65948841,1,9,1.0,10,0.1
65950662,4,5,4.0,9,0.4444444444444444
65953224,1,9,1.0,10,0.1
65956282,1,7,1.0,8,0.125
65965614,1,8,1.0,9,0.1111111111111111
65971574,1,9,1.0,10,0.1
65971951,3,7,3.0,10,0.3
65978639,1,18,1.0,19,0.05263157894736842
65980642,2,8,2.0,10,0.2
65983222,1,8,1.0,9,0.1111111111111111
65983750,1,9,1.0,10,0.1
65987753,1,9,1.0,10,0.1
65996931,2,8,2.0,10,0.2
66003450,1,8,1.0,9,0.1111111111111111
66011649,1,17,1.0,18,0.05555555555555555
66014178,2,15,2.0,17,0.11764705882352941
66026633,8,2,2.0,10,0.2
66027548,8,1,1.0,9,0.1111111111111111
66034741,6,13,6.0,19,0.3157894736842105
66036614,3,7,3.0,10,0.3
66037207,2,16,2.0,18,0.1111111111111111
66041978,3,16,3.0,19,0.15789473684210525
66048656,1,7,1.0,8,0.125
66049199,2,8,2.0,10,0.2
66068638,1,8,1.0,9,0.1111111111111111
66069963,1,9,1.0,10,0.1
66070309,6,3,3.0,9,0.3333333333333333
66071243,1,9,1.0,10,0.1
66071651,4,4,4.0,8,0.5
66073560,1,9,1.0,10,0.1
66074439,2,7,2.0,9,0.2222222222222222
66086631,2,18,2.0,20,0.1
66089585,4,6,4.0,10,0.4
66096161,1,8,1.0,9,0.1111111111111111
66111982,1,8,1.0,9,0.1111111111111111
66118805,1,9,1.0,10,0.1
66118959,4,5,4.0,9,0.4444444444444444
66123529,3,15,3.0,18,0.16666666666666666
66126148,6,3,3.0,9,0.3333333333333333
66127337,4,6,4.0,10,0.4
66145573,2,16,2.0,18,0.1111111111111111
66146164,1,19,1.0,20,0.05
66158582,1,9,1.0,10,0.1
66168277,8,1,1.0,9,0.1111111111111111
66180840,4,6,4.0,10,0.4
66182897,2,8,2.0,10,0.2
66194490,1,9,1.0,10,0.1
66206317,2,8,2.0,10,0.2
66217712,2,7,2.0,9,0.2222222222222222
66217809,5,4,4.0,9,0.4444444444444444
66245358,2,8,2.0,10,0.2
66247554,1,8,1.0,9,0.1111111111111111
66249854,7,2,2.0,9,0.2222222222222222
66251386,1,8,1.0,9,0.1111111111111111
66254474,3,15,3.0,18,0.16666666666666666
66264363,6,4,4.0,10,0.4
66264845,1,8,1.0,9,0.1111111111111111
66328298,2,8,2.0,10,0.2
66349825,2,7,2.0,9,0.2222222222222222
66354378,5,15,5.0,20,0.25
66357526,1,27,1.0,28,0.03571428571428571
66372790,10,17,10.0,27,0.37037037037037035
66373780,2,8,2.0,10,0.2
66380541,7,3,3.0,10,0.3
66388923,1,8,1.0,9,0.1111111111111111
66393140,1,9,1.0,10,0.1
66394277,7,3,3.0,10,0.3
66402009,3,5,3.0,8,0.375
66402435,2,7,2.0,9,0.2222222222222222
66415716,3,15,3.0,18,0.16666666666666666
66419628,7,3,3.0,10,0.3
66420653,7,3,3.0,10,0.3
66421095,3,7,3.0,10,0.3
66421477,2,8,2.0,10,0.2
66425963,1,9,1.0,10,0.1
66427729,3,6,3.0,9,0.3333333333333333
66442105,9,1,1.0,10,0.1
66453947,3,7,3.0,10,0.3
66455937,1,8,1.0,9,0.1111111111111111
66457021,5,3,3.0,8,0.375
66461318,1,9,1.0,10,0.1
66467113,1,8,1.0,9,0.1111111111111111
66475388,8,2,2.0,10,0.2
66476079,9,1,1.0,10,0.1
66476226,5,5,5.0,10,0.5
66477179,9,1,1.0,10,0.1
66477559,7,3,3.0,10,0.3
66496308,2,8,2.0,10,0.2
66516772,2,7,2.0,9,0.2222222222222222
66532768,5,3,3.0,8,0.375
66537774,4,6,4.0,10,0.4
66539331,1,8,1.0,9,0.1111111111111111
66539654,1,9,1.0,10,0.1
66539697,2,8,2.0,10,0.2
66544684,3,7,3.0,10,0.3
66546887,1,18,1.0,19,0.05263157894736842
66549360,3,7,3.0,10,0.3
66549561,1,8,1.0,9,0.1111111111111111
66553086,1,16,1.0,17,0.058823529411764705
66554326,2,7,2.0,9,0.2222222222222222
66574615,8,17,8.0,25,0.32
66574882,3,7,3.0,10,0.3
66575394,9,1,1.0,10,0.1
66576195,29,1,1.0,30,0.03333333333333333
66578889,1,18,1.0,19,0.05263157894736842
66585077,14,5,5.0,19,0.2631578947368421
66596222,1,19,1.0,20,0.05
66601228,6,3,3.0,9,0.3333333333333333
66622340,16,12,12.0,28,0.42857142857142855
66623739,3,7,3.0,10,0.3
66630143,2,18,2.0,20,0.1
66640155,1,9,1.0,10,0.1
66658479,1,18,1.0,19,0.05263157894736842
66659114,2,7,2.0,9,0.2222222222222222
66677395,27,2,2.0,29,0.06896551724137931
66677715,8,1,1.0,9,0.1111111111111111
66678692,7,1,1.0,8,0.125
66720750,1,9,1.0,10,0.1
66732312,1,9,1.0,10,0.1
66755759,3,7,3.0,10,0.3
66760756,1,19,1.0,20,0.05
66780299,10,18,10.0,28,0.35714285714285715
66788455,8,2,2.0,10,0.2
66792222,2,17,2.0,19,0.10526315789473684
66793495,1,9,1.0,10,0.1
66803190,1,19,1.0,20,0.05
66814911,6,22,6.0,28,0.21428571428571427
66828177,3,6,3.0,9,0.3333333333333333
66828868,1,9,1.0,10,0.1
66841245,3,7,3.0,10,0.3
66842703,20,7,7.0,27,0.25925925925925924
66844152,8,2,2.0,10,0.2
66867275,1,9,1.0,10,0.1
66870513,1,7,1.0,8,0.125
66878263,1,8,1.0,9,0.1111111111111111
66883307,1,9,1.0,10,0.1
66890100,2,8,2.0,10,0.2
66890255,8,1,1.0,9,0.1111111111111111
66890666,1,9,1.0,10,0.1
66891253,1,9,1.0,10,0.1
66893730,23,4,4.0,27,0.14814814814814814
66899403,4,4,4.0,8,0.5
66899944,1,9,1.0,10,0.1
66905481,7,3,3.0,10,0.3
66905687,1,17,1.0,18,0.05555555555555555
66905756,3,7,3.0,10,0.3
66927319,7,21,7.0,28,0.25
66928535,5,4,4.0,9,0.4444444444444444
66929605,6,4,4.0,10,0.4
66934750,4,4,4.0,8,0.5
66965801,2,8,2.0,10,0.2
66967291,1,8,1.0,9,0.1111111111111111
66988746,1,9,1.0,10,0.1
66997006,4,15,4.0,19,0.21052631578947367
67048561,5,24,5.0,29,0.1724137931034483
67055344,2,8,2.0,10,0.2
67060348,2,27,2.0,29,0.06896551724137931
67062264,1,8,1.0,9,0.1111111111111111
67063181,1,8,1.0,9,0.1111111111111111
67064123,7,2,2.0,9,0.2222222222222222
67064496,4,6,4.0,10,0.4
67065368,7,3,3.0,10,0.3
67066594,8,2,2.0,10,0.2
67070613,2,18,2.0,20,0.1
67071305,2,7,2.0,9,0.2222222222222222
67072495,2,8,2.0,10,0.2
67076084,6,4,4.0,10,0.4
67084221,1,9,1.0,10,0.1
67084641,19,9,9.0,28,0.32142857142857145
67085006,1,8,1.0,9,0.1111111111111111
67087653,6,4,4.0,10,0.4
67088734,3,16,3.0,19,0.15789473684210525
67095227,1,26,1.0,27,0.037037037037037035
67114287,3,6,3.0,9,0.3333333333333333
67117603,7,2,2.0,9,0.2222222222222222
67137514,6,4,4.0,10,0.4
67148793,5,5,5.0,10,0.5
67151175,26,2,2.0,28,0.07142857142857142
67162718,3,7,3.0,10,0.3
67165401,8,1,1.0,9,0.1111111111111111
67165699,4,6,4.0,10,0.4
67166420,8,2,2.0,10,0.2
67167374,1,9,1.0,10,0.1
67167519,1,8,1.0,9,0.1111111111111111
67178299,8,1,1.0,9,0.1111111111111111
67199784,7,13,7.0,20,0.35
67201193,1,9,1.0,10,0.1
67201839,8,2,2.0,10,0.2
67222627,8,2,2.0,10,0.2
67225752,1,9,1.0,10,0.1
67228255,2,8,2.0,10,0.2
67228427,1,9,1.0,10,0.1
67251456,4,4,4.0,8,0.5
67260759,1,9,1.0,10,0.1
67268418,3,6,3.0,9,0.3333333333333333
67268943,1,9,1.0,10,0.1
67275491,1,8,1.0,9,0.1111111111111111
67317960,1,19,1.0,20,0.05
67329929,1,9,1.0,10,0.1
67343994,2,18,2.0,20,0.1
67372438,2,8,2.0,10,0.2
67374437,7,1,1.0,8,0.125
67375555,6,3,3.0,9,0.3333333333333333
67375787,1,17,1.0,18,0.05555555555555555
67376803,4,5,4.0,9,0.4444444444444444
67377189,1,8,1.0,9,0.1111111111111111
67377283,2,6,2.0,8,0.25
67378185,9,1,1.0,10,0.1
67380384,8,1,1.0,9,0.1111111111111111
67387555,1,9,1.0,10,0.1
67393352,3,15,3.0,18,0.16666666666666666
67420253,5,5,5.0,10,0.5
67424961,1,9,1.0,10,0.1
67426216,2,7,2.0,9,0.2222222222222222
67426917,3,7,3.0,10,0.3
67428413,2,6,2.0,8,0.25
67428844,3,7,3.0,10,0.3
67430118,1,8,1.0,9,0.1111111111111111
67437852,3,6,3.0,9,0.3333333333333333
67447310,2,7,2.0,9,0.2222222222222222
67448609,2,8,2.0,10,0.2
67461284,2,7,2.0,9,0.2222222222222222
67476740,8,1,1.0,9,0.1111111111111111
67477170,2,8,2.0,10,0.2
67477890,8,11,8.0,19,0.42105263157894735
67479424,3,7,3.0,10,0.3
67482645,2,6,2.0,8,0.25
67496107,29,1,1.0,30,0.03333333333333333
67496423,8,1,1.0,9,0.1111111111111111
67504468,6,3,3.0,9,0.3333333333333333
67505768,5,5,5.0,10,0.5
67512712,1,9,1.0,10,0.1
67516473,3,26,3.0,29,0.10344827586206896
67519254,7,2,2.0,9,0.2222222222222222
67521814,4,6,4.0,10,0.4
67529582,2,8,2.0,10,0.2
67547438,1,8,1.0,9,0.1111111111111111
67549570,2,8,2.0,10,0.2
67552729,1,9,1.0,10,0.1
67552996,1,8,1.0,9,0.1111111111111111
67564153,1,9,1.0,10,0.1
67565235,2,8,2.0,10,0.2
67643764,4,6,4.0,10,0.4
67643799,1,8,1.0,9,0.1111111111111111
67661218,1,18,1.0,19,0.05263157894736842
67668946,6,4,4.0,10,0.4
67676564,5,4,4.0,9,0.4444444444444444
67697233,8,11,8.0,19,0.42105263157894735
67698698,7,2,2.0,9,0.2222222222222222
67699515,2,6,2.0,8,0.25
67699737,27,3,3.0,30,0.1
67700231,7,3,3.0,10,0.3
67708115,1,9,1.0,10,0.1
67718637,6,3,3.0,9,0.3333333333333333
67721126,8,1,1.0,9,0.1111111111111111
67722412,8,2,2.0,10,0.2
67723337,1,18,1.0,19,0.05263157894736842
67726771,1,8,1.0,9,0.1111111111111111
67728211,5,4,4.0,9,0.4444444444444444
67730098,10,20,10.0,30,0.3333333333333333
67742628,23,3,3.0,26,0.11538461538461539
67747484,7,2,2.0,9,0.2222222222222222
67758806,9,1,1.0,10,0.1
67760620,7,2,2.0,9,0.2222222222222222
67762415,4,6,4.0,10,0.4
67762531,5,3,3.0,8,0.375
67763075,2,6,2.0,8,0.25
67763681,3,6,3.0,9,0.3333333333333333
67764452,4,6,4.0,10,0.4
67785650,1,9,1.0,10,0.1
67785784,1,7,1.0,8,0.125
67788858,2,8,2.0,10,0.2
67794688,1,19,1.0,20,0.05
67798658,1,9,1.0,10,0.1
67799462,1,8,1.0,9,0.1111111111111111
67799587,1,19,1.0,20,0.05
67801573,1,8,1.0,9,0.1111111111111111
67804670,5,4,4.0,9,0.4444444444444444
67805204,1,9,1.0,10,0.1
67805457,5,5,5.0,10,0.5
67806013,3,7,3.0,10,0.3
67806300,6,4,4.0,10,0.4
67807043,8,2,2.0,10,0.2
67807346,6,3,3.0,9,0.3333333333333333
67807474,8,1,1.0,9,0.1111111111111111
67807611,7,3,3.0,10,0.3
67807772,7,3,3.0,10,0.3
67808127,8,1,1.0,9,0.1111111111111111
67809875,2,7,2.0,9,0.2222222222222222
67810449,17,13,13.0,30,0.43333333333333335
67810595,3,6,3.0,9,0.3333333333333333
67830034,2,8,2.0,10,0.2
67836331,8,2,2.0,10,0.2
67839615,1,19,1.0,20,0.05
67842644,2,7,2.0,9,0.2222222222222222
67863890,1,17,1.0,18,0.05555555555555555
67869407,3,7,3.0,10,0.3
67880004,2,8,2.0,10,0.2
67882915,2,8,2.0,10,0.2
67883059,4,6,4.0,10,0.4
67889785,3,23,3.0,26,0.11538461538461539
67890201,1,8,1.0,9,0.1111111111111111
67901137,8,1,1.0,9,0.1111111111111111
67901315,2,7,2.0,9,0.2222222222222222
67904373,23,7,7.0,30,0.23333333333333334
67913335,3,7,3.0,10,0.3
67916726,5,4,4.0,9,0.4444444444444444
67917015,18,9,9.0,27,0.3333333333333333
67917088,1,8,1.0,9,0.1111111111111111
67917904,7,2,2.0,9,0.2222222222222222
67919565,3,5,3.0,8,0.375
67919620,1,9,1.0,10,0.1
67923036,4,5,4.0,9,0.4444444444444444
67942379,7,3,3.0,10,0.3
67950017,6,4,4.0,10,0.4
67950386,1,9,1.0,10,0.1
67953271,1,9,1.0,10,0.1
67954470,4,14,4.0,18,0.2222222222222222
67959619,6,4,4.0,10,0.4
67964804,3,7,3.0,10,0.3
67979069,1,9,1.0,10,0.1
67997986,5,15,5.0,20,0.25
68009575,2,17,2.0,19,0.10526315789473684
68013063,1,19,1.0,20,0.05
68036749,1,9,1.0,10,0.1
68055977,1,8,1.0,9,0.1111111111111111
68057052,1,7,1.0,8,0.125
68081661,1,9,1.0,10,0.1
68092791,1,9,1.0,10,0.1
68104742,2,17,2.0,19,0.10526315789473684
68105609,4,6,4.0,10,0.4
68109872,1,9,1.0,10,0.1
68112463,6,3,3.0,9,0.3333333333333333
68123152,4,5,4.0,9,0.4444444444444444
68124626,2,18,2.0,20,0.1
68129932,6,4,4.0,10,0.4
68131053,3,5,3.0,8,0.375
68131078,5,4,4.0,9,0.4444444444444444
68132962,1,8,1.0,9,0.1111111111111111
68133773,1,9,1.0,10,0.1
68134319,5,5,5.0,10,0.5
68138900,1,8,1.0,9,0.1111111111111111
68139129,3,7,3.0,10,0.3
68139677,9,1,1.0,10,0.1
68148487,8,2,2.0,10,0.2
68149168,1,8,1.0,9,0.1111111111111111
68157057,1,17,1.0,18,0.05555555555555555
68157285,1,8,1.0,9,0.1111111111111111
68162345,9,1,1.0,10,0.1
68174085,3,27,3.0,30,0.1
68192939,2,7,2.0,9,0.2222222222222222
68193075,1,16,1.0,17,0.058823529411764705
68193379,6,3,3.0,9,0.3333333333333333
68203728,3,16,3.0,19,0.15789473684210525
68209624,1,7,1.0,8,0.125
68222690,1,8,1.0,9,0.1111111111111111
68239201,8,1,1.0,9,0.1111111111111111
68240525,3,6,3.0,9,0.3333333333333333
68259052,2,8,2.0,10,0.2
68264123,1,9,1.0,10,0.1
68267281,1,8,1.0,9,0.1111111111111111
68271250,1,7,1.0,8,0.125
68284108,1,9,1.0,10,0.1
68290875,3,7,3.0,10,0.3
68301172,1,9,1.0,10,0.1
68302291,1,18,1.0,19,0.05263157894736842
68305479,1,9,1.0,10,0.1
68311604,9,1,1.0,10,0.1
68319392,2,6,2.0,8,0.25
68337809,3,6,3.0,9,0.3333333333333333
68343122,2,7,2.0,9,0.2222222222222222
68344474,1,8,1.0,9,0.1111111111111111
68349646,9,1,1.0,10,0.1
68356163,7,3,3.0,10,0.3
68357917,4,6,4.0,10,0.4
68358620,1,9,1.0,10,0.1
68359427,3,7,3.0,10,0.3
68359740,1,9,1.0,10,0.1
68367625,3,6,3.0,9,0.3333333333333333
68371327,3,7,3.0,10,0.3
68372436,26,3,3.0,29,0.10344827586206896
68376637,2,6,2.0,8,0.25
68381925,2,8,2.0,10,0.2
68382474,1,7,1.0,8,0.125
68382810,4,6,4.0,10,0.4
68383194,1,8,1.0,9,0.1111111111111111
68383645,8,2,2.0,10,0.2
68418628,4,6,4.0,10,0.4
68422454,4,25,4.0,29,0.13793103448275862
68434316,3,17,3.0,20,0.15
68449222,3,7,3.0,10,0.3
68453029,1,18,1.0,19,0.05263157894736842
68459846,1,18,1.0,19,0.05263157894736842
68464367,8,1,1.0,9,0.1111111111111111
68466984,13,7,7.0,20,0.35
68479145,5,22,5.0,27,0.18518518518518517
68492911,2,8,2.0,10,0.2
68493777,1,9,1.0,10,0.1
68495373,2,8,2.0,10,0.2
68502903,3,7,3.0,10,0.3
68507393,1,8,1.0,9,0.1111111111111111
68514958,2,8,2.0,10,0.2
68543545,1,9,1.0,10,0.1
68549445,1,18,1.0,19,0.05263157894736842
68551912,3,17,3.0,20,0.15
68553555,1,9,1.0,10,0.1
68556809,10,20,10.0,30,0.3333333333333333
68556925,3,6,3.0,9,0.3333333333333333
68556967,4,5,4.0,9,0.4444444444444444
68563355,7,3,3.0,10,0.3
68564541,2,8,2.0,10,0.2
68565676,1,9,1.0,10,0.1
68569043,4,19,4.0,23,0.17391304347826086
68575571,7,2,2.0,9,0.2222222222222222
68576357,11,16,11.0,27,0.4074074074074074
68576664,10,18,10.0,28,0.35714285714285715
68577041,8,2,2.0,10,0.2
68580236,1,9,1.0,10,0.1
68583286,1,9,1.0,10,0.1
68591437,1,7,1.0,8,0.125
68602348,9,1,1.0,10,0.1
68631676,2,8,2.0,10,0.2
68632957,4,6,4.0,10,0.4
68633375,27,2,2.0,29,0.06896551724137931
68633711,5,15,5.0,20,0.25
68634038,1,18,1.0,19,0.05263157894736842
68658122,8,2,2.0,10,0.2
68662173,6,4,4.0,10,0.4
68676324,1,9,1.0,10,0.1
68679193,1,9,1.0,10,0.1
68701240,1,7,1.0,8,0.125
68703287,2,27,2.0,29,0.06896551724137931
68711414,14,12,12.0,26,0.46153846153846156
68716134,8,2,2.0,10,0.2
68729705,9,11,9.0,20,0.45
68738434,1,9,1.0,10,0.1
68739576,1,9,1.0,10,0.1
68740608,2,18,2.0,20,0.1
68740635,4,6,4.0,10,0.4
68742199,4,6,4.0,10,0.4
68745451,7,3,3.0,10,0.3
68745786,6,4,4.0,10,0.4
68751189,3,6,3.0,9,0.3333333333333333
68751913,3,7,3.0,10,0.3
68757613,1,9,1.0,10,0.1
68758458,1,8,1.0,9,0.1111111111111111
68759042,1,18,1.0,19,0.05263157894736842
68762080,2,7,2.0,9,0.2222222222222222
68766793,1,7,1.0,8,0.125
68767133,1,9,1.0,10,0.1
68767548,2,7,2.0,9,0.2222222222222222
68767742,2,26,2.0,28,0.07142857142857142
68768135,2,23,2.0,25,0.08
68768933,3,6,3.0,9,0.3333333333333333
68769792,4,6,4.0,10,0.4
68772915,7,1,1.0,8,0.125
68780195,8,2,2.0,10,0.2
68780235,5,5,5.0,10,0.5
68781472,6,4,4.0,10,0.4
68782137,5,4,4.0,9,0.4444444444444444
68783114,5,5,5.0,10,0.5
68788298,2,17,2.0,19,0.10526315789473684
68788665,3,7,3.0,10,0.3
68808282,3,7,3.0,10,0.3
68809161,2,8,2.0,10,0.2
68809417,2,7,2.0,9,0.2222222222222222
68810664,2,7,2.0,9,0.2222222222222222
68821524,4,4,4.0,8,0.5
68821719,1,27,1.0,28,0.03571428571428571
68828350,1,8,1.0,9,0.1111111111111111
68830409,1,9,1.0,10,0.1
68843851,6,3,3.0,9,0.3333333333333333
68848788,1,9,1.0,10,0.1
68864480,3,6,3.0,9,0.3333333333333333
68865357,6,3,3.0,9,0.3333333333333333
68874813,1,9,1.0,10,0.1
68874987,3,6,3.0,9,0.3333333333333333
68875512,2,8,2.0,10,0.2
68877290,5,5,5.0,10,0.5
68877843,14,14,14.0,28,0.5
68878794,1,9,1.0,10,0.1
68879695,3,7,3.0,10,0.3
68879998,4,6,4.0,10,0.4
68880133,4,6,4.0,10,0.4
68884064,2,8,2.0,10,0.2
68890685,2,17,2.0,19,0.10526315789473684
68895201,7,13,7.0,20,0.35
68895457,2,8,2.0,10,0.2
68913528,1,9,1.0,10,0.1
68916944,4,6,4.0,10,0.4
68917656,2,6,2.0,8,0.25
68917857,5,5,5.0,10,0.5
68922615,2,7,2.0,9,0.2222222222222222
68928652,1,9,1.0,10,0.1
68944311,1,19,1.0,20,0.05
68945490,7,2,2.0,9,0.2222222222222222
68948489,1,9,1.0,10,0.1
68949902,1,8,1.0,9,0.1111111111111111
68951418,2,8,2.0,10,0.2
68953126,1,9,1.0,10,0.1
68953889,1,8,1.0,9,0.1111111111111111
68954128,2,18,2.0,20,0.1
68954664,2,8,2.0,10,0.2
68958497,8,1,1.0,9,0.1111111111111111
68959459,7,18,7.0,25,0.28
68960662,1,9,1.0,10,0.1
68962018,4,5,4.0,9,0.4444444444444444
68972608,1,8,1.0,9,0.1111111111111111
68974348,1,9,1.0,10,0.1
68999029,2,8,2.0,10,0.2
69005868,4,6,4.0,10,0.4
69011634,1,9,1.0,10,0.1
69021312,1,8,1.0,9,0.1111111111111111
69029109,2,6,2.0,8,0.25
69033124,8,2,2.0,10,0.2
69033717,7,3,3.0,10,0.3
69044309,1,8,1.0,9,0.1111111111111111
69047027,2,7,2.0,9,0.2222222222222222
69049808,1,26,1.0,27,0.037037037037037035
69051430,1,29,1.0,30,0.03333333333333333
69052632,1,9,1.0,10,0.1
69058219,1,27,1.0,28,0.03571428571428571
69060756,17,2,2.0,19,0.10526315789473684
69067224,1,9,1.0,10,0.1
69067398,2,8,2.0,10,0.2
69068720,9,1,1.0,10,0.1
69071157,7,3,3.0,10,0.3
69071657,7,3,3.0,10,0.3
69073437,1,8,1.0,9,0.1111111111111111
69075716,2,7,2.0,9,0.2222222222222222
69081065,1,9,1.0,10,0.1
69092879,1,9,1.0,10,0.1
69095395,9,1,1.0,10,0.1
69097146,2,8,2.0,10,0.2
69099098,9,1,1.0,10,0.1
69104205,1,8,1.0,9,0.1111111111111111
69104518,1,27,1.0,28,0.03571428571428571
69107234,4,5,4.0,9,0.4444444444444444
69111073,1,9,1.0,10,0.1
69118490,4,6,4.0,10,0.4
69118889,1,8,1.0,9,0.1111111111111111
69119263,1,9,1.0,10,0.1
69119792,2,7,2.0,9,0.2222222222222222
69127980,2,8,2.0,10,0.2
69129410,1,9,1.0,10,0.1
69134996,21,9,9.0,30,0.3
69141379,15,14,14.0,29,0.4827586206896552
69142067,2,8,2.0,10,0.2
69142157,3,13,3.0,16,0.1875
69142352,5,4,4.0,9,0.4444444444444444
69142593,3,6,3.0,9,0.3333333333333333
69147561,13,7,7.0,20,0.35
69153730,1,8,1.0,9,0.1111111111111111
69155317,1,9,1.0,10,0.1
69161162,3,7,3.0,10,0.3
69162328,6,22,6.0,28,0.21428571428571427
69162858,1,9,1.0,10,0.1
69162962,2,8,2.0,10,0.2
69163285,4,6,4.0,10,0.4
69163675,8,20,8.0,28,0.2857142857142857
69174860,4,4,4.0,8,0.5
69176035,1,7,1.0,8,0.125
69178620,2,8,2.0,10,0.2
69178864,8,20,8.0,28,0.2857142857142857
69197368,2,18,2.0,20,0.1
69197521,6,4,4.0,10,0.4
69202602,2,7,2.0,9,0.2222222222222222
69203284,16,11,11.0,27,0.4074074074074074
69204953,2,7,2.0,9,0.2222222222222222
69222203,4,6,4.0,10,0.4
69222309,7,2,2.0,9,0.2222222222222222
69224096,3,7,3.0,10,0.3
69224461,2,7,2.0,9,0.2222222222222222
69227414,1,9,1.0,10,0.1
69230865,19,10,10.0,29,0.3448275862068966
69237677,6,3,3.0,9,0.3333333333333333
69238692,1,9,1.0,10,0.1
69239708,9,1,1.0,10,0.1
69240194,5,4,4.0,9,0.4444444444444444
69281695,1,19,1.0,20,0.05
69288382,2,15,2.0,17,0.11764705882352941
69300411,4,6,4.0,10,0.4
69303877,4,5,4.0,9,0.4444444444444444
69309318,5,5,5.0,10,0.5
69309863,6,3,3.0,9,0.3333333333333333
69320396,1,7,1.0,8,0.125
69321534,1,9,1.0,10,0.1
69323908,1,9,1.0,10,0.1
69327755,1,8,1.0,9,0.1111111111111111
69335733,1,8,1.0,9,0.1111111111111111
69343246,1,9,1.0,10,0.1
69344574,3,7,3.0,10,0.3
69344792,7,13,7.0,20,0.35
69347920,2,8,2.0,10,0.2
69348731,2,26,2.0,28,0.07142857142857142
69366861,3,6,3.0,9,0.3333333333333333
69367171,6,4,4.0,10,0.4
69367515,1,9,1.0,10,0.1
69368979,4,6,4.0,10,0.4
69381384,2,6,2.0,8,0.25
69381937,2,7,2.0,9,0.2222222222222222
69399374,2,7,2.0,9,0.2222222222222222
69399815,2,8,2.0,10,0.2
69402234,7,3,3.0,10,0.3
69408336,1,9,1.0,10,0.1
69416748,1,19,1.0,20,0.05
69451056,2,17,2.0,19,0.10526315789473684
69456270,1,9,1.0,10,0.1
69461540,1,9,1.0,10,0.1
69463173,2,8,2.0,10,0.2
69468990,2,7,2.0,9,0.2222222222222222
69469272,2,8,2.0,10,0.2
69475799,1,17,1.0,18,0.05555555555555555
69490934,1,18,1.0,19,0.05263157894736842
69491148,20,9,9.0,29,0.3103448275862069
69502635,1,9,1.0,10,0.1
69513661,1,8,1.0,9,0.1111111111111111
69513729,1,8,1.0,9,0.1111111111111111
69522022,1,19,1.0,20,0.05
69522542,4,5,4.0,9,0.4444444444444444
69524288,1,9,1.0,10,0.1
69527297,4,6,4.0,10,0.4
69573126,1,18,1.0,19,0.05263157894736842
69580154,24,3,3.0,27,0.1111111111111111
69586929,5,5,5.0,10,0.5
69597467,3,6,3.0,9,0.3333333333333333
69598510,1,8,1.0,9,0.1111111111111111
69602423,4,6,4.0,10,0.4
69608138,5,5,5.0,10,0.5
69621046,1,7,1.0,8,0.125
69621313,1,9,1.0,10,0.1
69626528,2,8,2.0,10,0.2
69628207,1,9,1.0,10,0.1
69628310,2,7,2.0,9,0.2222222222222222
69645993,2,17,2.0,19,0.10526315789473684
69669790,1,26,1.0,27,0.037037037037037035
69679286,1,8,1.0,9,0.1111111111111111
69679874,2,8,2.0,10,0.2
69684387,2,6,2.0,8,0.25
69696831,3,7,3.0,10,0.3
69707608,6,4,4.0,10,0.4
69711616,5,4,4.0,9,0.4444444444444444
69712047,3,7,3.0,10,0.3
69712501,1,9,1.0,10,0.1
69712802,3,7,3.0,10,0.3
69750979,1,18,1.0,19,0.05263157894736842
69755395,8,2,2.0,10,0.2
69760741,5,4,4.0,9,0.4444444444444444
69762350,1,9,1.0,10,0.1
69772708,1,8,1.0,9,0.1111111111111111
69780379,7,2,2.0,9,0.2222222222222222
69780748,2,7,2.0,9,0.2222222222222222
69786214,3,7,3.0,10,0.3
69789531,8,2,2.0,10,0.2
69808341,13,16,13.0,29,0.4482758620689655
69811986,1,8,1.0,9,0.1111111111111111
69822639,1,8,1.0,9,0.1111111111111111
69848591,2,8,2.0,10,0.2
69859411,2,8,2.0,10,0.2
69904483,1,9,1.0,10,0.1
69904941,1,9,1.0,10,0.1
69909159,4,5,4.0,9,0.4444444444444444
69910034,1,9,1.0,10,0.1
69910420,3,6,3.0,9,0.3333333333333333
69921195,4,6,4.0,10,0.4
69922146,15,12,12.0,27,0.4444444444444444
69949407,2,7,2.0,9,0.2222222222222222
69953927,1,7,1.0,8,0.125
69954265,2,7,2.0,9,0.2222222222222222
69957645,2,7,2.0,9,0.2222222222222222
69966240,6,2,2.0,8,0.25
69969793,1,9,1.0,10,0.1
69972972,2,8,2.0,10,0.2
69986241,2,7,2.0,9,0.2222222222222222
70031191,2,8,2.0,10,0.2
70037063,1,9,1.0,10,0.1
70040497,1,9,1.0,10,0.1
70041042,2,7,2.0,9,0.2222222222222222
70053755,1,9,1.0,10,0.1
70065798,4,15,4.0,19,0.21052631578947367
70077784,2,8,2.0,10,0.2
70079152,1,9,1.0,10,0.1
70085379,2,7,2.0,9,0.2222222222222222
70087855,1,8,1.0,9,0.1111111111111111
70088564,1,9,1.0,10,0.1
70089333,1,9,1.0,10,0.1
70096596,1,9,1.0,10,0.1
70120304,4,6,4.0,10,0.4
70135190,1,9,1.0,10,0.1
70135748,2,8,2.0,10,0.2
70136148,1,8,1.0,9,0.1111111111111111
70136509,3,6,3.0,9,0.3333333333333333
70145135,1,18,1.0,19,0.05263157894736842
70146680,1,8,1.0,9,0.1111111111111111
70182977,1,9,1.0,10,0.1
70253474,1,9,1.0,10,0.1
70255551,6,3,3.0,9,0.3333333333333333
70262076,2,7,2.0,9,0.2222222222222222
70267363,1,9,1.0,10,0.1
70268946,1,19,1.0,20,0.05
70278409,7,3,3.0,10,0.3
70279242,1,9,1.0,10,0.1
70286136,1,9,1.0,10,0.1
70288492,8,1,1.0,9,0.1111111111111111
70294878,1,8,1.0,9,0.1111111111111111
70313993,3,16,3.0,19,0.15789473684210525
70314069,1,19,1.0,20,0.05
70326144,3,7,3.0,10,0.3
70327397,10,17,10.0,27,0.37037037037037035
70336328,6,3,3.0,9,0.3333333333333333
70336872,1,9,1.0,10,0.1
70341238,7,3,3.0,10,0.3
70342176,6,4,4.0,10,0.4
70343933,8,2,2.0,10,0.2
70352730,5,4,4.0,9,0.4444444444444444
70364028,2,6,2.0,8,0.25
70366704,6,4,4.0,10,0.4
70372787,1,8,1.0,9,0.1111111111111111
70375981,1,16,1.0,17,0.058823529411764705
70396171,3,26,3.0,29,0.10344827586206896
70396914,1,9,1.0,10,0.1
70400596,3,7,3.0,10,0.3
70424432,7,2,2.0,9,0.2222222222222222
70427118,4,4,4.0,8,0.5
70435159,1,9,1.0,10,0.1
70438964,2,8,2.0,10,0.2
70439201,4,6,4.0,10,0.4
70450478,1,9,1.0,10,0.1
70482868,9,1,1.0,10,0.1
70483611,5,4,4.0,9,0.4444444444444444
70489561,5,5,5.0,10,0.5
70502338,6,23,6.0,29,0.20689655172413793
70505635,9,1,1.0,10,0.1
70527812,3,6,3.0,9,0.3333333333333333
70531879,3,7,3.0,10,0.3
70535992,3,7,3.0,10,0.3
70536261,4,4,4.0,8,0.5
70551739,3,6,3.0,9,0.3333333333333333
70552634,2,8,2.0,10,0.2
70555666,3,7,3.0,10,0.3
70556076,1,19,1.0,20,0.05
70561189,2,8,2.0,10,0.2
70566298,3,17,3.0,20,0.15
70596762,2,7,2.0,9,0.2222222222222222
70601097,14,13,13.0,27,0.48148148148148145
70601164,2,7,2.0,9,0.2222222222222222
70602054,1,9,1.0,10,0.1
70623848,3,6,3.0,9,0.3333333333333333
70624165,1,9,1.0,10,0.1
70630142,1,8,1.0,9,0.1111111111111111
70631668,1,19,1.0,20,0.05
70640879,5,5,5.0,10,0.5
70641058,5,5,5.0,10,0.5
70641499,23,5,5.0,28,0.17857142857142858
70642475,4,5,4.0,9,0.4444444444444444
70652433,1,9,1.0,10,0.1
70661612,1,9,1.0,10,0.1
70663062,2,17,2.0,19,0.10526315789473684
70665523,1,8,1.0,9,0.1111111111111111
70693520,9,1,1.0,10,0.1
70695587,8,2,2.0,10,0.2
70699074,2,8,2.0,10,0.2
70711864,1,28,1.0,29,0.034482758620689655
70718567,2,8,2.0,10,0.2
70730610,1,9,1.0,10,0.1
70736611,1,9,1.0,10,0.1
70758660,4,14,4.0,18,0.2222222222222222
70774386,5,5,5.0,10,0.5
70776268,7,3,3.0,10,0.3
70781260,7,3,3.0,10,0.3
70808688,4,4,4.0,8,0.5
70815006,15,12,12.0,27,0.4444444444444444
70816003,3,6,3.0,9,0.3333333333333333
70816835,4,6,4.0,10,0.4
70817164,4,5,4.0,9,0.4444444444444444
70825433,2,7,2.0,9,0.2222222222222222
70844252,1,9,1.0,10,0.1
70856929,3,7,3.0,10,0.3
70856979,2,7,2.0,9,0.2222222222222222
70857212,4,6,4.0,10,0.4
70857596,1,9,1.0,10,0.1
70863294,1,9,1.0,10,0.1
70863653,7,3,3.0,10,0.3
70865406,3,6,3.0,9,0.3333333333333333
70871483,3,6,3.0,9,0.3333333333333333
70877334,4,6,4.0,10,0.4
70880071,7,2,2.0,9,0.2222222222222222
70883613,1,17,1.0,18,0.05555555555555555
70884370,9,1,1.0,10,0.1
70887412,6,3,3.0,9,0.3333333333333333
70895726,3,7,3.0,10,0.3
70898877,5,12,5.0,17,0.29411764705882354
70905491,1,8,1.0,9,0.1111111111111111
70907289,1,9,1.0,10,0.1
70917000,1,17,1.0,18,0.05555555555555555
70952064,2,7,2.0,9,0.2222222222222222
70962093,3,7,3.0,10,0.3
70962519,1,26,1.0,27,0.037037037037037035
70971246,1,19,1.0,20,0.05
70977463,12,16,12.0,28,0.42857142857142855
70979812,2,8,2.0,10,0.2
71000285,4,4,4.0,8,0.5
71001798,2,8,2.0,10,0.2
71003570,1,8,1.0,9,0.1111111111111111
71010692,1,8,1.0,9,0.1111111111111111
71011553,1,18,1.0,19,0.05263157894736842
71047885,9,1,1.0,10,0.1
71082497,4,6,4.0,10,0.4
71086894,1,9,1.0,10,0.1
71095422,1,9,1.0,10,0.1
71108902,1,18,1.0,19,0.05263157894736842
71111127,2,7,2.0,9,0.2222222222222222
71111829,4,6,4.0,10,0.4
71112453,7,2,2.0,9,0.2222222222222222
71128999,7,3,3.0,10,0.3
71138387,1,9,1.0,10,0.1
71138670,2,7,2.0,9,0.2222222222222222
71140984,1,9,1.0,10,0.1
71146556,5,5,5.0,10,0.5
71155425,2,7,2.0,9,0.2222222222222222
71155633,4,4,4.0,8,0.5
71168592,2,8,2.0,10,0.2
71171789,2,8,2.0,10,0.2
71183032,4,5,4.0,9,0.4444444444444444
71192502,1,8,1.0,9,0.1111111111111111
71197658,15,2,2.0,17,0.11764705882352941
71200050,6,3,3.0,9,0.3333333333333333
71209545,5,5,5.0,10,0.5
71212682,7,2,2.0,9,0.2222222222222222
71244236,7,2,2.0,9,0.2222222222222222
71247040,2,7,2.0,9,0.2222222222222222
71250184,5,5,5.0,10,0.5
71250335,1,9,1.0,10,0.1
71259622,2,6,2.0,8,0.25
71267510,1,8,1.0,9,0.1111111111111111
71283889,1,9,1.0,10,0.1
71290252,1,19,1.0,20,0.05
71291897,6,4,4.0,10,0.4
71291946,2,7,2.0,9,0.2222222222222222
71297066,1,8,1.0,9,0.1111111111111111
71309292,1,16,1.0,17,0.058823529411764705
71313330,2,18,2.0,20,0.1
71314997,1,9,1.0,10,0.1
71316795,1,9,1.0,10,0.1
71387058,1,19,1.0,20,0.05
71389875,3,7,3.0,10,0.3
71392599,5,3,3.0,8,0.375
71418487,4,6,4.0,10,0.4
71418935,3,6,3.0,9,0.3333333333333333
71434338,1,26,1.0,27,0.037037037037037035
71436756,4,25,4.0,29,0.13793103448275862
71443683,2,17,2.0,19,0.10526315789473684
71452818,1,9,1.0,10,0.1
71465947,1,15,1.0,16,0.0625
71467037,2,8,2.0,10,0.2
71467876,3,5,3.0,8,0.375
71470479,5,4,4.0,9,0.4444444444444444
71473244,1,8,1.0,9,0.1111111111111111
71484668,2,6,2.0,8,0.25
71511370,1,9,1.0,10,0.1
71511870,1,9,1.0,10,0.1
71528991,2,26,2.0,28,0.07142857142857142
71533000,1,7,1.0,8,0.125
71592932,1,9,1.0,10,0.1
71608116,3,13,3.0,16,0.1875
71625569,1,8,1.0,9,0.1111111111111111
71642607,1,8,1.0,9,0.1111111111111111
71650477,1,19,1.0,20,0.05
71663793,1,9,1.0,10,0.1
71678660,7,2,2.0,9,0.2222222222222222
71686578,5,5,5.0,10,0.5
71691292,1,9,1.0,10,0.1
71721573,9,1,1.0,10,0.1
71777324,1,9,1.0,10,0.1
71799828,1,8,1.0,9,0.1111111111111111
71800524,1,19,1.0,20,0.05
71822320,4,5,4.0,9,0.4444444444444444
71824783,1,8,1.0,9,0.1111111111111111
71828533,9,1,1.0,10,0.1
71831767,1,7,1.0,8,0.125
71832178,1,28,1.0,29,0.034482758620689655
71832583,3,6,3.0,9,0.3333333333333333
71862896,8,2,2.0,10,0.2
71878700,1,7,1.0,8,0.125
71881496,7,3,3.0,10,0.3
71883137,1,16,1.0,17,0.058823529411764705
71891136,1,7,1.0,8,0.125
71891399,4,5,4.0,9,0.4444444444444444
71891889,8,2,2.0,10,0.2
71892819,9,1,1.0,10,0.1
71907947,2,27,2.0,29,0.06896551724137931
71989349,2,8,2.0,10,0.2
72002351,1,19,1.0,20,0.05
72002363,3,7,3.0,10,0.3
72003342,3,17,3.0,20,0.15
72029007,1,9,1.0,10,0.1
72057769,1,8,1.0,9,0.1111111111111111
72058248,2,8,2.0,10,0.2
72061884,3,26,3.0,29,0.10344827586206896
72068058,3,7,3.0,10,0.3
72072137,1,9,1.0,10,0.1
72074064,5,5,5.0,10,0.5
72074571,5,4,4.0,9,0.4444444444444444
72079398,1,8,1.0,9,0.1111111111111111
72081523,2,8,2.0,10,0.2
72104070,3,6,3.0,9,0.3333333333333333
72128099,1,9,1.0,10,0.1
72130325,1,9,1.0,10,0.1
72141188,1,9,1.0,10,0.1
72170383,2,8,2.0,10,0.2
72170579,1,9,1.0,10,0.1
72170995,1,9,1.0,10,0.1
72171628,20,6,6.0,26,0.23076923076923078
72171700,3,7,3.0,10,0.3
72190839,1,9,1.0,10,0.1
72206955,2,8,2.0,10,0.2
72271207,3,6,3.0,9,0.3333333333333333
72277551,1,9,1.0,10,0.1
72302361,5,3,3.0,8,0.375
72302498,8,1,1.0,9,0.1111111111111111
72310402,4,6,4.0,10,0.4
72329019,1,9,1.0,10,0.1
72335663,4,4,4.0,8,0.5
72349808,2,7,2.0,9,0.2222222222222222
72362492,2,8,2.0,10,0.2
72366028,1,9,1.0,10,0.1
72366230,2,8,2.0,10,0.2
72375981,1,8,1.0,9,0.1111111111111111
72381287,4,26,4.0,30,0.13333333333333333
72382240,1,9,1.0,10,0.1
72383981,9,1,1.0,10,0.1
72437480,2,8,2.0,10,0.2
72437712,3,7,3.0,10,0.3
72440500,1,9,1.0,10,0.1
72441840,8,2,2.0,10,0.2
72442551,1,8,1.0,9,0.1111111111111111
72483697,1,28,1.0,29,0.034482758620689655
72522076,1,9,1.0,10,0.1
72525619,1,9,1.0,10,0.1
72526723,1,19,1.0,20,0.05
72547021,1,9,1.0,10,0.1
72559958,1,19,1.0,20,0.05
72565364,1,8,1.0,9,0.1111111111111111
72578337,8,2,2.0,10,0.2
72582246,8,2,2.0,10,0.2
72590868,6,21,6.0,27,0.2222222222222222
72619077,1,19,1.0,20,0.05
72622559,3,7,3.0,10,0.3
72629365,2,8,2.0,10,0.2
72638310,4,5,4.0,9,0.4444444444444444
72640143,6,14,6.0,20,0.3
72642399,2,6,2.0,8,0.25
72645669,3,6,3.0,9,0.3333333333333333
72645896,2,26,2.0,28,0.07142857142857142
72656754,1,7,1.0,8,0.125
72657962,3,7,3.0,10,0.3
72658284,20,9,9.0,29,0.3103448275862069
72678377,2,17,2.0,19,0.10526315789473684
72683479,1,9,1.0,10,0.1
72691057,5,4,4.0,9,0.4444444444444444
72692963,8,1,1.0,9,0.1111111111111111
72732200,1,8,1.0,9,0.1111111111111111
72734967,1,8,1.0,9,0.1111111111111111
72736464,2,8,2.0,10,0.2
72738821,3,7,3.0,10,0.3
72739796,3,7,3.0,10,0.3
72741229,2,18,2.0,20,0.1
72741532,3,7,3.0,10,0.3
72749189,4,6,4.0,10,0.4
72757347,5,4,4.0,9,0.4444444444444444
72761987,2,8,2.0,10,0.2
72770750,9,1,1.0,10,0.1
72778549,3,7,3.0,10,0.3
72803892,1,9,1.0,10,0.1
72835447,6,2,2.0,8,0.25
72839951,4,6,4.0,10,0.4
72843947,29,1,1.0,30,0.03333333333333333
72885542,1,19,1.0,20,0.05
72904966,3,7,3.0,10,0.3
72920563,1,9,1.0,10,0.1
72923238,2,8,2.0,10,0.2
72947040,3,6,3.0,9,0.3333333333333333
72966252,3,6,3.0,9,0.3333333333333333
72974431,4,5,4.0,9,0.4444444444444444
72974814,1,9,1.0,10,0.1
72976093,1,9,1.0,10,0.1
72984687,2,6,2.0,8,0.25
72984894,1,8,1.0,9,0.1111111111111111
73014991,3,15,3.0,18,0.16666666666666666
73016762,1,9,1.0,10,0.1
73018366,9,1,1.0,10,0.1
73024409,1,8,1.0,9,0.1111111111111111
73025281,16,12,12.0,28,0.42857142857142855
73031310,2,7,2.0,9,0.2222222222222222
73031415,1,9,1.0,10,0.1
73031915,4,5,4.0,9,0.4444444444444444
73032487,6,4,4.0,10,0.4
73042587,4,6,4.0,10,0.4
73044980,1,8,1.0,9,0.1111111111111111
73048515,1,9,1.0,10,0.1
73059636,1,9,1.0,10,0.1
73069942,3,7,3.0,10,0.3
73071620,1,7,1.0,8,0.125
73082053,1,8,1.0,9,0.1111111111111111
73088356,9,1,1.0,10,0.1
73125123,2,17,2.0,19,0.10526315789473684
73127041,2,8,2.0,10,0.2
73129529,1,8,1.0,9,0.1111111111111111
73131340,2,16,2.0,18,0.1111111111111111
73144933,3,5,3.0,8,0.375
73145693,1,9,1.0,10,0.1
73159767,2,8,2.0,10,0.2
73161183,1,9,1.0,10,0.1
73163777,2,8,2.0,10,0.2
73184737,1,9,1.0,10,0.1
73184843,2,28,2.0,30,0.06666666666666667
73186491,1,18,1.0,19,0.05263157894736842
73217435,1,9,1.0,10,0.1
73223888,1,9,1.0,10,0.1
73238776,1,9,1.0,10,0.1
73257238,1,9,1.0,10,0.1
73294416,1,9,1.0,10,0.1
73300570,24,1,1.0,25,0.04
73334571,4,6,4.0,10,0.4
73334827,6,4,4.0,10,0.4
73345381,12,7,7.0,19,0.3684210526315789
73356723,6,2,2.0,8,0.25
73372367,2,7,2.0,9,0.2222222222222222
73381969,2,18,2.0,20,0.1
73382089,2,8,2.0,10,0.2
73386472,1,9,1.0,10,0.1
73394964,1,8,1.0,9,0.1111111111111111
73403096,1,18,1.0,19,0.05263157894736842
73404274,1,8,1.0,9,0.1111111111111111
73412564,1,8,1.0,9,0.1111111111111111
73413154,4,6,4.0,10,0.4
73413455,1,8,1.0,9,0.1111111111111111
73413974,1,8,1.0,9,0.1111111111111111
73417279,3,7,3.0,10,0.3
73429531,4,5,4.0,9,0.4444444444444444
73430369,3,6,3.0,9,0.3333333333333333
73430914,22,6,6.0,28,0.21428571428571427
73433396,6,4,4.0,10,0.4
73435060,9,1,1.0,10,0.1
73439824,1,9,1.0,10,0.1
73476326,1,9,1.0,10,0.1
73486917,1,9,1.0,10,0.1
73487024,1,8,1.0,9,0.1111111111111111
73488662,1,8,1.0,9,0.1111111111111111
73491753,1,9,1.0,10,0.1
73495871,7,3,3.0,10,0.3
73498123,2,7,2.0,9,0.2222222222222222
73499884,3,7,3.0,10,0.3
73500764,3,7,3.0,10,0.3
73508112,1,7,1.0,8,0.125
73510443,1,9,1.0,10,0.1
73516993,3,6,3.0,9,0.3333333333333333
73520335,6,3,3.0,9,0.3333333333333333
73522205,4,6,4.0,10,0.4
73522962,2,8,2.0,10,0.2
73526018,1,9,1.0,10,0.1
73526597,3,6,3.0,9,0.3333333333333333
73526915,2,8,2.0,10,0.2
73528519,4,6,4.0,10,0.4
73529637,3,7,3.0,10,0.3
73538950,1,9,1.0,10,0.1
73548051,1,17,1.0,18,0.05555555555555555
73549293,1,9,1.0,10,0.1
73594287,3,7,3.0,10,0.3
73599561,1,8,1.0,9,0.1111111111111111
73605140,1,9,1.0,10,0.1
73615632,5,4,4.0,9,0.4444444444444444
73616532,5,5,5.0,10,0.5
73616900,6,3,3.0,9,0.3333333333333333
73617414,6,2,2.0,8,0.25
73627222,2,7,2.0,9,0.2222222222222222
73641333,3,7,3.0,10,0.3
73641761,1,8,1.0,9,0.1111111111111111
73642000,1,9,1.0,10,0.1
73644143,26,1,1.0,27,0.037037037037037035
73651595,1,8,1.0,9,0.1111111111111111
73670160,2,8,2.0,10,0.2
73674870,6,3,3.0,9,0.3333333333333333
73675841,5,4,4.0,9,0.4444444444444444
73703149,5,5,5.0,10,0.5
73706519,6,4,4.0,10,0.4
73706717,3,6,3.0,9,0.3333333333333333
73706826,1,8,1.0,9,0.1111111111111111
73708905,4,6,4.0,10,0.4
73708954,2,18,2.0,20,0.1
73709483,6,3,3.0,9,0.3333333333333333
73718142,1,8,1.0,9,0.1111111111111111
73719605,5,4,4.0,9,0.4444444444444444
73719814,1,9,1.0,10,0.1
73721623,4,5,4.0,9,0.4444444444444444
73721873,1,19,1.0,20,0.05
73722348,8,10,8.0,18,0.4444444444444444
73728757,5,5,5.0,10,0.5
73733888,6,23,6.0,29,0.20689655172413793
73737167,1,8,1.0,9,0.1111111111111111
73759632,9,1,1.0,10,0.1
73766063,2,8,2.0,10,0.2
73770737,6,2,2.0,8,0.25
73771124,1,9,1.0,10,0.1
73774707,1,9,1.0,10,0.1
73774770,23,7,7.0,30,0.23333333333333334
73777323,1,18,1.0,19,0.05263157894736842
73777498,8,2,2.0,10,0.2
73827680,2,17,2.0,19,0.10526315789473684
73839973,7,3,3.0,10,0.3
73852503,1,18,1.0,19,0.05263157894736842
73852901,12,15,12.0,27,0.4444444444444444
73853251,7,12,7.0,19,0.3684210526315789
73856983,5,4,4.0,9,0.4444444444444444
73866078,4,5,4.0,9,0.4444444444444444
73867528,2,7,2.0,9,0.2222222222222222
73885812,1,9,1.0,10,0.1
73887408,1,9,1.0,10,0.1
73889706,2,8,2.0,10,0.2
73896604,1,9,1.0,10,0.1
73902693,3,6,3.0,9,0.3333333333333333
73904192,1,8,1.0,9,0.1111111111111111
73904212,5,3,3.0,8,0.375
73904413,2,8,2.0,10,0.2
73931255,3,5,3.0,8,0.375
73931512,4,5,4.0,9,0.4444444444444444
73932390,7,3,3.0,10,0.3
73933107,6,2,2.0,8,0.25
73933399,4,6,4.0,10,0.4
73962233,2,8,2.0,10,0.2
73988633,4,6,4.0,10,0.4
73994389,1,7,1.0,8,0.125
73995731,1,8,1.0,9,0.1111111111111111
73996920,4,6,4.0,10,0.4
74012487,2,8,2.0,10,0.2
74014963,2,18,2.0,20,0.1
74029811,1,18,1.0,19,0.05263157894736842
74032787,2,7,2.0,9,0.2222222222222222
74038089,1,7,1.0,8,0.125
74038529,2,8,2.0,10,0.2
74045759,2,8,2.0,10,0.2
74047169,1,8,1.0,9,0.1111111111111111
74047747,2,7,2.0,9,0.2222222222222222
74047908,1,9,1.0,10,0.1
74048849,1,9,1.0,10,0.1
74052647,1,9,1.0,10,0.1
74059055,2,6,2.0,8,0.25
74061650,1,9,1.0,10,0.1
74062495,2,8,2.0,10,0.2
74079250,1,9,1.0,10,0.1
74080419,8,2,2.0,10,0.2
74080876,9,1,1.0,10,0.1
74085709,2,7,2.0,9,0.2222222222222222
74085751,1,9,1.0,10,0.1
74086711,4,6,4.0,10,0.4
74088038,3,7,3.0,10,0.3
74090593,2,8,2.0,10,0.2
74092178,4,6,4.0,10,0.4
74093482,1,9,1.0,10,0.1
74094663,4,6,4.0,10,0.4
74097040,8,2,2.0,10,0.2
74097246,7,2,2.0,9,0.2222222222222222
74097685,2,8,2.0,10,0.2
74098163,3,7,3.0,10,0.3
74098452,3,17,3.0,20,0.15
74098705,3,5,3.0,8,0.375
74099571,4,15,4.0,19,0.21052631578947367
74113456,1,9,1.0,10,0.1
74114472,2,6,2.0,8,0.25
74125875,1,17,1.0,18,0.05555555555555555
74128134,24,6,6.0,30,0.2
74172990,3,7,3.0,10,0.3
74175769,1,8,1.0,9,0.1111111111111111
74178106,2,8,2.0,10,0.2
74179746,12,17,12.0,29,0.41379310344827586
74181174,1,9,1.0,10,0.1
74181515,1,9,1.0,10,0.1
74200889,5,5,5.0,10,0.5
74230161,1,27,1.0,28,0.03571428571428571
74233674,1,9,1.0,10,0.1
74236538,3,16,3.0,19,0.15789473684210525
74237007,1,7,1.0,8,0.125
74238158,7,20,7.0,27,0.25925925925925924
74240354,2,6,2.0,8,0.25
74240576,1,9,1.0,10,0.1
74241521,13,17,13.0,30,0.43333333333333335
74243893,1,8,1.0,9,0.1111111111111111
74243937,1,9,1.0,10,0.1
74255048,2,27,2.0,29,0.06896551724137931
74255569,2,8,2.0,10,0.2
74255975,1,7,1.0,8,0.125
74256112,1,9,1.0,10,0.1
74267113,1,9,1.0,10,0.1
74270618,6,13,6.0,19,0.3157894736842105
74274045,1,19,1.0,20,0.05
74283207,1,8,1.0,9,0.1111111111111111
74284423,2,8,2.0,10,0.2
74303981,1,9,1.0,10,0.1
74349522,2,6,2.0,8,0.25
74350281,5,5,5.0,10,0.5
74351263,4,6,4.0,10,0.4
74351822,1,9,1.0,10,0.1
74352002,1,9,1.0,10,0.1
74352168,2,8,2.0,10,0.2
74361703,1,9,1.0,10,0.1
74369700,2,17,2.0,19,0.10526315789473684
74377443,1,9,1.0,10,0.1
74377640,2,8,2.0,10,0.2
74378047,1,9,1.0,10,0.1
74380510,1,9,1.0,10,0.1
74397917,6,4,4.0,10,0.4
74400894,8,1,1.0,9,0.1111111111111111
74401565,5,3,3.0,8,0.375
74401936,1,9,1.0,10,0.1
74403876,2,8,2.0,10,0.2
74405495,7,2,2.0,9,0.2222222222222222
74414946,4,6,4.0,10,0.4
74416247,4,5,4.0,9,0.4444444444444444
74425295,2,7,2.0,9,0.2222222222222222
74433424,1,9,1.0,10,0.1
74437786,1,9,1.0,10,0.1
74463876,1,9,1.0,10,0.1
74475961,3,5,3.0,8,0.375
74492709,2,8,2.0,10,0.2
74493663,3,7,3.0,10,0.3
74501262,1,8,1.0,9,0.1111111111111111
74511160,1,8,1.0,9,0.1111111111111111
74535685,1,18,1.0,19,0.05263157894736842
74538563,1,7,1.0,8,0.125
74539918,1,17,1.0,18,0.05555555555555555
74553329,1,8,1.0,9,0.1111111111111111
74553758,5,5,5.0,10,0.5
74554316,2,26,2.0,28,0.07142857142857142
74555452,7,2,2.0,9,0.2222222222222222
74558248,3,7,3.0,10,0.3
74558498,1,8,1.0,9,0.1111111111111111
74559695,2,7,2.0,9,0.2222222222222222
74563234,2,16,2.0,18,0.1111111111111111
74567744,1,9,1.0,10,0.1
74568725,2,18,2.0,20,0.1
74569364,1,9,1.0,10,0.1
74570277,2,7,2.0,9,0.2222222222222222
74578512,6,24,6.0,30,0.2
74583831,4,5,4.0,9,0.4444444444444444
74621443,1,9,1.0,10,0.1
74625655,1,8,1.0,9,0.1111111111111111
74626883,5,5,5.0,10,0.5
74628271,1,9,1.0,10,0.1
74640858,3,5,3.0,8,0.375
74643813,1,18,1.0,19,0.05263157894736842
74654024,1,9,1.0,10,0.1
74659071,2,8,2.0,10,0.2
74664584,6,3,3.0,9,0.3333333333333333
74693836,9,1,1.0,10,0.1
74694061,5,5,5.0,10,0.5
74695621,1,9,1.0,10,0.1
74695852,8,2,2.0,10,0.2
74696131,5,3,3.0,8,0.375
74696327,2,8,2.0,10,0.2
74696558,8,1,1.0,9,0.1111111111111111
74706515,2,17,2.0,19,0.10526315789473684
74707465,10,9,9.0,19,0.47368421052631576
74711397,2,18,2.0,20,0.1
74722717,9,1,1.0,10,0.1
74736916,2,7,2.0,9,0.2222222222222222
74738174,13,13,13.0,26,0.5
74739478,1,8,1.0,9,0.1111111111111111
74739613,4,6,4.0,10,0.4
74743379,2,6,2.0,8,0.25
74747038,6,14,6.0,20,0.3
74747187,3,6,3.0,9,0.3333333333333333
74747706,6,4,4.0,10,0.4
74748176,6,4,4.0,10,0.4
74748605,27,2,2.0,29,0.06896551724137931
74749183,8,2,2.0,10,0.2
74749718,6,4,4.0,10,0.4
74751364,18,1,1.0,19,0.05263157894736842
74751631,6,3,3.0,9,0.3333333333333333
74751673,3,6,3.0,9,0.3333333333333333
74751949,15,3,3.0,18,0.16666666666666666
74752037,2,8,2.0,10,0.2
74752883,3,7,3.0,10,0.3
74753302,2,8,2.0,10,0.2
74753411,4,5,4.0,9,0.4444444444444444
74754944,8,2,2.0,10,0.2
74755861,4,6,4.0,10,0.4
74756684,8,2,2.0,10,0.2
74760262,4,6,4.0,10,0.4
74776039,1,9,1.0,10,0.1
74794206,2,18,2.0,20,0.1
74801845,1,8,1.0,9,0.1111111111111111
74805238,1,19,1.0,20,0.05
74806854,4,6,4.0,10,0.4
74807422,6,3,3.0,9,0.3333333333333333
74808273,2,8,2.0,10,0.2
74809137,1,8,1.0,9,0.1111111111111111
74813833,4,22,4.0,26,0.15384615384615385
74816202,4,4,4.0,8,0.5
74816540,3,6,3.0,9,0.3333333333333333
74816887,4,5,4.0,9,0.4444444444444444
74817030,3,7,3.0,10,0.3
74829897,3,6,3.0,9,0.3333333333333333
74843044,7,3,3.0,10,0.3
74862783,2,8,2.0,10,0.2
74890792,4,5,4.0,9,0.4444444444444444
74893553,4,5,4.0,9,0.4444444444444444
74897879,2,7,2.0,9,0.2222222222222222
74918244,3,7,3.0,10,0.3
74929760,1,9,1.0,10,0.1
74930535,2,8,2.0,10,0.2
74939159,18,10,10.0,28,0.35714285714285715
74939391,1,19,1.0,20,0.05
74939588,4,5,4.0,9,0.4444444444444444
74941103,3,7,3.0,10,0.3
74954727,3,27,3.0,30,0.1
74959532,1,9,1.0,10,0.1
74976739,2,8,2.0,10,0.2
74981005,2,17,2.0,19,0.10526315789473684
74981184,1,9,1.0,10,0.1
74982166,5,25,5.0,30,0.16666666666666666
74982752,4,6,4.0,10,0.4
74983245,5,5,5.0,10,0.5
74984680,1,7,1.0,8,0.125
74989543,2,8,2.0,10,0.2
75002794,2,8,2.0,10,0.2
75044542,3,7,3.0,10,0.3
75057691,4,6,4.0,10,0.4
75061659,2,7,2.0,9,0.2222222222222222
75062325,1,9,1.0,10,0.1
75062565,1,9,1.0,10,0.1
75088219,3,6,3.0,9,0.3333333333333333
75107488,2,8,2.0,10,0.2
75121787,6,3,3.0,9,0.3333333333333333
75141054,1,8,1.0,9,0.1111111111111111
75142879,4,6,4.0,10,0.4
75145252,5,3,3.0,8,0.375
75148208,2,17,2.0,19,0.10526315789473684
75154054,1,8,1.0,9,0.1111111111111111
75171202,4,6,4.0,10,0.4
75172117,2,8,2.0,10,0.2
75172852,4,5,4.0,9,0.4444444444444444
75174443,9,1,1.0,10,0.1
75174497,2,8,2.0,10,0.2
75178500,1,9,1.0,10,0.1
75210551,1,9,1.0,10,0.1
75219264,5,15,5.0,20,0.25
75227138,3,7,3.0,10,0.3
75250100,2,8,2.0,10,0.2
75258363,2,7,2.0,9,0.2222222222222222
75259888,1,8,1.0,9,0.1111111111111111
75277697,9,1,1.0,10,0.1
75285254,1,9,1.0,10,0.1
75287846,1,8,1.0,9,0.1111111111111111
75289291,1,9,1.0,10,0.1
75293040,3,7,3.0,10,0.3
75294381,2,8,2.0,10,0.2
75299188,4,5,4.0,9,0.4444444444444444
75304535,2,7,2.0,9,0.2222222222222222
75321281,7,20,7.0,27,0.25925925925925924
75326413,1,8,1.0,9,0.1111111111111111
75328580,1,29,1.0,30,0.03333333333333333
75333079,1,9,1.0,10,0.1
75338013,3,7,3.0,10,0.3
75338307,3,17,3.0,20,0.15
75341645,2,8,2.0,10,0.2
75344830,1,8,1.0,9,0.1111111111111111
75360236,3,7,3.0,10,0.3
75362158,4,6,4.0,10,0.4
75390346,1,18,1.0,19,0.05263157894736842
75409824,4,4,4.0,8,0.5
75417473,1,18,1.0,19,0.05263157894736842
75439669,3,6,3.0,9,0.3333333333333333
75450425,1,19,1.0,20,0.05
75474120,2,7,2.0,9,0.2222222222222222
75484959,1,9,1.0,10,0.1
75494057,2,8,2.0,10,0.2
75501285,1,8,1.0,9,0.1111111111111111
75504761,1,9,1.0,10,0.1
75524075,2,7,2.0,9,0.2222222222222222
75553087,6,4,4.0,10,0.4
75565615,1,9,1.0,10,0.1
75567232,1,7,1.0,8,0.125
75567546,1,8,1.0,9,0.1111111111111111
75568854,2,8,2.0,10,0.2
75569576,3,5,3.0,8,0.375
75575566,2,8,2.0,10,0.2
75576074,2,8,2.0,10,0.2
75578604,3,6,3.0,9,0.3333333333333333
75596938,2,17,2.0,19,0.10526315789473684
75605221,1,9,1.0,10,0.1
75609195,8,2,2.0,10,0.2
75619373,1,9,1.0,10,0.1
75667516,5,5,5.0,10,0.5
75693808,4,6,4.0,10,0.4
75698281,1,8,1.0,9,0.1111111111111111
75705200,2,8,2.0,10,0.2
75708034,2,8,2.0,10,0.2
75710914,4,6,4.0,10,0.4
75714615,1,9,1.0,10,0.1
75738795,4,5,4.0,9,0.4444444444444444
75741135,1,7,1.0,8,0.125
75742361,3,25,3.0,28,0.10714285714285714
75752036,1,9,1.0,10,0.1
75783993,1,19,1.0,20,0.05
75791181,2,7,2.0,9,0.2222222222222222
75792095,5,4,4.0,9,0.4444444444444444
75793667,5,5,5.0,10,0.5
75795035,4,6,4.0,10,0.4
75800293,1,16,1.0,17,0.058823529411764705
75814862,6,4,4.0,10,0.4
75840347,1,8,1.0,9,0.1111111111111111
75843398,3,17,3.0,20,0.15
75865526,2,8,2.0,10,0.2
75872625,1,9,1.0,10,0.1
75924941,6,3,3.0,9,0.3333333333333333
75934667,3,7,3.0,10,0.3
75936446,2,17,2.0,19,0.10526315789473684
75940346,8,2,2.0,10,0.2
75944591,1,9,1.0,10,0.1
75948019,4,4,4.0,8,0.5
75964153,1,9,1.0,10,0.1
75970749,1,8,1.0,9,0.1111111111111111
75981522,8,1,1.0,9,0.1111111111111111
75996823,2,7,2.0,9,0.2222222222222222
75997649,3,7,3.0,10,0.3
75999697,2,17,2.0,19,0.10526315789473684
76006369,2,6,2.0,8,0.25
76043659,2,7,2.0,9,0.2222222222222222
76068724,1,9,1.0,10,0.1
76076690,1,7,1.0,8,0.125
76078919,1,9,1.0,10,0.1
76083152,1,8,1.0,9,0.1111111111111111
76085216,6,2,2.0,8,0.25
76089662,1,8,1.0,9,0.1111111111111111
76091864,3,6,3.0,9,0.3333333333333333
76102420,1,9,1.0,10,0.1
76103354,1,8,1.0,9,0.1111111111111111
76108533,1,9,1.0,10,0.1
76113282,1,8,1.0,9,0.1111111111111111
76115225,1,9,1.0,10,0.1
76136471,2,8,2.0,10,0.2
76156970,1,7,1.0,8,0.125
76160544,7,2,2.0,9,0.2222222222222222
76212691,4,6,4.0,10,0.4
76252619,1,8,1.0,9,0.1111111111111111
76255206,6,4,4.0,10,0.4
76261413,3,16,3.0,19,0.15789473684210525
76266127,1,8,1.0,9,0.1111111111111111
76271563,3,7,3.0,10,0.3
76274619,1,9,1.0,10,0.1
76276215,1,8,1.0,9,0.1111111111111111
76286261,1,9,1.0,10,0.1
76288876,2,8,2.0,10,0.2
76307353,3,7,3.0,10,0.3
76308697,5,4,4.0,9,0.4444444444444444
76309327,4,6,4.0,10,0.4
76310500,6,4,4.0,10,0.4
76317974,4,6,4.0,10,0.4
76318837,3,5,3.0,8,0.375
76327202,8,1,1.0,9,0.1111111111111111
76337035,2,8,2.0,10,0.2
76339003,3,7,3.0,10,0.3
76340087,6,3,3.0,9,0.3333333333333333
76341305,2,7,2.0,9,0.2222222222222222
76341369,1,18,1.0,19,0.05263157894736842
76342078,3,6,3.0,9,0.3333333333333333
76347088,3,6,3.0,9,0.3333333333333333
76353941,1,15,1.0,16,0.0625
76354411,2,7,2.0,9,0.2222222222222222
76360467,3,7,3.0,10,0.3
76361538,1,7,1.0,8,0.125
76364041,3,7,3.0,10,0.3
76366408,18,11,11.0,29,0.3793103448275862
76366759,5,5,5.0,10,0.5
76369066,5,14,5.0,19,0.2631578947368421
76390249,10,10,10.0,20,0.5
76392533,1,9,1.0,10,0.1
76412565,2,7,2.0,9,0.2222222222222222
76423275,5,4,4.0,9,0.4444444444444444
76425261,1,7,1.0,8,0.125
76483458,3,5,3.0,8,0.375
76487729,1,7,1.0,8,0.125
76498947,1,7,1.0,8,0.125
76499428,3,7,3.0,10,0.3
76522029,5,5,5.0,10,0.5
76526080,10,18,10.0,28,0.35714285714285715
76556581,2,7,2.0,9,0.2222222222222222
76558442,1,8,1.0,9,0.1111111111111111
76559052,4,25,4.0,29,0.13793103448275862
76562151,2,7,2.0,9,0.2222222222222222
76590044,9,1,1.0,10,0.1
76590095,1,9,1.0,10,0.1
76591458,6,3,3.0,9,0.3333333333333333
76591598,3,7,3.0,10,0.3
76592089,5,5,5.0,10,0.5
76597952,6,4,4.0,10,0.4
76599150,3,7,3.0,10,0.3
76643057,1,9,1.0,10,0.1
76643248,1,19,1.0,20,0.05
76677681,28,2,2.0,30,0.06666666666666667
76688422,2,8,2.0,10,0.2
76694634,1,17,1.0,18,0.05555555555555555
76696608,3,6,3.0,9,0.3333333333333333
76702700,4,5,4.0,9,0.4444444444444444
76706610,5,4,4.0,9,0.4444444444444444
76711415,3,26,3.0,29,0.10344827586206896
76715012,2,8,2.0,10,0.2
76723260,3,7,3.0,10,0.3
76724183,1,9,1.0,10,0.1
76749397,2,8,2.0,10,0.2
76772636,3,16,3.0,19,0.15789473684210525
76773360,1,9,1.0,10,0.1
76781971,1,7,1.0,8,0.125
76785868,7,3,3.0,10,0.3
76794434,11,17,11.0,28,0.39285714285714285
76797169,1,18,1.0,19,0.05263157894736842
76798416,1,8,1.0,9,0.1111111111111111
76804857,1,9,1.0,10,0.1
76818327,3,6,3.0,9,0.3333333333333333
76836153,2,8,2.0,10,0.2
76836211,1,19,1.0,20,0.05
76837428,3,6,3.0,9,0.3333333333333333
76861663,2,8,2.0,10,0.2
76879512,6,4,4.0,10,0.4
76882380,2,17,2.0,19,0.10526315789473684
76885144,1,9,1.0,10,0.1
76916872,1,9,1.0,10,0.1
76924774,4,6,4.0,10,0.4
76925313,5,5,5.0,10,0.5
76925610,3,6,3.0,9,0.3333333333333333
76929199,1,9,1.0,10,0.1
76938952,3,7,3.0,10,0.3
76951789,1,8,1.0,9,0.1111111111111111
76952669,8,1,1.0,9,0.1111111111111111
76953229,1,9,1.0,10,0.1
76969475,7,3,3.0,10,0.3
76979374,1,8,1.0,9,0.1111111111111111
76980276,1,18,1.0,19,0.05263157894736842
76990018,6,4,4.0,10,0.4
76994169,4,6,4.0,10,0.4
76997293,8,2,2.0,10,0.2
77005714,8,2,2.0,10,0.2
77026207,1,8,1.0,9,0.1111111111111111
77043865,1,9,1.0,10,0.1
77054024,4,6,4.0,10,0.4
77055032,2,8,2.0,10,0.2
77060540,2,7,2.0,9,0.2222222222222222
77063026,2,8,2.0,10,0.2
77066686,1,9,1.0,10,0.1
77076761,3,6,3.0,9,0.3333333333333333
77081858,1,8,1.0,9,0.1111111111111111
77093171,1,7,1.0,8,0.125
77093343,1,8,1.0,9,0.1111111111111111
77094747,6,13,6.0,19,0.3157894736842105
77106287,2,18,2.0,20,0.1
77108590,2,16,2.0,18,0.1111111111111111
77132899,1,8,1.0,9,0.1111111111111111
77134232,1,9,1.0,10,0.1
77141558,1,8,1.0,9,0.1111111111111111
77143844,2,8,2.0,10,0.2
77150869,7,13,7.0,20,0.35
77153747,3,7,3.0,10,0.3
77185588,1,19,1.0,20,0.05
77200409,4,6,4.0,10,0.4
77206700,22,6,6.0,28,0.21428571428571427
77219111,9,1,1.0,10,0.1
77221670,4,6,4.0,10,0.4
77222801,9,1,1.0,10,0.1
77233873,1,8,1.0,9,0.1111111111111111
77234905,4,25,4.0,29,0.13793103448275862
77242624,1,9,1.0,10,0.1
77245702,1,9,1.0,10,0.1
77247246,1,8,1.0,9,0.1111111111111111
77281801,7,2,2.0,9,0.2222222222222222
77291988,6,4,4.0,10,0.4
77292065,6,4,4.0,10,0.4
77292321,4,5,4.0,9,0.4444444444444444
77292980,3,7,3.0,10,0.3
77297543,18,11,11.0,29,0.3793103448275862
77305613,2,8,2.0,10,0.2
77312896,1,9,1.0,10,0.1
77320180,5,5,5.0,10,0.5
77320317,8,1,1.0,9,0.1111111111111111
77346536,1,9,1.0,10,0.1
77349154,1,19,1.0,20,0.05
77355092,2,8,2.0,10,0.2
77372021,4,5,4.0,9,0.4444444444444444
77375202,1,8,1.0,9,0.1111111111111111
77390178,1,29,1.0,30,0.03333333333333333
77390503,2,8,2.0,10,0.2
77392393,2,6,2.0,8,0.25
77407248,2,17,2.0,19,0.10526315789473684
77418318,4,6,4.0,10,0.4
77430475,1,7,1.0,8,0.125
77438854,1,8,1.0,9,0.1111111111111111
77450729,3,7,3.0,10,0.3
77460601,8,2,2.0,10,0.2
77460672,9,19,9.0,28,0.32142857142857145
77467986,4,5,4.0,9,0.4444444444444444
77470116,2,8,2.0,10,0.2
77475014,1,9,1.0,10,0.1
77481828,5,4,4.0,9,0.4444444444444444
77502439,1,18,1.0,19,0.05263157894736842
77556993,2,18,2.0,20,0.1
77568186,22,8,8.0,30,0.26666666666666666
77568780,7,2,2.0,9,0.2222222222222222
77576171,5,5,5.0,10,0.5
77578161,4,4,4.0,8,0.5
77582346,2,7,2.0,9,0.2222222222222222
77591465,2,8,2.0,10,0.2
77613069,9,15,9.0,24,0.375
77628665,5,5,5.0,10,0.5
77629215,3,7,3.0,10,0.3
77633943,9,1,1.0,10,0.1
77635804,9,1,1.0,10,0.1
77656102,3,6,3.0,9,0.3333333333333333
77659413,12,7,7.0,19,0.3684210526315789
77668280,3,7,3.0,10,0.3
77683580,1,9,1.0,10,0.1
77715214,2,6,2.0,8,0.25
77723093,7,2,2.0,9,0.2222222222222222
77739252,3,7,3.0,10,0.3
77739834,2,18,2.0,20,0.1
77741517,1,18,1.0,19,0.05263157894736842
77746578,3,6,3.0,9,0.3333333333333333
77746956,1,17,1.0,18,0.05555555555555555
77747185,1,9,1.0,10,0.1
77747351,6,4,4.0,10,0.4
77747852,2,17,2.0,19,0.10526315789473684
77749003,1,9,1.0,10,0.1
77753631,1,7,1.0,8,0.125
77785582,8,2,2.0,10,0.2
77803201,5,4,4.0,9,0.4444444444444444
77805499,4,5,4.0,9,0.4444444444444444
77805562,8,1,1.0,9,0.1111111111111111
77816733,1,17,1.0,18,0.05555555555555555
77817747,4,6,4.0,10,0.4
77829273,2,8,2.0,10,0.2
77831221,1,18,1.0,19,0.05263157894736842
77839091,9,1,1.0,10,0.1
77846828,1,8,1.0,9,0.1111111111111111
77852958,5,5,5.0,10,0.5
77856710,1,9,1.0,10,0.1
77867392,1,19,1.0,20,0.05
77869825,1,18,1.0,19,0.05263157894736842
77890446,2,7,2.0,9,0.2222222222222222
77901390,3,7,3.0,10,0.3
77907449,2,7,2.0,9,0.2222222222222222
77911653,5,4,4.0,9,0.4444444444444444
77931559,1,9,1.0,10,0.1
77936742,6,14,6.0,20,0.3
77937124,1,8,1.0,9,0.1111111111111111
77958182,3,7,3.0,10,0.3
77958321,4,4,4.0,8,0.5
77967034,6,12,6.0,18,0.3333333333333333
77969406,8,1,1.0,9,0.1111111111111111
77978124,6,12,6.0,18,0.3333333333333333
78010758,3,15,3.0,18,0.16666666666666666
78017966,7,2,2.0,9,0.2222222222222222
78020266,2,8,2.0,10,0.2
78021816,4,6,4.0,10,0.4
78026551,2,7,2.0,9,0.2222222222222222
78031236,1,7,1.0,8,0.125
78066038,1,19,1.0,20,0.05
78073533,2,6,2.0,8,0.25
78074242,3,6,3.0,9,0.3333333333333333
78074431,9,1,1.0,10,0.1
78074566,7,2,2.0,9,0.2222222222222222
78075450,9,1,1.0,10,0.1
78075632,2,17,2.0,19,0.10526315789473684
78076265,3,7,3.0,10,0.3
78097171,5,5,5.0,10,0.5
78100740,8,2,2.0,10,0.2
78103363,1,8,1.0,9,0.1111111111111111
78103650,7,2,2.0,9,0.2222222222222222
78111309,8,2,2.0,10,0.2
78120227,2,8,2.0,10,0.2
78120233,1,9,1.0,10,0.1
78125921,6,3,3.0,9,0.3333333333333333
78138215,3,7,3.0,10,0.3
78139677,3,6,3.0,9,0.3333333333333333
78140154,4,16,4.0,20,0.2
78141116,1,9,1.0,10,0.1
78144803,28,2,2.0,30,0.06666666666666667
78156547,2,8,2.0,10,0.2
78164008,9,18,9.0,27,0.3333333333333333
78165816,1,9,1.0,10,0.1
78166527,5,5,5.0,10,0.5
78169641,4,6,4.0,10,0.4
78170371,9,1,1.0,10,0.1
78171666,1,8,1.0,9,0.1111111111111111
78174944,3,5,3.0,8,0.375
78175705,3,7,3.0,10,0.3
78177640,3,6,3.0,9,0.3333333333333333
78186190,1,8,1.0,9,0.1111111111111111
78187378,3,17,3.0,20,0.15
78200358,1,9,1.0,10,0.1
78211738,2,18,2.0,20,0.1
78215693,3,5,3.0,8,0.375
78220434,4,4,4.0,8,0.5
78221023,1,25,1.0,26,0.038461538461538464
78221169,3,6,3.0,9,0.3333333333333333
78221920,6,3,3.0,9,0.3333333333333333
78241250,1,9,1.0,10,0.1
78245323,4,15,4.0,19,0.21052631578947367
78246712,2,18,2.0,20,0.1
78268047,1,18,1.0,19,0.05263157894736842
78277321,1,9,1.0,10,0.1
78308018,1,9,1.0,10,0.1
78309297,1,8,1.0,9,0.1111111111111111
78327714,4,5,4.0,9,0.4444444444444444
78368694,2,7,2.0,9,0.2222222222222222
78392686,2,8,2.0,10,0.2
78440946,1,19,1.0,20,0.05
78441074,1,7,1.0,8,0.125
78444811,2,17,2.0,19,0.10526315789473684
78457594,1,8,1.0,9,0.1111111111111111
78480281,1,18,1.0,19,0.05263157894736842
78480532,24,5,5.0,29,0.1724137931034483
78481172,1,7,1.0,8,0.125
78481408,6,4,4.0,10,0.4
78508334,3,17,3.0,20,0.15
78528038,1,9,1.0,10,0.1
78540636,3,6,3.0,9,0.3333333333333333
78544802,9,1,1.0,10,0.1
78546165,9,1,1.0,10,0.1
78547130,6,2,2.0,8,0.25
78560935,2,8,2.0,10,0.2
78563293,5,5,5.0,10,0.5
78565399,7,3,3.0,10,0.3
78565418,7,3,3.0,10,0.3
78600847,2,7,2.0,9,0.2222222222222222
78617979,4,5,4.0,9,0.4444444444444444
78620885,1,19,1.0,20,0.05
78623678,1,18,1.0,19,0.05263157894736842
78650804,7,21,7.0,28,0.25
78695321,1,16,1.0,17,0.058823529411764705
78697596,2,16,2.0,18,0.1111111111111111
78752547,2,7,2.0,9,0.2222222222222222
78762316,2,7,2.0,9,0.2222222222222222
78782251,1,8,1.0,9,0.1111111111111111
78788589,5,5,5.0,10,0.5
78831994,8,2,2.0,10,0.2
78832027,21,7,7.0,28,0.25
78833549,7,3,3.0,10,0.3
78835429,17,3,3.0,20,0.15
78858672,2,8,2.0,10,0.2
78865893,1,8,1.0,9,0.1111111111111111
78877150,1,8,1.0,9,0.1111111111111111
78881218,5,3,3.0,8,0.375
78881416,2,7,2.0,9,0.2222222222222222
78882279,2,8,2.0,10,0.2
78882658,2,7,2.0,9,0.2222222222222222
78883120,6,4,4.0,10,0.4
78885325,1,8,1.0,9,0.1111111111111111
78890588,3,14,3.0,17,0.17647058823529413
78893151,6,3,3.0,9,0.3333333333333333
78920941,1,9,1.0,10,0.1
78926846,1,9,1.0,10,0.1
78927311,1,7,1.0,8,0.125
78934767,6,3,3.0,9,0.3333333333333333
78935913,5,5,5.0,10,0.5
78948944,2,8,2.0,10,0.2
78949270,3,6,3.0,9,0.3333333333333333
78959971,1,8,1.0,9,0.1111111111111111
78976816,1,9,1.0,10,0.1
78995737,5,13,5.0,18,0.2777777777777778
79001287,1,8,1.0,9,0.1111111111111111
79014905,3,7,3.0,10,0.3
79016311,4,6,4.0,10,0.4
79020084,1,9,1.0,10,0.1
79032312,1,18,1.0,19,0.05263157894736842
79033072,3,7,3.0,10,0.3
79054827,3,7,3.0,10,0.3
79061790,2,7,2.0,9,0.2222222222222222
79066173,1,7,1.0,8,0.125
79071354,1,9,1.0,10,0.1
79104476,2,7,2.0,9,0.2222222222222222
79114710,6,2,2.0,8,0.25
79129151,3,7,3.0,10,0.3
79144427,1,9,1.0,10,0.1
79162276,4,4,4.0,8,0.5
79165873,3,7,3.0,10,0.3
79178692,1,18,1.0,19,0.05263157894736842
79190330,3,7,3.0,10,0.3
79220735,1,7,1.0,8,0.125
79234858,2,16,2.0,18,0.1111111111111111
79244837,7,2,2.0,9,0.2222222222222222
79257625,1,8,1.0,9,0.1111111111111111
79274514,1,9,1.0,10,0.1
79276798,4,6,4.0,10,0.4
79277436,4,6,4.0,10,0.4
79279079,3,7,3.0,10,0.3
79297360,1,15,1.0,16,0.0625
79299323,2,7,2.0,9,0.2222222222222222
79307128,1,9,1.0,10,0.1
79311527,2,17,2.0,19,0.10526315789473684
79312437,2,7,2.0,9,0.2222222222222222
79313810,1,9,1.0,10,0.1
79314236,8,2,2.0,10,0.2
79327965,2,8,2.0,10,0.2
79328094,1,28,1.0,29,0.034482758620689655
79334798,4,5,4.0,9,0.4444444444444444
79351547,5,25,5.0,30,0.16666666666666666
79352097,2,8,2.0,10,0.2
79359653,1,8,1.0,9,0.1111111111111111
79376154,4,5,4.0,9,0.4444444444444444
79391710,3,16,3.0,19,0.15789473684210525
79397446,2,8,2.0,10,0.2
79403111,5,5,5.0,10,0.5
79404541,2,8,2.0,10,0.2
79436450,1,8,1.0,9,0.1111111111111111
79440318,1,9,1.0,10,0.1
79454260,3,7,3.0,10,0.3
79454549,1,9,1.0,10,0.1
79454746,2,24,2.0,26,0.07692307692307693
79455084,2,8,2.0,10,0.2
79457321,1,8,1.0,9,0.1111111111111111
79464807,6,4,4.0,10,0.4
79465474,5,5,5.0,10,0.5
79466669,6,3,3.0,9,0.3333333333333333
79472379,1,8,1.0,9,0.1111111111111111
79473060,2,17,2.0,19,0.10526315789473684
79474457,1,8,1.0,9,0.1111111111111111
79480417,2,7,2.0,9,0.2222222222222222
79483264,2,7,2.0,9,0.2222222222222222
79493819,7,1,1.0,8,0.125
79498951,7,3,3.0,10,0.3
79525357,1,9,1.0,10,0.1
79529042,2,8,2.0,10,0.2
79533390,2,8,2.0,10,0.2
79534699,1,9,1.0,10,0.1
79542893,2,7,2.0,9,0.2222222222222222
79554847,2,16,2.0,18,0.1111111111111111
79580781,1,8,1.0,9,0.1111111111111111
79582915,2,18,2.0,20,0.1
79584130,7,2,2.0,9,0.2222222222222222
79584747,2,8,2.0,10,0.2
79587909,1,8,1.0,9,0.1111111111111111
79644076,1,9,1.0,10,0.1
79644997,4,6,4.0,10,0.4
79646741,8,1,1.0,9,0.1111111111111111
79646903,17,1,1.0,18,0.05555555555555555
79658372,1,9,1.0,10,0.1
79663802,4,16,4.0,20,0.2
79708022,1,9,1.0,10,0.1
79714156,1,8,1.0,9,0.1111111111111111
79714503,2,8,2.0,10,0.2
79739316,2,8,2.0,10,0.2
79745785,4,16,4.0,20,0.2
79755244,3,7,3.0,10,0.3
79758979,8,2,2.0,10,0.2
79759783,2,7,2.0,9,0.2222222222222222
79760307,4,5,4.0,9,0.4444444444444444
79760321,1,8,1.0,9,0.1111111111111111
79761343,1,9,1.0,10,0.1
79772928,7,3,3.0,10,0.3
79807234,1,7,1.0,8,0.125
79828226,1,8,1.0,9,0.1111111111111111
79883437,1,8,1.0,9,0.1111111111111111
79913901,2,16,2.0,18,0.1111111111111111
79930455,6,4,4.0,10,0.4
79949727,2,8,2.0,10,0.2
79976672,4,5,4.0,9,0.4444444444444444
80001950,1,18,1.0,19,0.05263157894736842
80006294,3,7,3.0,10,0.3
80006602,1,25,1.0,26,0.038461538461538464
80006955,1,8,1.0,9,0.1111111111111111
80007134,2,7,2.0,9,0.2222222222222222
80009035,2,7,2.0,9,0.2222222222222222
80020898,9,1,1.0,10,0.1
80044088,2,8,2.0,10,0.2
80045853,1,29,1.0,30,0.03333333333333333
80048769,6,4,4.0,10,0.4
80050704,1,9,1.0,10,0.1
80061088,9,1,1.0,10,0.1
80062325,1,8,1.0,9,0.1111111111111111
80084315,1,8,1.0,9,0.1111111111111111
80104836,2,6,2.0,8,0.25
80117452,1,9,1.0,10,0.1
80161715,8,1,1.0,9,0.1111111111111111
80194209,4,12,4.0,16,0.25
80197417,2,7,2.0,9,0.2222222222222222
80204600,1,8,1.0,9,0.1111111111111111
80207412,4,6,4.0,10,0.4
80228380,5,4,4.0,9,0.4444444444444444
80228563,8,1,1.0,9,0.1111111111111111
80229304,25,1,1.0,26,0.038461538461538464
80239579,2,18,2.0,20,0.1
80258632,3,7,3.0,10,0.3
80283092,1,9,1.0,10,0.1
80293190,1,8,1.0,9,0.1111111111111111
80317771,1,9,1.0,10,0.1
80333328,2,7,2.0,9,0.2222222222222222
80355140,25,3,3.0,28,0.10714285714285714
80360242,1,7,1.0,8,0.125
80362215,1,16,1.0,17,0.058823529411764705
80370761,8,10,8.0,18,0.4444444444444444
80435742,6,4,4.0,10,0.4
80436828,1,9,1.0,10,0.1
80457773,1,9,1.0,10,0.1
80463997,1,9,1.0,10,0.1
80481470,1,8,1.0,9,0.1111111111111111
80517074,4,15,4.0,19,0.21052631578947367
80518002,3,17,3.0,20,0.15
80553745,1,9,1.0,10,0.1
80561170,1,9,1.0,10,0.1
80599642,1,19,1.0,20,0.05
80620149,3,16,3.0,19,0.15789473684210525
80650337,1,9,1.0,10,0.1
80671160,6,10,6.0,16,0.375
80672085,6,14,6.0,20,0.3
80680148,16,10,10.0,26,0.38461538461538464
80684633,7,3,3.0,10,0.3
80716705,1,8,1.0,9,0.1111111111111111
80719470,1,8,1.0,9,0.1111111111111111
80727396,1,9,1.0,10,0.1
80736753,1,8,1.0,9,0.1111111111111111
80739658,1,19,1.0,20,0.05
80747349,1,9,1.0,10,0.1
80772370,1,9,1.0,10,0.1
80781643,1,9,1.0,10,0.1
80785784,4,5,4.0,9,0.4444444444444444
80786623,2,8,2.0,10,0.2
80804138,1,9,1.0,10,0.1
80836029,1,9,1.0,10,0.1
80839259,3,7,3.0,10,0.3
80845844,1,9,1.0,10,0.1
80848849,1,8,1.0,9,0.1111111111111111
80850584,1,8,1.0,9,0.1111111111111111
80851146,8,1,1.0,9,0.1111111111111111
80854887,3,14,3.0,17,0.17647058823529413
80872267,1,9,1.0,10,0.1
80887037,3,7,3.0,10,0.3
80887215,1,7,1.0,8,0.125
80913439,6,3,3.0,9,0.3333333333333333
80919517,3,7,3.0,10,0.3
80936018,9,1,1.0,10,0.1
80937953,4,6,4.0,10,0.4
80938485,5,4,4.0,9,0.4444444444444444
80938710,22,6,6.0,28,0.21428571428571427
80939266,1,8,1.0,9,0.1111111111111111
80984084,3,7,3.0,10,0.3
80988354,7,22,7.0,29,0.2413793103448276
80990347,2,17,2.0,19,0.10526315789473684
80993111,1,8,1.0,9,0.1111111111111111
80993865,1,8,1.0,9,0.1111111111111111
80994138,1,7,1.0,8,0.125
81011452,3,7,3.0,10,0.3
81023927,1,8,1.0,9,0.1111111111111111
81037804,7,3,3.0,10,0.3
81056735,3,7,3.0,10,0.3
81064296,2,7,2.0,9,0.2222222222222222
81064569,3,7,3.0,10,0.3
81068632,7,3,3.0,10,0.3
81069671,1,28,1.0,29,0.034482758620689655
81079908,1,9,1.0,10,0.1
81092174,2,28,2.0,30,0.06666666666666667
81103268,2,17,2.0,19,0.10526315789473684
81106716,3,7,3.0,10,0.3
81120381,1,9,1.0,10,0.1
81131351,3,5,3.0,8,0.375
81136888,1,29,1.0,30,0.03333333333333333
81145288,6,4,4.0,10,0.4
81163874,5,5,5.0,10,0.5
81163970,9,1,1.0,10,0.1
81164915,3,6,3.0,9,0.3333333333333333
81165528,8,2,2.0,10,0.2
81165585,8,2,2.0,10,0.2
81165832,7,3,3.0,10,0.3
81170837,1,8,1.0,9,0.1111111111111111
81173784,2,8,2.0,10,0.2
81182503,2,8,2.0,10,0.2
81183887,2,8,2.0,10,0.2
81194811,1,9,1.0,10,0.1
81206269,1,9,1.0,10,0.1
81209275,1,7,1.0,8,0.125
81209503,3,6,3.0,9,0.3333333333333333
81210731,5,4,4.0,9,0.4444444444444444
81214647,4,6,4.0,10,0.4
81240299,5,5,5.0,10,0.5
81244340,3,6,3.0,9,0.3333333333333333
81253135,8,2,2.0,10,0.2
81260153,1,29,1.0,30,0.03333333333333333
81262233,1,8,1.0,9,0.1111111111111111
81278349,3,7,3.0,10,0.3
81305739,1,9,1.0,10,0.1
81307130,1,8,1.0,9,0.1111111111111111
81311636,1,7,1.0,8,0.125
81314680,1,8,1.0,9,0.1111111111111111
81330121,1,7,1.0,8,0.125
81332765,1,7,1.0,8,0.125
81332969,2,7,2.0,9,0.2222222222222222
81341953,2,27,2.0,29,0.06896551724137931
81342295,1,8,1.0,9,0.1111111111111111
81359866,1,17,1.0,18,0.05555555555555555
81363750,3,16,3.0,19,0.15789473684210525
81378970,2,8,2.0,10,0.2
81379456,1,9,1.0,10,0.1
81380506,1,9,1.0,10,0.1
81387865,2,7,2.0,9,0.2222222222222222
81417506,3,7,3.0,10,0.3
81434557,3,7,3.0,10,0.3
81434656,4,5,4.0,9,0.4444444444444444
81434821,2,7,2.0,9,0.2222222222222222
81434907,3,6,3.0,9,0.3333333333333333
81454320,1,9,1.0,10,0.1
81464463,1,17,1.0,18,0.05555555555555555
81465759,3,7,3.0,10,0.3
81473693,8,1,1.0,9,0.1111111111111111
81475888,3,7,3.0,10,0.3
81484588,2,8,2.0,10,0.2
81496281,5,5,5.0,10,0.5
81496516,2,7,2.0,9,0.2222222222222222
81496673,1,9,1.0,10,0.1
81498870,2,8,2.0,10,0.2
81499432,2,18,2.0,20,0.1
81500733,3,16,3.0,19,0.15789473684210525
81501231,27,2,2.0,29,0.06896551724137931
81505457,8,2,2.0,10,0.2
81508782,1,19,1.0,20,0.05
81518295,2,7,2.0,9,0.2222222222222222
81526707,1,9,1.0,10,0.1
81531657,3,5,3.0,8,0.375
81550838,2,8,2.0,10,0.2
81553806,1,9,1.0,10,0.1
81569064,7,3,3.0,10,0.3
81594640,1,9,1.0,10,0.1
81601099,1,18,1.0,19,0.05263157894736842
81613602,7,3,3.0,10,0.3
81632031,1,18,1.0,19,0.05263157894736842
81641070,2,27,2.0,29,0.06896551724137931
81641394,1,8,1.0,9,0.1111111111111111
81645078,4,5,4.0,9,0.4444444444444444
81662591,5,5,5.0,10,0.5
81682808,1,18,1.0,19,0.05263157894736842
81687218,1,9,1.0,10,0.1
81722697,3,16,3.0,19,0.15789473684210525
81728541,1,9,1.0,10,0.1
81738065,2,8,2.0,10,0.2
81739491,9,1,1.0,10,0.1
81740717,5,5,5.0,10,0.5
81741827,5,5,5.0,10,0.5
81757317,2,8,2.0,10,0.2
81788798,1,8,1.0,9,0.1111111111111111
81791839,1,19,1.0,20,0.05
81792637,3,7,3.0,10,0.3
81792964,1,8,1.0,9,0.1111111111111111
81801025,3,7,3.0,10,0.3
81803453,4,6,4.0,10,0.4
81807795,2,7,2.0,9,0.2222222222222222
81814980,1,8,1.0,9,0.1111111111111111
81820168,3,7,3.0,10,0.3
81827541,4,6,4.0,10,0.4
81827688,1,8,1.0,9,0.1111111111111111
81827951,3,7,3.0,10,0.3
81829097,1,26,1.0,27,0.037037037037037035
81846670,4,6,4.0,10,0.4
81847232,2,8,2.0,10,0.2
81848169,2,8,2.0,10,0.2
81858030,4,6,4.0,10,0.4
81866687,2,8,2.0,10,0.2
81891428,1,9,1.0,10,0.1
81919481,8,1,1.0,9,0.1111111111111111
81919848,1,9,1.0,10,0.1
81920622,8,2,2.0,10,0.2
81928707,8,2,2.0,10,0.2
81930242,2,17,2.0,19,0.10526315789473684
81939343,1,9,1.0,10,0.1
81940495,1,8,1.0,9,0.1111111111111111
81948270,4,6,4.0,10,0.4
81958826,1,9,1.0,10,0.1
81959230,1,9,1.0,10,0.1
81960961,4,5,4.0,9,0.4444444444444444
81987508,3,6,3.0,9,0.3333333333333333
82021484,4,6,4.0,10,0.4
82033464,1,9,1.0,10,0.1
82035508,7,3,3.0,10,0.3
82058401,13,6,6.0,19,0.3157894736842105
82062455,1,17,1.0,18,0.05555555555555555
82073166,1,9,1.0,10,0.1
82111405,2,7,2.0,9,0.2222222222222222
82115666,1,7,1.0,8,0.125
82159840,2,16,2.0,18,0.1111111111111111
82171454,4,6,4.0,10,0.4
82178389,9,1,1.0,10,0.1
82179061,2,15,2.0,17,0.11764705882352941
82196928,1,9,1.0,10,0.1
82206056,1,7,1.0,8,0.125
82206310,2,8,2.0,10,0.2
82206755,25,4,4.0,29,0.13793103448275862
82207236,6,4,4.0,10,0.4
82227646,2,8,2.0,10,0.2
82232105,1,7,1.0,8,0.125
82239000,1,7,1.0,8,0.125
82241779,6,4,4.0,10,0.4
82243101,2,7,2.0,9,0.2222222222222222
82254328,9,1,1.0,10,0.1
82271517,5,5,5.0,10,0.5
82272118,1,17,1.0,18,0.05555555555555555
82277758,3,7,3.0,10,0.3
82281521,5,24,5.0,29,0.1724137931034483
82282751,1,8,1.0,9,0.1111111111111111
82283826,6,4,4.0,10,0.4
82284742,2,8,2.0,10,0.2
82288427,1,18,1.0,19,0.05263157894736842
82289098,1,9,1.0,10,0.1
82328804,2,8,2.0,10,0.2
82364924,7,3,3.0,10,0.3
82372307,1,9,1.0,10,0.1
82393874,6,4,4.0,10,0.4
82402357,4,6,4.0,10,0.4
82402529,3,7,3.0,10,0.3
82404788,9,1,1.0,10,0.1
82414014,1,19,1.0,20,0.05
82423735,4,5,4.0,9,0.4444444444444444
82423877,2,8,2.0,10,0.2
82439940,1,9,1.0,10,0.1
82454454,2,7,2.0,9,0.2222222222222222
82467972,8,2,2.0,10,0.2
82470121,2,6,2.0,8,0.25
82487557,3,7,3.0,10,0.3
82502974,1,9,1.0,10,0.1
82522305,1,9,1.0,10,0.1
82523289,5,5,5.0,10,0.5
82524118,17,11,11.0,28,0.39285714285714285
82524915,3,7,3.0,10,0.3
82529352,1,19,1.0,20,0.05
82538737,1,17,1.0,18,0.05555555555555555
82544570,7,3,3.0,10,0.3
82546889,1,9,1.0,10,0.1
82553713,2,18,2.0,20,0.1
82560404,3,5,3.0,8,0.375
82566358,1,8,1.0,9,0.1111111111111111
82573743,1,26,1.0,27,0.037037037037037035
82573758,1,9,1.0,10,0.1
82575316,1,9,1.0,10,0.1
82577905,1,9,1.0,10,0.1
82578129,1,7,1.0,8,0.125
82579083,1,8,1.0,9,0.1111111111111111
82591142,2,7,2.0,9,0.2222222222222222
82592088,1,9,1.0,10,0.1
82594539,1,8,1.0,9,0.1111111111111111
82603639,21,8,8.0,29,0.27586206896551724
82604282,27,1,1.0,28,0.03571428571428571
82611377,2,8,2.0,10,0.2
82617255,1,9,1.0,10,0.1
82622836,1,8,1.0,9,0.1111111111111111
82626576,1,7,1.0,8,0.125
82631307,1,9,1.0,10,0.1
82649104,9,1,1.0,10,0.1
82655539,2,8,2.0,10,0.2
82659766,1,18,1.0,19,0.05263157894736842
82663816,7,3,3.0,10,0.3
82664675,1,9,1.0,10,0.1
82665178,2,26,2.0,28,0.07142857142857142
82668138,8,1,1.0,9,0.1111111111111111
82679546,3,15,3.0,18,0.16666666666666666
82681721,7,3,3.0,10,0.3
82689959,3,7,3.0,10,0.3
82707209,1,28,1.0,29,0.034482758620689655
82740463,1,9,1.0,10,0.1
82747045,1,8,1.0,9,0.1111111111111111
82761792,3,6,3.0,9,0.3333333333333333
82772124,1,16,1.0,17,0.058823529411764705
82775631,1,8,1.0,9,0.1111111111111111
82779784,3,7,3.0,10,0.3
82780633,6,3,3.0,9,0.3333333333333333
82782049,6,4,4.0,10,0.4
82783898,2,8,2.0,10,0.2
82784222,5,5,5.0,10,0.5
82784658,3,7,3.0,10,0.3
82784750,1,9,1.0,10,0.1
82788079,1,9,1.0,10,0.1
82810648,3,17,3.0,20,0.15
82834286,7,3,3.0,10,0.3
82845917,2,17,2.0,19,0.10526315789473684
82856473,1,9,1.0,10,0.1
82878309,1,8,1.0,9,0.1111111111111111
82881335,1,9,1.0,10,0.1
82886500,1,8,1.0,9,0.1111111111111111
82889941,2,7,2.0,9,0.2222222222222222
82889973,3,7,3.0,10,0.3
82903484,1,8,1.0,9,0.1111111111111111
82909172,2,7,2.0,9,0.2222222222222222
82909603,3,16,3.0,19,0.15789473684210525
82911381,2,8,2.0,10,0.2
82917399,12,8,8.0,20,0.4
82922721,2,18,2.0,20,0.1
82923281,2,7,2.0,9,0.2222222222222222
82923611,2,17,2.0,19,0.10526315789473684
82924521,1,18,1.0,19,0.05263157894736842
82948895,5,3,3.0,8,0.375
82954519,4,6,4.0,10,0.4
82954576,6,3,3.0,9,0.3333333333333333
82973496,1,9,1.0,10,0.1
82995905,1,8,1.0,9,0.1111111111111111
83031309,1,9,1.0,10,0.1
83034282,1,9,1.0,10,0.1
83034917,8,1,1.0,9,0.1111111111111111
83035677,8,2,2.0,10,0.2
83041900,2,8,2.0,10,0.2
83048931,1,17,1.0,18,0.05555555555555555
83059559,1,19,1.0,20,0.05
83066398,1,18,1.0,19,0.05263157894736842
83066705,2,8,2.0,10,0.2
83068040,1,9,1.0,10,0.1
83068897,1,8,1.0,9,0.1111111111111111
83080888,6,3,3.0,9,0.3333333333333333
83081472,2,8,2.0,10,0.2
83082099,1,19,1.0,20,0.05
83083984,1,9,1.0,10,0.1
83100899,3,7,3.0,10,0.3
83112408,2,8,2.0,10,0.2
83119300,1,18,1.0,19,0.05263157894736842
83119583,2,8,2.0,10,0.2
83119924,3,7,3.0,10,0.3
83128999,8,22,8.0,30,0.26666666666666666
83130355,3,7,3.0,10,0.3
83130714,1,8,1.0,9,0.1111111111111111
83131889,6,4,4.0,10,0.4
83137752,5,5,5.0,10,0.5
83139973,2,17,2.0,19,0.10526315789473684
83184350,1,9,1.0,10,0.1
83185440,3,7,3.0,10,0.3
83185602,9,1,1.0,10,0.1
83191763,2,8,2.0,10,0.2
83268988,1,8,1.0,9,0.1111111111111111
83274579,5,5,5.0,10,0.5
83291107,4,15,4.0,19,0.21052631578947367
83325556,5,4,4.0,9,0.4444444444444444
83334891,7,3,3.0,10,0.3
83339326,3,6,3.0,9,0.3333333333333333
83339600,23,4,4.0,27,0.14814814814814814
83340044,2,8,2.0,10,0.2
83340677,5,5,5.0,10,0.5
83340972,6,3,3.0,9,0.3333333333333333
83341599,7,3,3.0,10,0.3
83344029,1,8,1.0,9,0.1111111111111111
83345297,1,8,1.0,9,0.1111111111111111
83346683,3,7,3.0,10,0.3
83352533,2,6,2.0,8,0.25
83352779,4,6,4.0,10,0.4
83352864,4,4,4.0,8,0.5
83375139,6,4,4.0,10,0.4
83386623,10,9,9.0,19,0.47368421052631576
83392809,3,7,3.0,10,0.3
83395607,3,7,3.0,10,0.3
83396512,1,8,1.0,9,0.1111111111111111
83401799,3,7,3.0,10,0.3
83426020,2,7,2.0,9,0.2222222222222222
83428474,1,9,1.0,10,0.1
83430375,6,22,6.0,28,0.21428571428571427
83431964,5,14,5.0,19,0.2631578947368421
83433910,2,7,2.0,9,0.2222222222222222
83435694,4,6,4.0,10,0.4
83437745,4,6,4.0,10,0.4
83440527,1,9,1.0,10,0.1
83451632,5,4,4.0,9,0.4444444444444444
83453586,1,9,1.0,10,0.1
83487368,1,9,1.0,10,0.1
83497005,2,18,2.0,20,0.1
83499575,2,8,2.0,10,0.2
83503486,5,5,5.0,10,0.5
83504180,3,7,3.0,10,0.3
83504539,1,9,1.0,10,0.1
83521374,5,5,5.0,10,0.5
83522940,2,8,2.0,10,0.2
83526027,1,9,1.0,10,0.1
83534514,10,18,10.0,28,0.35714285714285715
83536228,1,9,1.0,10,0.1
83553887,1,7,1.0,8,0.125
83562850,2,8,2.0,10,0.2
83567287,2,17,2.0,19,0.10526315789473684
83581922,1,9,1.0,10,0.1
83589190,4,15,4.0,19,0.21052631578947367
83589318,3,7,3.0,10,0.3
83589947,2,8,2.0,10,0.2
83591367,2,7,2.0,9,0.2222222222222222
83591996,3,6,3.0,9,0.3333333333333333
83593579,1,8,1.0,9,0.1111111111111111
83594397,1,9,1.0,10,0.1
83610564,9,9,9.0,18,0.5
83610790,2,7,2.0,9,0.2222222222222222
83621356,1,8,1.0,9,0.1111111111111111
83634950,2,15,2.0,17,0.11764705882352941
83639675,3,17,3.0,20,0.15
83643549,5,4,4.0,9,0.4444444444444444
83656262,2,18,2.0,20,0.1
83660650,2,7,2.0,9,0.2222222222222222
83661660,6,4,4.0,10,0.4
83662214,22,5,5.0,27,0.18518518518518517
83664011,1,9,1.0,10,0.1
83677838,3,6,3.0,9,0.3333333333333333
83678337,2,8,2.0,10,0.2
83680328,2,8,2.0,10,0.2
83681742,4,6,4.0,10,0.4
83683269,28,1,1.0,29,0.034482758620689655
83714566,2,16,2.0,18,0.1111111111111111
83717388,3,15,3.0,18,0.16666666666666666
83724605,2,17,2.0,19,0.10526315789473684
83730614,3,16,3.0,19,0.15789473684210525
83738496,2,7,2.0,9,0.2222222222222222
83762762,1,9,1.0,10,0.1
83782159,3,15,3.0,18,0.16666666666666666
83788066,1,17,1.0,18,0.05555555555555555
83798638,5,5,5.0,10,0.5
83799208,3,7,3.0,10,0.3
83799741,1,9,1.0,10,0.1
83800026,15,13,13.0,28,0.4642857142857143
83800134,3,25,3.0,28,0.10714285714285714
83800701,8,2,2.0,10,0.2
83801418,5,13,5.0,18,0.2777777777777778
83805285,1,19,1.0,20,0.05
83808602,1,9,1.0,10,0.1
83812753,1,7,1.0,8,0.125
83815898,8,1,1.0,9,0.1111111111111111
83816002,9,1,1.0,10,0.1
83816243,2,7,2.0,9,0.2222222222222222
83816405,1,9,1.0,10,0.1
83817304,8,1,1.0,9,0.1111111111111111
83817385,6,3,3.0,9,0.3333333333333333
83818775,5,4,4.0,9,0.4444444444444444
83821817,6,4,4.0,10,0.4
83822188,17,2,2.0,19,0.10526315789473684
83823600,3,7,3.0,10,0.3
83824094,1,8,1.0,9,0.1111111111111111
83824583,9,1,1.0,10,0.1
83866158,1,17,1.0,18,0.05555555555555555
83876977,8,1,1.0,9,0.1111111111111111
83891467,8,18,8.0,26,0.3076923076923077
83891716,2,8,2.0,10,0.2
83892025,1,9,1.0,10,0.1
83895979,1,9,1.0,10,0.1
83915578,1,7,1.0,8,0.125
83926537,7,2,2.0,9,0.2222222222222222
83930300,6,4,4.0,10,0.4
83947197,28,1,1.0,29,0.034482758620689655
83962098,1,17,1.0,18,0.05555555555555555
83966940,2,8,2.0,10,0.2
83985502,2,7,2.0,9,0.2222222222222222
83990411,11,9,9.0,20,0.45
84001844,1,7,1.0,8,0.125
84002585,5,4,4.0,9,0.4444444444444444
84002637,7,3,3.0,10,0.3
84032360,8,1,1.0,9,0.1111111111111111
84055062,7,2,2.0,9,0.2222222222222222
84062246,1,9,1.0,10,0.1
84069138,2,8,2.0,10,0.2
84103738,3,7,3.0,10,0.3
84113471,1,9,1.0,10,0.1
84113476,2,8,2.0,10,0.2
84142604,3,7,3.0,10,0.3
84145222,1,8,1.0,9,0.1111111111111111
84146437,1,9,1.0,10,0.1
84167311,9,1,1.0,10,0.1
84179109,3,6,3.0,9,0.3333333333333333
84179200,5,14,5.0,19,0.2631578947368421
84181644,1,8,1.0,9,0.1111111111111111
84182266,1,7,1.0,8,0.125
84195801,4,6,4.0,10,0.4
84202479,1,9,1.0,10,0.1
84202609,1,8,1.0,9,0.1111111111111111
84204162,1,9,1.0,10,0.1
84207210,12,6,6.0,18,0.3333333333333333
84250258,1,18,1.0,19,0.05263157894736842
84266226,1,17,1.0,18,0.05555555555555555
84267616,2,7,2.0,9,0.2222222222222222
84283293,1,9,1.0,10,0.1
84284857,3,5,3.0,8,0.375
84314310,7,13,7.0,20,0.35
84323575,1,9,1.0,10,0.1
84325162,1,8,1.0,9,0.1111111111111111
84327049,2,18,2.0,20,0.1
84337808,1,9,1.0,10,0.1
84382189,3,5,3.0,8,0.375
84390094,3,7,3.0,10,0.3
84404624,2,8,2.0,10,0.2
84404785,1,7,1.0,8,0.125
84424405,2,7,2.0,9,0.2222222222222222
84434340,1,9,1.0,10,0.1
84464461,3,16,3.0,19,0.15789473684210525
84508630,2,18,2.0,20,0.1
84523130,1,28,1.0,29,0.034482758620689655
84529085,1,9,1.0,10,0.1
84538542,2,7,2.0,9,0.2222222222222222
84539510,15,4,4.0,19,0.21052631578947367
84558087,1,8,1.0,9,0.1111111111111111
84563732,2,8,2.0,10,0.2
84567836,8,20,8.0,28,0.2857142857142857
84569164,5,5,5.0,10,0.5
84570947,4,5,4.0,9,0.4444444444444444
84571719,4,6,4.0,10,0.4
84572276,6,3,3.0,9,0.3333333333333333
84573718,8,1,1.0,9,0.1111111111111111
84574167,4,6,4.0,10,0.4
84598998,7,3,3.0,10,0.3
84617035,3,7,3.0,10,0.3
84626610,1,9,1.0,10,0.1
84645990,1,15,1.0,16,0.0625
84647434,2,7,2.0,9,0.2222222222222222
84658543,1,9,1.0,10,0.1
84702602,5,4,4.0,9,0.4444444444444444
84706088,5,4,4.0,9,0.4444444444444444
84707976,3,7,3.0,10,0.3
84710323,3,5,3.0,8,0.375
84710858,7,3,3.0,10,0.3
84716121,2,7,2.0,9,0.2222222222222222
84716834,13,14,13.0,27,0.48148148148148145
84746766,6,3,3.0,9,0.3333333333333333
84749130,1,9,1.0,10,0.1
84784836,1,8,1.0,9,0.1111111111111111
84812282,3,7,3.0,10,0.3
84843500,1,9,1.0,10,0.1
84852565,1,9,1.0,10,0.1
84864448,1,19,1.0,20,0.05
84893216,11,17,11.0,28,0.39285714285714285
84898983,1,19,1.0,20,0.05
84923780,7,2,2.0,9,0.2222222222222222
84934254,2,8,2.0,10,0.2
84935872,2,7,2.0,9,0.2222222222222222
84935951,2,6,2.0,8,0.25
84940255,5,5,5.0,10,0.5
84940580,5,4,4.0,9,0.4444444444444444
84945846,1,9,1.0,10,0.1
84981246,2,7,2.0,9,0.2222222222222222
84985511,1,18,1.0,19,0.05263157894736842
84991319,4,5,4.0,9,0.4444444444444444
85003303,2,8,2.0,10,0.2
85017746,1,18,1.0,19,0.05263157894736842
85049710,4,16,4.0,20,0.2
85053411,1,27,1.0,28,0.03571428571428571
85059487,1,9,1.0,10,0.1
85062123,2,8,2.0,10,0.2
85065975,1,8,1.0,9,0.1111111111111111
85067174,2,7,2.0,9,0.2222222222222222
85087478,2,7,2.0,9,0.2222222222222222
85090572,1,7,1.0,8,0.125
85091113,2,8,2.0,10,0.2
85120589,1,8,1.0,9,0.1111111111111111
85161327,2,8,2.0,10,0.2
85163776,2,7,2.0,9,0.2222222222222222
85229125,5,4,4.0,9,0.4444444444444444
85245391,1,8,1.0,9,0.1111111111111111
85250655,4,6,4.0,10,0.4
85250817,5,3,3.0,8,0.375
85251291,3,7,3.0,10,0.3
85251472,6,4,4.0,10,0.4
85253981,4,25,4.0,29,0.13793103448275862
85263595,4,6,4.0,10,0.4
85264057,4,6,4.0,10,0.4
85273635,1,9,1.0,10,0.1
85277721,1,19,1.0,20,0.05
85288492,2,8,2.0,10,0.2
85305249,10,9,9.0,19,0.47368421052631576
85307285,8,2,2.0,10,0.2
85312276,3,16,3.0,19,0.15789473684210525
85325032,1,18,1.0,19,0.05263157894736842
85327722,3,6,3.0,9,0.3333333333333333
85335710,1,17,1.0,18,0.05555555555555555
85349957,2,17,2.0,19,0.10526315789473684
85351299,2,8,2.0,10,0.2
85352111,1,8,1.0,9,0.1111111111111111
85359993,5,5,5.0,10,0.5
85367133,1,8,1.0,9,0.1111111111111111
85368414,2,18,2.0,20,0.1
85369406,4,4,4.0,8,0.5
85379241,3,7,3.0,10,0.3
85379756,8,1,1.0,9,0.1111111111111111
85382726,2,18,2.0,20,0.1
85396808,3,6,3.0,9,0.3333333333333333
85413743,1,9,1.0,10,0.1
85440323,1,9,1.0,10,0.1
85476640,7,2,2.0,9,0.2222222222222222
85477788,1,9,1.0,10,0.1
85480162,3,16,3.0,19,0.15789473684210525
85483760,1,9,1.0,10,0.1
85486414,7,21,7.0,28,0.25
85494190,1,19,1.0,20,0.05
85507813,1,9,1.0,10,0.1
85518670,3,6,3.0,9,0.3333333333333333
85522285,3,7,3.0,10,0.3
85549754,1,9,1.0,10,0.1
85559095,1,8,1.0,9,0.1111111111111111
85564546,7,12,7.0,19,0.3684210526315789
85570736,2,8,2.0,10,0.2
85576511,1,8,1.0,9,0.1111111111111111
85597029,17,13,13.0,30,0.43333333333333335
85605381,7,2,2.0,9,0.2222222222222222
85609330,10,16,10.0,26,0.38461538461538464
85613588,2,7,2.0,9,0.2222222222222222
85617199,3,7,3.0,10,0.3
85626214,2,7,2.0,9,0.2222222222222222
85626305,1,9,1.0,10,0.1
85633562,5,5,5.0,10,0.5
85636886,4,16,4.0,20,0.2
85662306,1,17,1.0,18,0.05555555555555555
85688224,1,9,1.0,10,0.1
85749556,1,8,1.0,9,0.1111111111111111
85759173,5,5,5.0,10,0.5
85781248,1,8,1.0,9,0.1111111111111111
85783020,1,8,1.0,9,0.1111111111111111
85785903,1,9,1.0,10,0.1
85797749,4,6,4.0,10,0.4
85798255,3,6,3.0,9,0.3333333333333333
85799758,1,17,1.0,18,0.05555555555555555
85802392,5,4,4.0,9,0.4444444444444444
85835592,1,19,1.0,20,0.05
85889038,8,1,1.0,9,0.1111111111111111
85893672,3,15,3.0,18,0.16666666666666666
85897916,1,9,1.0,10,0.1
85911845,1,9,1.0,10,0.1
85915408,1,9,1.0,10,0.1
85924670,1,9,1.0,10,0.1
85926379,3,6,3.0,9,0.3333333333333333
85927505,1,8,1.0,9,0.1111111111111111
85931568,6,4,4.0,10,0.4
85956619,1,8,1.0,9,0.1111111111111111
85957685,1,8,1.0,9,0.1111111111111111
85963555,1,8,1.0,9,0.1111111111111111
85966210,1,8,1.0,9,0.1111111111111111
85971363,1,8,1.0,9,0.1111111111111111
85976693,4,6,4.0,10,0.4
85994360,1,8,1.0,9,0.1111111111111111
86005449,3,16,3.0,19,0.15789473684210525
86008242,6,4,4.0,10,0.4
86029332,2,8,2.0,10,0.2
86035742,5,5,5.0,10,0.5
86036959,4,26,4.0,30,0.13333333333333333
86039621,20,8,8.0,28,0.2857142857142857
86049717,14,14,14.0,28,0.5
86051228,1,9,1.0,10,0.1
86051376,24,3,3.0,27,0.1111111111111111
86051613,4,25,4.0,29,0.13793103448275862
86053130,4,6,4.0,10,0.4
86076555,1,9,1.0,10,0.1
86106568,2,8,2.0,10,0.2
86108920,2,8,2.0,10,0.2
86108933,4,6,4.0,10,0.4
86115669,3,6,3.0,9,0.3333333333333333
86120730,2,7,2.0,9,0.2222222222222222
86123901,5,5,5.0,10,0.5
86125917,2,6,2.0,8,0.25
86138295,1,19,1.0,20,0.05
86153438,2,8,2.0,10,0.2
86154858,1,9,1.0,10,0.1
86156213,1,18,1.0,19,0.05263157894736842
86169770,3,26,3.0,29,0.10344827586206896
86170780,2,7,2.0,9,0.2222222222222222
86172787,1,9,1.0,10,0.1
86174741,1,8,1.0,9,0.1111111111111111
86175989,1,9,1.0,10,0.1
86176649,2,8,2.0,10,0.2
86176999,1,8,1.0,9,0.1111111111111111
86179181,2,8,2.0,10,0.2
86179684,1,19,1.0,20,0.05
86190138,5,3,3.0,8,0.375
86196191,8,1,1.0,9,0.1111111111111111
86199064,1,8,1.0,9,0.1111111111111111
86208847,8,2,2.0,10,0.2
86216910,1,9,1.0,10,0.1
86219893,1,18,1.0,19,0.05263157894736842
86246688,1,8,1.0,9,0.1111111111111111
86252742,1,9,1.0,10,0.1
86259610,1,19,1.0,20,0.05
86274396,14,5,5.0,19,0.2631578947368421
86278440,1,9,1.0,10,0.1
86279013,2,8,2.0,10,0.2
86279564,1,9,1.0,10,0.1
86281076,1,7,1.0,8,0.125
86281433,5,25,5.0,30,0.16666666666666666
86299572,6,3,3.0,9,0.3333333333333333
86299591,1,7,1.0,8,0.125
86300804,2,8,2.0,10,0.2
86315677,3,7,3.0,10,0.3
86323342,3,6,3.0,9,0.3333333333333333
86329820,1,9,1.0,10,0.1
86353375,3,6,3.0,9,0.3333333333333333
86355378,1,9,1.0,10,0.1
86370048,3,6,3.0,9,0.3333333333333333
86371721,5,4,4.0,9,0.4444444444444444
86375182,1,9,1.0,10,0.1
86389643,1,8,1.0,9,0.1111111111111111
86408089,1,7,1.0,8,0.125
86418860,1,8,1.0,9,0.1111111111111111
86438673,3,15,3.0,18,0.16666666666666666
86443710,5,15,5.0,20,0.25
86446120,6,3,3.0,9,0.3333333333333333
86489918,9,1,1.0,10,0.1
86494231,1,9,1.0,10,0.1
86502320,1,7,1.0,8,0.125
86502507,1,8,1.0,9,0.1111111111111111
86506864,1,8,1.0,9,0.1111111111111111
86514856,1,9,1.0,10,0.1
86520522,1,9,1.0,10,0.1
86523069,3,6,3.0,9,0.3333333333333333
86523790,25,3,3.0,28,0.10714285714285714
86524380,7,3,3.0,10,0.3
86525413,1,8,1.0,9,0.1111111111111111
86540787,4,6,4.0,10,0.4
86541163,4,6,4.0,10,0.4
86541870,6,4,4.0,10,0.4
86557250,1,17,1.0,18,0.05555555555555555
86571636,2,7,2.0,9,0.2222222222222222
86576481,4,6,4.0,10,0.4
86594235,1,9,1.0,10,0.1
86594391,2,8,2.0,10,0.2
86603402,1,19,1.0,20,0.05
86609390,1,18,1.0,19,0.05263157894736842
86616732,1,9,1.0,10,0.1
86623140,2,8,2.0,10,0.2
86627707,2,8,2.0,10,0.2
86632864,1,9,1.0,10,0.1
86639643,1,17,1.0,18,0.05555555555555555
86661239,9,1,1.0,10,0.1
86662028,8,1,1.0,9,0.1111111111111111
86662578,5,5,5.0,10,0.5
86663422,3,7,3.0,10,0.3
86663946,2,8,2.0,10,0.2
86664171,2,8,2.0,10,0.2
86701844,1,17,1.0,18,0.05555555555555555
86722710,6,4,4.0,10,0.4
86738048,1,8,1.0,9,0.1111111111111111
86739829,1,9,1.0,10,0.1
86742927,4,4,4.0,8,0.5
86743547,1,9,1.0,10,0.1
86744353,1,9,1.0,10,0.1
86773223,3,7,3.0,10,0.3
86774763,1,19,1.0,20,0.05
86775575,2,8,2.0,10,0.2
86776783,3,6,3.0,9,0.3333333333333333
86776943,1,9,1.0,10,0.1
86784977,1,9,1.0,10,0.1
86792317,1,9,1.0,10,0.1
86793105,3,10,3.0,13,0.23076923076923078
86812556,7,2,2.0,9,0.2222222222222222
86819332,6,3,3.0,9,0.3333333333333333
86819789,6,4,4.0,10,0.4
86852873,1,19,1.0,20,0.05
86855525,1,9,1.0,10,0.1
86878677,1,7,1.0,8,0.125
86878878,9,1,1.0,10,0.1
86879411,1,9,1.0,10,0.1
86885468,1,9,1.0,10,0.1
86888366,1,9,1.0,10,0.1
86910558,1,9,1.0,10,0.1
86914583,4,6,4.0,10,0.4
86926525,1,8,1.0,9,0.1111111111111111
86927119,1,8,1.0,9,0.1111111111111111
86932808,1,17,1.0,18,0.05555555555555555
86954611,1,8,1.0,9,0.1111111111111111
86956204,4,6,4.0,10,0.4
86972464,8,1,1.0,9,0.1111111111111111
86974626,3,6,3.0,9,0.3333333333333333
86976976,1,9,1.0,10,0.1
86984060,3,17,3.0,20,0.15
86995248,1,8,1.0,9,0.1111111111111111
86997651,3,7,3.0,10,0.3
87008597,27,2,2.0,29,0.06896551724137931
87038438,1,9,1.0,10,0.1
87064375,1,19,1.0,20,0.05
87072436,2,7,2.0,9,0.2222222222222222
87073965,3,7,3.0,10,0.3
87076262,2,6,2.0,8,0.25
87077067,1,7,1.0,8,0.125
87089049,3,25,3.0,28,0.10714285714285714
87090010,2,8,2.0,10,0.2
87098407,9,1,1.0,10,0.1
87133381,7,21,7.0,28,0.25
87150131,9,1,1.0,10,0.1
87219492,25,3,3.0,28,0.10714285714285714
87242610,1,9,1.0,10,0.1
87245611,1,8,1.0,9,0.1111111111111111
87245683,2,27,2.0,29,0.06896551724137931
87252386,1,8,1.0,9,0.1111111111111111
87299592,2,28,2.0,30,0.06666666666666667
87304652,2,7,2.0,9,0.2222222222222222
87305030,3,7,3.0,10,0.3
87305563,1,9,1.0,10,0.1
87309078,1,9,1.0,10,0.1
87309334,1,9,1.0,10,0.1
87309357,2,25,2.0,27,0.07407407407407407
87313830,2,8,2.0,10,0.2
87315653,4,25,4.0,29,0.13793103448275862
87316365,4,6,4.0,10,0.4
87316693,8,2,2.0,10,0.2
87316699,2,8,2.0,10,0.2
87317049,6,4,4.0,10,0.4
87317172,4,6,4.0,10,0.4
87317318,1,9,1.0,10,0.1
87318781,2,8,2.0,10,0.2
87318786,8,2,2.0,10,0.2
87318823,5,5,5.0,10,0.5
87319064,9,1,1.0,10,0.1
87319761,2,7,2.0,9,0.2222222222222222
87323680,3,7,3.0,10,0.3
87327223,2,7,2.0,9,0.2222222222222222
87327280,4,6,4.0,10,0.4
87354589,1,8,1.0,9,0.1111111111111111
87366707,1,9,1.0,10,0.1
87369987,3,7,3.0,10,0.3
87370263,2,7,2.0,9,0.2222222222222222
87372595,1,9,1.0,10,0.1
87373068,1,9,1.0,10,0.1
87373645,3,6,3.0,9,0.3333333333333333
87373788,5,5,5.0,10,0.5
87380993,3,7,3.0,10,0.3
87391598,2,17,2.0,19,0.10526315789473684
87392186,2,24,2.0,26,0.07692307692307693
87435679,4,15,4.0,19,0.21052631578947367
87445343,1,9,1.0,10,0.1
87455211,5,5,5.0,10,0.5
87463600,1,9,1.0,10,0.1
87466761,7,3,3.0,10,0.3
87467103,2,6,2.0,8,0.25
87474944,1,18,1.0,19,0.05263157894736842
87476197,9,1,1.0,10,0.1
87476348,4,6,4.0,10,0.4
87482114,2,8,2.0,10,0.2
87487702,6,3,3.0,9,0.3333333333333333
87499444,1,9,1.0,10,0.1
87501895,1,9,1.0,10,0.1
87534000,4,6,4.0,10,0.4
87535089,1,9,1.0,10,0.1
87536359,7,2,2.0,9,0.2222222222222222
87538382,6,3,3.0,9,0.3333333333333333
87547160,5,5,5.0,10,0.5
87549917,1,8,1.0,9,0.1111111111111111
87555699,5,5,5.0,10,0.5
87571121,2,17,2.0,19,0.10526315789473684
87612751,7,3,3.0,10,0.3
87644804,3,5,3.0,8,0.375
87645148,5,3,3.0,8,0.375
87648078,1,9,1.0,10,0.1
87663176,4,6,4.0,10,0.4
87670080,1,15,1.0,16,0.0625
87676940,8,1,1.0,9,0.1111111111111111
87680318,2,6,2.0,8,0.25
87682773,4,6,4.0,10,0.4
87689165,1,16,1.0,17,0.058823529411764705
87694765,5,4,4.0,9,0.4444444444444444
87703738,1,9,1.0,10,0.1
87712816,1,18,1.0,19,0.05263157894736842
87717315,3,6,3.0,9,0.3333333333333333
87727331,1,8,1.0,9,0.1111111111111111
87727623,8,1,1.0,9,0.1111111111111111
87729921,3,26,3.0,29,0.10344827586206896
87731150,6,4,4.0,10,0.4
87735530,8,2,2.0,10,0.2
87755705,2,17,2.0,19,0.10526315789473684
87756666,8,1,1.0,9,0.1111111111111111
87756720,8,2,2.0,10,0.2
87757026,6,4,4.0,10,0.4
87757357,1,9,1.0,10,0.1
87791308,1,7,1.0,8,0.125
87797777,1,9,1.0,10,0.1
87803053,3,7,3.0,10,0.3
87814886,1,9,1.0,10,0.1
87839034,1,9,1.0,10,0.1
87849809,2,8,2.0,10,0.2
87865180,1,8,1.0,9,0.1111111111111111
87877917,28,1,1.0,29,0.034482758620689655
87883071,5,22,5.0,27,0.18518518518518517
87897715,6,2,2.0,8,0.25
87900232,1,19,1.0,20,0.05
87934750,1,18,1.0,19,0.05263157894736842
87939457,5,3,3.0,8,0.375
87950517,1,9,1.0,10,0.1
87978464,3,7,3.0,10,0.3
87989601,6,3,3.0,9,0.3333333333333333
87990643,9,1,1.0,10,0.1
87991373,8,1,1.0,9,0.1111111111111111
87999753,9,1,1.0,10,0.1
88049954,3,7,3.0,10,0.3
88050336,2,8,2.0,10,0.2
88060144,1,9,1.0,10,0.1
88072605,9,1,1.0,10,0.1
88090402,1,9,1.0,10,0.1
88097105,2,16,2.0,18,0.1111111111111111
88097501,1,18,1.0,19,0.05263157894736842
88109404,6,3,3.0,9,0.3333333333333333
88129026,1,17,1.0,18,0.05555555555555555
88134035,1,17,1.0,18,0.05555555555555555
88169195,3,15,3.0,18,0.16666666666666666
88184896,1,18,1.0,19,0.05263157894736842
88188473,1,9,1.0,10,0.1
88189751,1,9,1.0,10,0.1
88190047,4,6,4.0,10,0.4
88204859,7,3,3.0,10,0.3
88220906,3,6,3.0,9,0.3333333333333333
88258812,7,3,3.0,10,0.3
88280074,2,8,2.0,10,0.2
88280336,2,7,2.0,9,0.2222222222222222
88284515,3,7,3.0,10,0.3
88287973,5,5,5.0,10,0.5
88288409,7,3,3.0,10,0.3
88301622,6,4,4.0,10,0.4
88309960,1,18,1.0,19,0.05263157894736842
88335940,1,9,1.0,10,0.1
88338062,2,8,2.0,10,0.2
88353402,2,8,2.0,10,0.2
88355654,3,6,3.0,9,0.3333333333333333
88358225,1,8,1.0,9,0.1111111111111111
88373111,1,9,1.0,10,0.1
88391196,1,16,1.0,17,0.058823529411764705
88400937,5,5,5.0,10,0.5
88414579,2,8,2.0,10,0.2
88415534,2,7,2.0,9,0.2222222222222222
88416139,2,8,2.0,10,0.2
88416501,6,3,3.0,9,0.3333333333333333
88419228,11,8,8.0,19,0.42105263157894735
88419576,8,1,1.0,9,0.1111111111111111
88435582,4,5,4.0,9,0.4444444444444444
88448113,2,8,2.0,10,0.2
88461986,1,9,1.0,10,0.1
88488802,2,8,2.0,10,0.2
88500978,1,9,1.0,10,0.1
88515837,1,9,1.0,10,0.1
88527888,2,6,2.0,8,0.25
88537717,5,5,5.0,10,0.5
88549452,1,9,1.0,10,0.1
88553772,6,3,3.0,9,0.3333333333333333
88564003,3,7,3.0,10,0.3
88564511,6,21,6.0,27,0.2222222222222222
88565168,1,9,1.0,10,0.1
88566493,1,8,1.0,9,0.1111111111111111
88574611,8,2,2.0,10,0.2
88577166,6,3,3.0,9,0.3333333333333333
88582137,1,9,1.0,10,0.1
88582990,4,5,4.0,9,0.4444444444444444
88587612,2,8,2.0,10,0.2
88592890,1,8,1.0,9,0.1111111111111111
88593896,4,5,4.0,9,0.4444444444444444
88600192,1,8,1.0,9,0.1111111111111111
88618145,7,1,1.0,8,0.125
88618557,7,3,3.0,10,0.3
88618757,3,7,3.0,10,0.3
88619024,8,1,1.0,9,0.1111111111111111
88619152,7,2,2.0,9,0.2222222222222222
88619262,9,1,1.0,10,0.1
88619359,5,3,3.0,8,0.375
88619397,22,4,4.0,26,0.15384615384615385
88650019,2,8,2.0,10,0.2
88653855,9,1,1.0,10,0.1
88656672,9,1,1.0,10,0.1
88656967,3,6,3.0,9,0.3333333333333333
88659078,5,4,4.0,9,0.4444444444444444
88660135,1,9,1.0,10,0.1
88661375,2,7,2.0,9,0.2222222222222222
88661887,6,4,4.0,10,0.4
88662465,3,7,3.0,10,0.3
88663588,1,7,1.0,8,0.125
88725367,4,6,4.0,10,0.4
88725791,1,18,1.0,19,0.05263157894736842
88740052,5,5,5.0,10,0.5
88741782,1,9,1.0,10,0.1
88764375,2,27,2.0,29,0.06896551724137931
88770031,13,15,13.0,28,0.4642857142857143
88770732,3,6,3.0,9,0.3333333333333333
88771045,5,4,4.0,9,0.4444444444444444
88790315,1,8,1.0,9,0.1111111111111111
88797166,2,7,2.0,9,0.2222222222222222
88799003,19,11,11.0,30,0.36666666666666664
88799278,1,8,1.0,9,0.1111111111111111
88803284,1,19,1.0,20,0.05
88806690,3,6,3.0,9,0.3333333333333333
88815940,1,16,1.0,17,0.058823529411764705
88817938,3,14,3.0,17,0.17647058823529413
88818625,1,9,1.0,10,0.1
88822889,1,14,1.0,15,0.06666666666666667
88831611,2,7,2.0,9,0.2222222222222222
88842957,2,7,2.0,9,0.2222222222222222
88843088,1,9,1.0,10,0.1
88843762,2,7,2.0,9,0.2222222222222222
88845598,1,9,1.0,10,0.1
88850270,1,9,1.0,10,0.1
88850505,1,8,1.0,9,0.1111111111111111
88858191,1,17,1.0,18,0.05555555555555555
88863621,1,9,1.0,10,0.1
88889120,1,8,1.0,9,0.1111111111111111
88904500,11,18,11.0,29,0.3793103448275862
88905314,1,8,1.0,9,0.1111111111111111
88909601,1,8,1.0,9,0.1111111111111111
88927539,1,9,1.0,10,0.1
88929817,4,24,4.0,28,0.14285714285714285
88945285,1,8,1.0,9,0.1111111111111111
88946468,1,9,1.0,10,0.1
88950624,8,1,1.0,9,0.1111111111111111
88974171,1,7,1.0,8,0.125
88974552,5,15,5.0,20,0.25
88976461,7,3,3.0,10,0.3
88981693,3,6,3.0,9,0.3333333333333333
88986083,2,7,2.0,9,0.2222222222222222
89010555,2,6,2.0,8,0.25
89016290,1,9,1.0,10,0.1
89029382,8,1,1.0,9,0.1111111111111111
89030262,2,6,2.0,8,0.25
89037728,9,1,1.0,10,0.1
89040783,3,5,3.0,8,0.375
89047260,1,8,1.0,9,0.1111111111111111
89048477,2,8,2.0,10,0.2
89049137,3,6,3.0,9,0.3333333333333333
89053518,8,2,2.0,10,0.2
89076957,2,7,2.0,9,0.2222222222222222
89081190,8,18,8.0,26,0.3076923076923077
89082127,2,8,2.0,10,0.2
89083754,1,9,1.0,10,0.1
89116405,21,7,7.0,28,0.25
89119506,3,7,3.0,10,0.3
89124952,2,8,2.0,10,0.2
89128216,9,1,1.0,10,0.1
89129193,4,6,4.0,10,0.4
89130134,7,3,3.0,10,0.3
89131683,8,1,1.0,9,0.1111111111111111
89132824,25,1,1.0,26,0.038461538461538464
89136101,2,7,2.0,9,0.2222222222222222
89140340,4,5,4.0,9,0.4444444444444444
89141266,5,24,5.0,29,0.1724137931034483
89146842,2,8,2.0,10,0.2
89162170,4,6,4.0,10,0.4
89172106,1,7,1.0,8,0.125
89174434,1,8,1.0,9,0.1111111111111111
89181671,3,7,3.0,10,0.3
89206209,1,8,1.0,9,0.1111111111111111
89210968,4,5,4.0,9,0.4444444444444444
89226564,1,9,1.0,10,0.1
89238642,1,9,1.0,10,0.1
89246647,6,3,3.0,9,0.3333333333333333
89252981,2,7,2.0,9,0.2222222222222222
89265341,1,8,1.0,9,0.1111111111111111
89267279,3,26,3.0,29,0.10344827586206896
89267661,2,8,2.0,10,0.2
89269775,1,16,1.0,17,0.058823529411764705
89277751,3,7,3.0,10,0.3
89278959,1,9,1.0,10,0.1
89296051,1,17,1.0,18,0.05555555555555555
89296275,3,7,3.0,10,0.3
89297422,1,9,1.0,10,0.1
89328659,2,7,2.0,9,0.2222222222222222
89345205,3,7,3.0,10,0.3
89396793,5,4,4.0,9,0.4444444444444444
89429855,1,9,1.0,10,0.1
89444779,7,2,2.0,9,0.2222222222222222
89458497,4,6,4.0,10,0.4
89471865,2,8,2.0,10,0.2
89476485,1,9,1.0,10,0.1
89477670,4,5,4.0,9,0.4444444444444444
89477752,8,1,1.0,9,0.1111111111111111
89484670,2,7,2.0,9,0.2222222222222222
89485811,2,16,2.0,18,0.1111111111111111
89513134,5,14,5.0,19,0.2631578947368421
89518535,2,8,2.0,10,0.2
89520082,3,17,3.0,20,0.15
89520530,1,7,1.0,8,0.125
89520633,5,5,5.0,10,0.5
89521016,5,4,4.0,9,0.4444444444444444
89528604,1,9,1.0,10,0.1
89538857,8,1,1.0,9,0.1111111111111111
89554815,8,1,1.0,9,0.1111111111111111
89556459,9,1,1.0,10,0.1
89556873,7,3,3.0,10,0.3
89566057,1,8,1.0,9,0.1111111111111111
89574357,1,9,1.0,10,0.1
89579239,1,9,1.0,10,0.1
89596992,8,1,1.0,9,0.1111111111111111
89597474,8,2,2.0,10,0.2
89629732,1,9,1.0,10,0.1
89629912,26,3,3.0,29,0.10344827586206896
89638632,1,8,1.0,9,0.1111111111111111
89638778,15,2,2.0,17,0.11764705882352941
89651845,8,2,2.0,10,0.2
89660685,9,10,9.0,19,0.47368421052631576
89689352,1,9,1.0,10,0.1
89703746,3,7,3.0,10,0.3
89728915,6,4,4.0,10,0.4
89739666,2,16,2.0,18,0.1111111111111111
89740304,2,25,2.0,27,0.07407407407407407
89740420,2,8,2.0,10,0.2
89768187,9,1,1.0,10,0.1
89778145,6,3,3.0,9,0.3333333333333333
89779490,6,4,4.0,10,0.4
89785043,2,8,2.0,10,0.2
89820334,1,19,1.0,20,0.05
89832578,1,9,1.0,10,0.1
89845483,4,6,4.0,10,0.4
89870129,6,4,4.0,10,0.4
89870641,8,2,2.0,10,0.2
89871425,3,6,3.0,9,0.3333333333333333
89887533,1,18,1.0,19,0.05263157894736842
89895362,2,18,2.0,20,0.1
89901498,7,1,1.0,8,0.125
89922023,4,6,4.0,10,0.4
89926539,5,4,4.0,9,0.4444444444444444
89926610,6,3,3.0,9,0.3333333333333333
89939252,3,7,3.0,10,0.3
89940973,3,6,3.0,9,0.3333333333333333
89942303,5,4,4.0,9,0.4444444444444444
89943613,2,6,2.0,8,0.25
89961066,6,3,3.0,9,0.3333333333333333
89962116,6,4,4.0,10,0.4
89964050,1,9,1.0,10,0.1
89968881,5,5,5.0,10,0.5
89969540,8,2,2.0,10,0.2
89974064,2,8,2.0,10,0.2
89987707,2,7,2.0,9,0.2222222222222222
89998744,7,3,3.0,10,0.3
89999623,2,8,2.0,10,0.2
89999803,2,7,2.0,9,0.2222222222222222
90002029,2,6,2.0,8,0.25
90036924,8,1,1.0,9,0.1111111111111111
90037778,8,1,1.0,9,0.1111111111111111
90038257,4,4,4.0,8,0.5
90051030,4,6,4.0,10,0.4
90055910,2,8,2.0,10,0.2
90056608,1,8,1.0,9,0.1111111111111111
90062773,7,3,3.0,10,0.3
90115276,2,8,2.0,10,0.2
90122231,3,7,3.0,10,0.3
90125968,1,8,1.0,9,0.1111111111111111
90134447,25,3,3.0,28,0.10714285714285714
90138088,3,6,3.0,9,0.3333333333333333
90152641,1,9,1.0,10,0.1
90168764,1,9,1.0,10,0.1
90169278,1,18,1.0,19,0.05263157894736842
90195664,9,20,9.0,29,0.3103448275862069
90199538,1,17,1.0,18,0.05555555555555555
90220412,3,7,3.0,10,0.3
90224163,6,3,3.0,9,0.3333333333333333
90267266,4,6,4.0,10,0.4
90267699,3,6,3.0,9,0.3333333333333333
90285609,1,8,1.0,9,0.1111111111111111
90302554,2,7,2.0,9,0.2222222222222222
90305057,7,23,7.0,30,0.23333333333333334
90305896,5,3,3.0,8,0.375
90306631,2,7,2.0,9,0.2222222222222222
90307308,2,7,2.0,9,0.2222222222222222
90308756,1,9,1.0,10,0.1
90309340,1,9,1.0,10,0.1
90310127,2,8,2.0,10,0.2
90310861,2,7,2.0,9,0.2222222222222222
90312018,3,7,3.0,10,0.3
90317100,1,8,1.0,9,0.1111111111111111
90321628,1,8,1.0,9,0.1111111111111111
90330344,7,3,3.0,10,0.3
90331764,1,28,1.0,29,0.034482758620689655
90365536,4,6,4.0,10,0.4
90366520,6,4,4.0,10,0.4
90392515,2,17,2.0,19,0.10526315789473684
90394195,2,8,2.0,10,0.2
90416098,10,8,8.0,18,0.4444444444444444
90451970,1,8,1.0,9,0.1111111111111111
90459300,3,15,3.0,18,0.16666666666666666
90466078,2,8,2.0,10,0.2
90467586,6,4,4.0,10,0.4
90492892,3,7,3.0,10,0.3
90516852,1,17,1.0,18,0.05555555555555555
90538505,6,12,6.0,18,0.3333333333333333
90545167,2,7,2.0,9,0.2222222222222222
90550152,1,9,1.0,10,0.1
90583303,5,4,4.0,9,0.4444444444444444
90588197,2,8,2.0,10,0.2
90591690,9,1,1.0,10,0.1
90608250,1,8,1.0,9,0.1111111111111111
90628356,6,3,3.0,9,0.3333333333333333
90631380,1,9,1.0,10,0.1
90632577,4,5,4.0,9,0.4444444444444444
90644909,4,6,4.0,10,0.4
90645051,1,9,1.0,10,0.1
90646714,3,7,3.0,10,0.3
90651097,1,9,1.0,10,0.1
90652033,2,8,2.0,10,0.2
90653478,1,28,1.0,29,0.034482758620689655
90686187,1,9,1.0,10,0.1
90719299,7,3,3.0,10,0.3
90724813,5,3,3.0,8,0.375
90748316,3,7,3.0,10,0.3
90788041,1,19,1.0,20,0.05
90791865,8,2,2.0,10,0.2
90796612,2,7,2.0,9,0.2222222222222222
90806177,2,7,2.0,9,0.2222222222222222
90809476,8,1,1.0,9,0.1111111111111111
90809855,9,1,1.0,10,0.1
90810185,1,18,1.0,19,0.05263157894736842
90810681,6,23,6.0,29,0.20689655172413793
90812208,6,3,3.0,9,0.3333333333333333
90836455,1,9,1.0,10,0.1
90837522,1,29,1.0,30,0.03333333333333333
90872688,1,19,1.0,20,0.05
90895537,4,6,4.0,10,0.4
90897429,2,18,2.0,20,0.1
90900769,2,8,2.0,10,0.2
90945704,1,7,1.0,8,0.125
90954582,3,7,3.0,10,0.3
90954810,1,9,1.0,10,0.1
90956832,2,6,2.0,8,0.25
90958432,8,2,2.0,10,0.2
90968450,4,6,4.0,10,0.4
90972612,1,9,1.0,10,0.1
90976578,2,8,2.0,10,0.2
90980616,2,8,2.0,10,0.2
90981099,2,7,2.0,9,0.2222222222222222
90981686,6,2,2.0,8,0.25
90983313,1,8,1.0,9,0.1111111111111111
90995353,2,7,2.0,9,0.2222222222222222
90998176,1,9,1.0,10,0.1
90998561,3,6,3.0,9,0.3333333333333333
90999614,3,7,3.0,10,0.3
91001320,1,9,1.0,10,0.1
91001642,1,9,1.0,10,0.1
91001886,1,9,1.0,10,0.1
91005274,2,8,2.0,10,0.2
91006159,4,5,4.0,9,0.4444444444444444
91011894,7,2,2.0,9,0.2222222222222222
91035457,6,3,3.0,9,0.3333333333333333
91037671,1,19,1.0,20,0.05
91039791,3,16,3.0,19,0.15789473684210525
91067953,1,9,1.0,10,0.1
91071776,1,9,1.0,10,0.1
91095274,2,8,2.0,10,0.2
91099504,1,8,1.0,9,0.1111111111111111
91107375,5,4,4.0,9,0.4444444444444444
91108499,4,5,4.0,9,0.4444444444444444
91125722,1,7,1.0,8,0.125
91137489,1,9,1.0,10,0.1
91142071,2,7,2.0,9,0.2222222222222222
91175933,3,6,3.0,9,0.3333333333333333
91176714,1,8,1.0,9,0.1111111111111111
91181159,1,7,1.0,8,0.125
91181909,1,9,1.0,10,0.1
91182588,1,9,1.0,10,0.1
91183258,2,8,2.0,10,0.2
91189078,1,9,1.0,10,0.1
91198133,3,7,3.0,10,0.3
91202456,6,3,3.0,9,0.3333333333333333
91203414,8,2,2.0,10,0.2
91205105,3,6,3.0,9,0.3333333333333333
91216995,1,8,1.0,9,0.1111111111111111
91237314,1,9,1.0,10,0.1
91255668,2,7,2.0,9,0.2222222222222222
91261299,1,9,1.0,10,0.1
91263127,1,16,1.0,17,0.058823529411764705
91267687,2,16,2.0,18,0.1111111111111111
91291670,2,17,2.0,19,0.10526315789473684
91293920,2,7,2.0,9,0.2222222222222222
91297943,5,5,5.0,10,0.5
91300857,2,8,2.0,10,0.2
91304625,4,6,4.0,10,0.4
91318811,1,8,1.0,9,0.1111111111111111
91320085,5,5,5.0,10,0.5
91320165,2,8,2.0,10,0.2
91344083,1,8,1.0,9,0.1111111111111111
91352643,6,4,4.0,10,0.4
91353914,2,8,2.0,10,0.2
91357453,6,21,6.0,27,0.2222222222222222
91371559,3,7,3.0,10,0.3
91373529,9,1,1.0,10,0.1
91374623,9,1,1.0,10,0.1
91380594,4,5,4.0,9,0.4444444444444444
91383308,3,7,3.0,10,0.3
91397108,4,6,4.0,10,0.4
91398136,2,8,2.0,10,0.2
91398831,8,1,1.0,9,0.1111111111111111
91399894,6,2,2.0,8,0.25
91422436,2,8,2.0,10,0.2
91422827,1,9,1.0,10,0.1
91426951,1,18,1.0,19,0.05263157894736842
91429103,4,6,4.0,10,0.4
91429226,2,8,2.0,10,0.2
91462171,8,1,1.0,9,0.1111111111111111
91470154,1,9,1.0,10,0.1
91473010,2,8,2.0,10,0.2
91473234,1,9,1.0,10,0.1
91481295,6,4,4.0,10,0.4
91484128,1,19,1.0,20,0.05
91501568,2,8,2.0,10,0.2
91526772,2,8,2.0,10,0.2
91527604,10,19,10.0,29,0.3448275862068966
91555648,7,1,1.0,8,0.125
91555844,2,6,2.0,8,0.25
91580390,2,8,2.0,10,0.2
91581490,1,9,1.0,10,0.1
91587786,3,7,3.0,10,0.3
91590400,3,7,3.0,10,0.3
91599372,2,16,2.0,18,0.1111111111111111
91621440,1,19,1.0,20,0.05
91627757,7,3,3.0,10,0.3
91630843,3,5,3.0,8,0.375
91648913,2,18,2.0,20,0.1
91661938,3,7,3.0,10,0.3
91662407,4,6,4.0,10,0.4
91680870,1,9,1.0,10,0.1
91701708,4,6,4.0,10,0.4
91703049,1,17,1.0,18,0.05555555555555555
91706907,6,4,4.0,10,0.4
91722859,1,7,1.0,8,0.125
91736691,9,1,1.0,10,0.1
91761023,1,8,1.0,9,0.1111111111111111
91775590,1,9,1.0,10,0.1
91775712,3,7,3.0,10,0.3
91775906,3,5,3.0,8,0.375
91776815,5,4,4.0,9,0.4444444444444444
91777721,1,9,1.0,10,0.1
91796486,1,9,1.0,10,0.1
91799503,1,9,1.0,10,0.1
91806385,3,7,3.0,10,0.3
91811856,1,18,1.0,19,0.05263157894736842
91812573,3,7,3.0,10,0.3
91857373,1,19,1.0,20,0.05
91862885,4,6,4.0,10,0.4
91873803,2,8,2.0,10,0.2
91948217,3,6,3.0,9,0.3333333333333333
91950838,4,4,4.0,8,0.5
91951035,8,22,8.0,30,0.26666666666666666
91982571,2,8,2.0,10,0.2
91987362,1,7,1.0,8,0.125
91988604,2,8,2.0,10,0.2
91989155,1,9,1.0,10,0.1
92009306,1,9,1.0,10,0.1
92013726,1,9,1.0,10,0.1
92022906,27,2,2.0,29,0.06896551724137931
92026551,7,3,3.0,10,0.3
92036415,1,9,1.0,10,0.1
92048982,1,18,1.0,19,0.05263157894736842
92054402,4,6,4.0,10,0.4
92063246,1,16,1.0,17,0.058823529411764705
92065754,1,9,1.0,10,0.1
92082017,2,8,2.0,10,0.2
92102996,3,6,3.0,9,0.3333333333333333
92132228,6,3,3.0,9,0.3333333333333333
92132792,1,9,1.0,10,0.1
92133968,3,7,3.0,10,0.3
92136127,1,9,1.0,10,0.1
92139373,2,7,2.0,9,0.2222222222222222
92142943,21,7,7.0,28,0.25
92146624,3,16,3.0,19,0.15789473684210525
92151640,7,2,2.0,9,0.2222222222222222
92151779,4,6,4.0,10,0.4
92182120,1,8,1.0,9,0.1111111111111111
92216693,6,4,4.0,10,0.4
92227781,4,15,4.0,19,0.21052631578947367
92238461,5,5,5.0,10,0.5
92239150,2,6,2.0,8,0.25
92239183,2,18,2.0,20,0.1
92309223,1,19,1.0,20,0.05
92326908,1,18,1.0,19,0.05263157894736842
92329963,1,9,1.0,10,0.1
92337884,1,9,1.0,10,0.1
92375793,2,18,2.0,20,0.1
92379230,3,17,3.0,20,0.15
92380215,4,6,4.0,10,0.4
92393983,1,8,1.0,9,0.1111111111111111
92408086,8,2,2.0,10,0.2
92428531,1,9,1.0,10,0.1
92433928,3,7,3.0,10,0.3
92433997,3,5,3.0,8,0.375
92466389,6,3,3.0,9,0.3333333333333333
92469420,1,9,1.0,10,0.1
92486284,1,17,1.0,18,0.05555555555555555
92489006,1,7,1.0,8,0.125
92493541,1,9,1.0,10,0.1
92502200,3,16,3.0,19,0.15789473684210525
92512711,2,7,2.0,9,0.2222222222222222
92519196,1,9,1.0,10,0.1
92522539,1,9,1.0,10,0.1
92523014,1,8,1.0,9,0.1111111111111111
92523643,3,6,3.0,9,0.3333333333333333
92532286,3,6,3.0,9,0.3333333333333333
92533660,1,9,1.0,10,0.1
92554507,1,9,1.0,10,0.1
92555567,1,8,1.0,9,0.1111111111111111
92577190,3,6,3.0,9,0.3333333333333333
92577367,5,4,4.0,9,0.4444444444444444
92578902,5,4,4.0,9,0.4444444444444444
92580072,1,8,1.0,9,0.1111111111111111
92580303,3,26,3.0,29,0.10344827586206896
92595016,1,9,1.0,10,0.1
92648873,1,8,1.0,9,0.1111111111111111
92650741,1,9,1.0,10,0.1
92650997,8,2,2.0,10,0.2
92651156,1,8,1.0,9,0.1111111111111111
92651246,1,9,1.0,10,0.1
92653394,1,8,1.0,9,0.1111111111111111
92661599,1,8,1.0,9,0.1111111111111111
92669219,1,9,1.0,10,0.1
92680690,2,15,2.0,17,0.11764705882352941
92702622,2,7,2.0,9,0.2222222222222222
92703302,2,18,2.0,20,0.1
92706363,2,7,2.0,9,0.2222222222222222
92706952,2,8,2.0,10,0.2
92724334,1,17,1.0,18,0.05555555555555555
92731607,3,7,3.0,10,0.3
92736513,2,7,2.0,9,0.2222222222222222
92737300,4,5,4.0,9,0.4444444444444444
92779258,2,8,2.0,10,0.2
92784192,1,7,1.0,8,0.125
92785541,1,9,1.0,10,0.1
92786100,1,7,1.0,8,0.125
92788214,1,8,1.0,9,0.1111111111111111
92793912,1,9,1.0,10,0.1
92800715,2,8,2.0,10,0.2
92815491,1,9,1.0,10,0.1
92818066,6,3,3.0,9,0.3333333333333333
92837343,1,18,1.0,19,0.05263157894736842
92839715,1,9,1.0,10,0.1
92848210,2,7,2.0,9,0.2222222222222222
92851780,2,20,2.0,22,0.09090909090909091
92853636,1,14,1.0,15,0.06666666666666667
92853864,7,3,3.0,10,0.3
92857141,8,2,2.0,10,0.2
92860910,2,8,2.0,10,0.2
92868340,1,19,1.0,20,0.05
92886422,2,8,2.0,10,0.2
92889967,1,9,1.0,10,0.1
92897880,2,8,2.0,10,0.2
92909210,11,8,8.0,19,0.42105263157894735
92928203,7,2,2.0,9,0.2222222222222222
92928782,1,9,1.0,10,0.1
92929466,1,8,1.0,9,0.1111111111111111
92929594,5,5,5.0,10,0.5
92929997,7,2,2.0,9,0.2222222222222222
92949153,11,18,11.0,29,0.3793103448275862
92988327,7,3,3.0,10,0.3
93032724,5,13,5.0,18,0.2777777777777778
93056141,8,2,2.0,10,0.2
93057712,4,5,4.0,9,0.4444444444444444
93058439,2,8,2.0,10,0.2
93058558,1,8,1.0,9,0.1111111111111111
93064398,2,8,2.0,10,0.2
93066538,4,6,4.0,10,0.4
93066592,1,9,1.0,10,0.1
93068851,1,19,1.0,20,0.05
93072599,2,8,2.0,10,0.2
93084951,1,8,1.0,9,0.1111111111111111
93089677,6,4,4.0,10,0.4
93093398,9,1,1.0,10,0.1
93097406,1,8,1.0,9,0.1111111111111111
93128407,5,4,4.0,9,0.4444444444444444
93132569,2,7,2.0,9,0.2222222222222222
93133185,1,9,1.0,10,0.1
93145416,1,7,1.0,8,0.125
93152053,13,15,13.0,28,0.4642857142857143
93152794,2,16,2.0,18,0.1111111111111111
93153588,1,8,1.0,9,0.1111111111111111
93154587,1,9,1.0,10,0.1
93156473,1,9,1.0,10,0.1
93156718,1,8,1.0,9,0.1111111111111111
93160074,7,2,2.0,9,0.2222222222222222
93182650,1,9,1.0,10,0.1
93184006,2,6,2.0,8,0.25
93191759,4,6,4.0,10,0.4
93212105,1,17,1.0,18,0.05555555555555555
93215597,3,7,3.0,10,0.3
93233158,4,5,4.0,9,0.4444444444444444
93248603,3,6,3.0,9,0.3333333333333333
93248875,7,3,3.0,10,0.3
93255822,1,9,1.0,10,0.1
93256956,2,8,2.0,10,0.2
93268843,1,18,1.0,19,0.05263157894736842
93269848,4,5,4.0,9,0.4444444444444444
93281428,1,8,1.0,9,0.1111111111111111
93282396,1,9,1.0,10,0.1
93312322,5,4,4.0,9,0.4444444444444444
93314926,2,8,2.0,10,0.2
93351446,5,5,5.0,10,0.5
93369772,1,9,1.0,10,0.1
93382978,1,9,1.0,10,0.1
93388009,1,18,1.0,19,0.05263157894736842
93400690,1,19,1.0,20,0.05
93419930,2,8,2.0,10,0.2
93432481,1,9,1.0,10,0.1
93437462,6,3,3.0,9,0.3333333333333333
93437755,2,15,2.0,17,0.11764705882352941
93470354,1,9,1.0,10,0.1
93474017,6,4,4.0,10,0.4
93478015,2,16,2.0,18,0.1111111111111111
93483226,1,7,1.0,8,0.125
93494421,9,1,1.0,10,0.1
93502224,1,9,1.0,10,0.1
93502965,2,8,2.0,10,0.2
93504375,1,8,1.0,9,0.1111111111111111
93513920,1,17,1.0,18,0.05555555555555555
93522751,2,7,2.0,9,0.2222222222222222
93527257,6,3,3.0,9,0.3333333333333333
93572603,4,14,4.0,18,0.2222222222222222
93574241,2,18,2.0,20,0.1
93576780,3,7,3.0,10,0.3
93603082,1,8,1.0,9,0.1111111111111111
93609121,1,19,1.0,20,0.05
93618775,1,7,1.0,8,0.125
93620183,5,4,4.0,9,0.4444444444444444
93620289,9,1,1.0,10,0.1
93621956,5,21,5.0,26,0.19230769230769232
93626292,4,16,4.0,20,0.2
93629351,2,8,2.0,10,0.2
93631003,2,8,2.0,10,0.2
93631183,2,17,2.0,19,0.10526315789473684
93633200,1,9,1.0,10,0.1
93633482,3,7,3.0,10,0.3
93635902,2,7,2.0,9,0.2222222222222222
93638523,2,7,2.0,9,0.2222222222222222
93641343,6,4,4.0,10,0.4
93655344,5,5,5.0,10,0.5
93658914,2,7,2.0,9,0.2222222222222222
93676950,2,7,2.0,9,0.2222222222222222
93695543,1,18,1.0,19,0.05263157894736842
93697151,1,9,1.0,10,0.1
93699003,2,16,2.0,18,0.1111111111111111
93703626,7,3,3.0,10,0.3
93704914,1,9,1.0,10,0.1
93706258,1,8,1.0,9,0.1111111111111111
93730400,4,4,4.0,8,0.5
93730794,1,8,1.0,9,0.1111111111111111
93735460,7,3,3.0,10,0.3
93760575,1,7,1.0,8,0.125
93792048,1,9,1.0,10,0.1
93793014,1,19,1.0,20,0.05
93795763,3,6,3.0,9,0.3333333333333333
93809609,1,8,1.0,9,0.1111111111111111
93820735,4,6,4.0,10,0.4
93824537,1,9,1.0,10,0.1
93826775,2,8,2.0,10,0.2
93827491,2,7,2.0,9,0.2222222222222222
93827801,1,8,1.0,9,0.1111111111111111
93840370,1,8,1.0,9,0.1111111111111111
93858438,2,8,2.0,10,0.2
93866948,1,8,1.0,9,0.1111111111111111
93867065,2,7,2.0,9,0.2222222222222222
93875841,1,18,1.0,19,0.05263157894736842
93877548,1,19,1.0,20,0.05
93890739,1,17,1.0,18,0.05555555555555555
93924435,1,9,1.0,10,0.1
93927212,8,1,1.0,9,0.1111111111111111
93935830,1,9,1.0,10,0.1
93940299,1,9,1.0,10,0.1
93958585,3,7,3.0,10,0.3
93960474,2,8,2.0,10,0.2
93961226,1,9,1.0,10,0.1
93967398,4,5,4.0,9,0.4444444444444444
93967417,1,9,1.0,10,0.1
93967838,4,5,4.0,9,0.4444444444444444
93968067,3,7,3.0,10,0.3
93968461,6,13,6.0,19,0.3157894736842105
93969669,7,3,3.0,10,0.3
94014436,2,8,2.0,10,0.2
94016802,5,5,5.0,10,0.5
94026308,2,8,2.0,10,0.2
94105732,2,18,2.0,20,0.1
94110462,1,9,1.0,10,0.1
94114277,1,9,1.0,10,0.1
94164780,3,7,3.0,10,0.3
94166852,4,4,4.0,8,0.5
94167991,5,5,5.0,10,0.5
94168414,3,6,3.0,9,0.3333333333333333
94169387,9,1,1.0,10,0.1
94170646,24,4,4.0,28,0.14285714285714285
94170730,19,10,10.0,29,0.3448275862068966
94174619,6,3,3.0,9,0.3333333333333333
94182731,8,2,2.0,10,0.2
94183094,1,18,1.0,19,0.05263157894736842
94184161,2,7,2.0,9,0.2222222222222222
94190178,3,27,3.0,30,0.1
94192842,5,4,4.0,9,0.4444444444444444
94192919,1,9,1.0,10,0.1
94196625,1,18,1.0,19,0.05263157894736842
94211967,1,19,1.0,20,0.05
94216211,1,9,1.0,10,0.1
94218685,1,9,1.0,10,0.1
94221690,6,4,4.0,10,0.4
94230990,4,6,4.0,10,0.4
94233454,2,17,2.0,19,0.10526315789473684
94234506,1,9,1.0,10,0.1
94263194,6,4,4.0,10,0.4
94263218,1,19,1.0,20,0.05
94278908,1,8,1.0,9,0.1111111111111111
94282699,1,8,1.0,9,0.1111111111111111
94285913,1,8,1.0,9,0.1111111111111111
94328891,2,7,2.0,9,0.2222222222222222
94329139,1,9,1.0,10,0.1
94359981,7,3,3.0,10,0.3
94368647,2,8,2.0,10,0.2
94382520,2,7,2.0,9,0.2222222222222222
94395300,5,4,4.0,9,0.4444444444444444
94395682,5,4,4.0,9,0.4444444444444444
94409224,6,13,6.0,19,0.3157894736842105
94411369,1,8,1.0,9,0.1111111111111111
94413580,27,2,2.0,29,0.06896551724137931
94433483,1,8,1.0,9,0.1111111111111111
94443669,1,9,1.0,10,0.1
94480674,7,2,2.0,9,0.2222222222222222
94526120,1,9,1.0,10,0.1
94529830,1,8,1.0,9,0.1111111111111111
94536697,1,18,1.0,19,0.05263157894736842
94563443,1,18,1.0,19,0.05263157894736842
94596847,1,19,1.0,20,0.05
94598082,8,2,2.0,10,0.2
94598810,4,5,4.0,9,0.4444444444444444
94599108,8,1,1.0,9,0.1111111111111111
94613514,7,3,3.0,10,0.3
94619844,4,6,4.0,10,0.4
94620220,5,5,5.0,10,0.5
94653710,2,8,2.0,10,0.2
94663850,1,8,1.0,9,0.1111111111111111
94672371,3,7,3.0,10,0.3
94674666,1,9,1.0,10,0.1
94679648,14,5,5.0,19,0.2631578947368421
94683281,1,9,1.0,10,0.1
94692412,1,8,1.0,9,0.1111111111111111
94692896,2,27,2.0,29,0.06896551724137931
94693226,2,18,2.0,20,0.1
94694797,1,9,1.0,10,0.1
94695308,2,7,2.0,9,0.2222222222222222
94697747,1,9,1.0,10,0.1
94718453,1,8,1.0,9,0.1111111111111111
94723145,3,27,3.0,30,0.1
94766529,16,11,11.0,27,0.4074074074074074
94782137,2,8,2.0,10,0.2
94782568,20,10,10.0,30,0.3333333333333333
94791803,1,9,1.0,10,0.1
94796989,4,5,4.0,9,0.4444444444444444
94830785,5,4,4.0,9,0.4444444444444444
94831559,3,7,3.0,10,0.3
94849501,1,9,1.0,10,0.1
94854643,2,7,2.0,9,0.2222222222222222
94906504,1,9,1.0,10,0.1
94920122,2,15,2.0,17,0.11764705882352941
94938645,1,9,1.0,10,0.1
94943127,1,9,1.0,10,0.1
94944582,9,1,1.0,10,0.1
94948229,1,17,1.0,18,0.05555555555555555
94967040,1,19,1.0,20,0.05
94975262,1,18,1.0,19,0.05263157894736842
94985344,8,1,1.0,9,0.1111111111111111
95011371,5,5,5.0,10,0.5
95018648,1,9,1.0,10,0.1
95021045,3,6,3.0,9,0.3333333333333333
95022723,2,18,2.0,20,0.1
95023023,2,8,2.0,10,0.2
95024587,3,7,3.0,10,0.3
95025227,1,8,1.0,9,0.1111111111111111
95025712,3,7,3.0,10,0.3
95027149,8,1,1.0,9,0.1111111111111111
95027631,7,2,2.0,9,0.2222222222222222
95028087,7,3,3.0,10,0.3
95028422,7,2,2.0,9,0.2222222222222222
95038500,5,14,5.0,19,0.2631578947368421
95041303,1,9,1.0,10,0.1
95050039,2,7,2.0,9,0.2222222222222222
95053053,1,9,1.0,10,0.1
95086630,8,2,2.0,10,0.2
95088877,6,4,4.0,10,0.4
95089070,9,1,1.0,10,0.1
95106763,4,5,4.0,9,0.4444444444444444
95114833,1,18,1.0,19,0.05263157894736842
95125187,1,19,1.0,20,0.05
95128057,23,6,6.0,29,0.20689655172413793
95130592,6,4,4.0,10,0.4
95134178,8,2,2.0,10,0.2
95151553,4,6,4.0,10,0.4
95154526,3,7,3.0,10,0.3
95162538,9,1,1.0,10,0.1
95189275,3,7,3.0,10,0.3
95199377,1,9,1.0,10,0.1
95209265,13,6,6.0,19,0.3157894736842105
95211256,2,8,2.0,10,0.2
95233324,2,18,2.0,20,0.1
95245447,2,17,2.0,19,0.10526315789473684
95254731,1,9,1.0,10,0.1
95312214,2,7,2.0,9,0.2222222222222222
95316663,1,15,1.0,16,0.0625
95322762,1,7,1.0,8,0.125
95333378,6,3,3.0,9,0.3333333333333333
95343278,6,4,4.0,10,0.4
95348709,6,3,3.0,9,0.3333333333333333
95349048,21,9,9.0,30,0.3
95354656,2,7,2.0,9,0.2222222222222222
95360433,2,25,2.0,27,0.07407407407407407
95360927,1,7,1.0,8,0.125
95367528,1,8,1.0,9,0.1111111111111111
95368671,2,16,2.0,18,0.1111111111111111
95377866,2,8,2.0,10,0.2
95383746,1,8,1.0,9,0.1111111111111111
95386575,3,7,3.0,10,0.3
95401175,1,18,1.0,19,0.05263157894736842
95418291,1,9,1.0,10,0.1
95418315,1,17,1.0,18,0.05555555555555555
95420648,2,8,2.0,10,0.2
95455148,1,9,1.0,10,0.1
95533356,1,8,1.0,9,0.1111111111111111
95538727,4,5,4.0,9,0.4444444444444444
95546910,1,9,1.0,10,0.1
95582140,2,7,2.0,9,0.2222222222222222
95609432,2,8,2.0,10,0.2
95627280,1,18,1.0,19,0.05263157894736842
95644609,4,6,4.0,10,0.4
95673005,3,7,3.0,10,0.3
95676137,1,9,1.0,10,0.1
95681803,1,9,1.0,10,0.1
95686306,4,16,4.0,20,0.2
95707971,1,18,1.0,19,0.05263157894736842
95741796,1,9,1.0,10,0.1
95743692,1,19,1.0,20,0.05
95746300,1,9,1.0,10,0.1
95754175,3,6,3.0,9,0.3333333333333333
95759868,1,9,1.0,10,0.1
95769391,2,8,2.0,10,0.2
95771338,1,8,1.0,9,0.1111111111111111
95772481,2,8,2.0,10,0.2
95780608,1,7,1.0,8,0.125
95781053,2,7,2.0,9,0.2222222222222222
95790488,1,18,1.0,19,0.05263157894736842
95791744,4,6,4.0,10,0.4
95794904,1,8,1.0,9,0.1111111111111111
95801787,2,8,2.0,10,0.2
95817853,2,8,2.0,10,0.2
95822787,2,18,2.0,20,0.1
95827796,2,8,2.0,10,0.2
95838793,7,1,1.0,8,0.125
95839609,6,3,3.0,9,0.3333333333333333
95841565,6,22,6.0,28,0.21428571428571427
95842965,1,7,1.0,8,0.125
95845805,2,7,2.0,9,0.2222222222222222
95850139,4,26,4.0,30,0.13333333333333333
95857275,2,8,2.0,10,0.2
95858672,2,18,2.0,20,0.1
95864920,1,9,1.0,10,0.1
95875717,2,7,2.0,9,0.2222222222222222
95888279,1,8,1.0,9,0.1111111111111111
95891662,1,7,1.0,8,0.125
95895031,1,17,1.0,18,0.05555555555555555
95932185,3,13,3.0,16,0.1875
95945611,6,12,6.0,18,0.3333333333333333
95946829,3,6,3.0,9,0.3333333333333333
95946975,6,4,4.0,10,0.4
95965918,1,9,1.0,10,0.1
95980094,7,3,3.0,10,0.3
95987090,1,8,1.0,9,0.1111111111111111
95987828,4,22,4.0,26,0.15384615384615385
95989933,5,4,4.0,9,0.4444444444444444
95994067,5,4,4.0,9,0.4444444444444444
96031081,1,9,1.0,10,0.1
96033327,4,6,4.0,10,0.4
96042610,2,8,2.0,10,0.2
96045294,2,8,2.0,10,0.2
96082725,1,9,1.0,10,0.1
96084140,1,9,1.0,10,0.1
96084818,4,4,4.0,8,0.5
96088203,5,4,4.0,9,0.4444444444444444
96091745,2,8,2.0,10,0.2
96093098,2,8,2.0,10,0.2
96120780,6,13,6.0,19,0.3157894736842105
96127208,1,9,1.0,10,0.1
96129832,1,19,1.0,20,0.05
96131236,3,7,3.0,10,0.3
96147749,7,2,2.0,9,0.2222222222222222
96153206,2,7,2.0,9,0.2222222222222222
96154382,3,6,3.0,9,0.3333333333333333
96155090,1,8,1.0,9,0.1111111111111111
96212243,9,8,8.0,17,0.47058823529411764
96212538,5,4,4.0,9,0.4444444444444444
96213066,5,5,5.0,10,0.5
96213763,9,1,1.0,10,0.1
96214339,19,8,8.0,27,0.2962962962962963
96214872,4,5,4.0,9,0.4444444444444444
96216221,4,6,4.0,10,0.4
96216860,3,7,3.0,10,0.3
96217545,3,7,3.0,10,0.3
96227607,3,6,3.0,9,0.3333333333333333
96229015,2,8,2.0,10,0.2
96229059,2,8,2.0,10,0.2
96230682,1,9,1.0,10,0.1
96232355,1,8,1.0,9,0.1111111111111111
96238794,2,8,2.0,10,0.2
96269104,1,25,1.0,26,0.038461538461538464
96269224,2,8,2.0,10,0.2
96296679,2,8,2.0,10,0.2
96297616,8,1,1.0,9,0.1111111111111111
96298252,1,18,1.0,19,0.05263157894736842
96309274,10,17,10.0,27,0.37037037037037035
96322223,2,6,2.0,8,0.25
96325103,1,19,1.0,20,0.05
96332060,12,17,12.0,29,0.41379310344827586
96345993,9,1,1.0,10,0.1
96365575,19,10,10.0,29,0.3448275862068966
96372134,1,8,1.0,9,0.1111111111111111
96377844,8,2,2.0,10,0.2
96406668,19,1,1.0,20,0.05
96406770,9,1,1.0,10,0.1
96406935,8,2,2.0,10,0.2
96407054,9,1,1.0,10,0.1
96409236,3,6,3.0,9,0.3333333333333333
96433076,1,9,1.0,10,0.1
96447129,1,8,1.0,9,0.1111111111111111
96469682,1,9,1.0,10,0.1
96481950,5,14,5.0,19,0.2631578947368421
96482168,1,9,1.0,10,0.1
96482757,12,7,7.0,19,0.3684210526315789
96483044,2,7,2.0,9,0.2222222222222222
96484217,3,7,3.0,10,0.3
96484504,8,2,2.0,10,0.2
96494815,4,5,4.0,9,0.4444444444444444
96495016,6,2,2.0,8,0.25
96505573,7,3,3.0,10,0.3
96506210,3,6,3.0,9,0.3333333333333333
96508866,7,3,3.0,10,0.3
96514182,2,16,2.0,18,0.1111111111111111
96517624,3,7,3.0,10,0.3
96547118,3,7,3.0,10,0.3
96551069,9,1,1.0,10,0.1
96551696,3,6,3.0,9,0.3333333333333333
96578939,2,8,2.0,10,0.2
96618635,2,8,2.0,10,0.2
96646769,2,8,2.0,10,0.2
96650444,3,16,3.0,19,0.15789473684210525
96674582,5,4,4.0,9,0.4444444444444444
96676431,4,4,4.0,8,0.5
96690688,3,7,3.0,10,0.3
96692361,1,9,1.0,10,0.1
96693367,1,7,1.0,8,0.125
96696471,3,7,3.0,10,0.3
96701519,4,6,4.0,10,0.4
96713408,1,18,1.0,19,0.05263157894736842
96735350,6,4,4.0,10,0.4
96745048,1,9,1.0,10,0.1
96752512,1,9,1.0,10,0.1
96768645,5,5,5.0,10,0.5
96798744,1,9,1.0,10,0.1
96809641,2,7,2.0,9,0.2222222222222222
96810180,1,9,1.0,10,0.1
96835366,3,6,3.0,9,0.3333333333333333
96857678,1,8,1.0,9,0.1111111111111111
96860559,1,8,1.0,9,0.1111111111111111
96898108,8,2,2.0,10,0.2
96903375,1,18,1.0,19,0.05263157894736842
96922593,1,9,1.0,10,0.1
97028523,2,8,2.0,10,0.2
97057995,1,9,1.0,10,0.1
97058248,8,2,2.0,10,0.2
97076705,1,9,1.0,10,0.1
97098890,3,6,3.0,9,0.3333333333333333
97098961,6,4,4.0,10,0.4
97115664,1,17,1.0,18,0.05555555555555555
97123436,1,18,1.0,19,0.05263157894736842
97135250,1,9,1.0,10,0.1
97168135,2,17,2.0,19,0.10526315789473684
97190703,4,24,4.0,28,0.14285714285714285
97192585,5,5,5.0,10,0.5
97203930,1,9,1.0,10,0.1
97253417,3,6,3.0,9,0.3333333333333333
97271244,1,8,1.0,9,0.1111111111111111
97276966,10,20,10.0,30,0.3333333333333333
97307383,1,18,1.0,19,0.05263157894736842
97307551,1,9,1.0,10,0.1
97313890,1,9,1.0,10,0.1
97314790,3,6,3.0,9,0.3333333333333333
97315162,2,8,2.0,10,0.2
97315271,3,7,3.0,10,0.3
97325545,2,6,2.0,8,0.25
97340093,8,2,2.0,10,0.2
97341254,6,3,3.0,9,0.3333333333333333
97342347,2,7,2.0,9,0.2222222222222222
97344480,2,6,2.0,8,0.25
97348754,1,9,1.0,10,0.1
97349544,1,9,1.0,10,0.1
97363663,2,8,2.0,10,0.2
97371676,5,5,5.0,10,0.5
97382810,12,7,7.0,19,0.3684210526315789
97383133,3,6,3.0,9,0.3333333333333333
97383498,5,5,5.0,10,0.5
97385338,8,1,1.0,9,0.1111111111111111
97386207,9,1,1.0,10,0.1
97387221,1,18,1.0,19,0.05263157894736842
97397738,6,2,2.0,8,0.25
97397983,7,3,3.0,10,0.3
97403365,1,18,1.0,19,0.05263157894736842
97416950,1,28,1.0,29,0.034482758620689655
97417378,1,9,1.0,10,0.1
97485507,2,7,2.0,9,0.2222222222222222
97494825,1,9,1.0,10,0.1
97508313,7,3,3.0,10,0.3
97523834,1,9,1.0,10,0.1
97538756,1,7,1.0,8,0.125
97563058,1,9,1.0,10,0.1
97568752,4,14,4.0,18,0.2222222222222222
97594526,4,5,4.0,9,0.4444444444444444
97680305,1,18,1.0,19,0.05263157894736842
97687289,2,7,2.0,9,0.2222222222222222
97694691,5,5,5.0,10,0.5
97721227,1,17,1.0,18,0.05555555555555555
97721907,7,3,3.0,10,0.3
97752934,2,7,2.0,9,0.2222222222222222
97768261,1,9,1.0,10,0.1
97805202,6,4,4.0,10,0.4
97824411,2,7,2.0,9,0.2222222222222222
97826767,6,4,4.0,10,0.4
97827444,8,2,2.0,10,0.2
97828578,1,9,1.0,10,0.1
97830358,13,6,6.0,19,0.3157894736842105
97869830,4,6,4.0,10,0.4
97872938,3,16,3.0,19,0.15789473684210525
97881753,1,28,1.0,29,0.034482758620689655
97907523,3,7,3.0,10,0.3
97908266,1,8,1.0,9,0.1111111111111111
97932689,1,18,1.0,19,0.05263157894736842
97943968,1,17,1.0,18,0.05555555555555555
97948807,1,9,1.0,10,0.1
97954824,2,6,2.0,8,0.25
98041602,1,9,1.0,10,0.1
98046627,8,2,2.0,10,0.2
98056519,1,18,1.0,19,0.05263157894736842
98059880,2,7,2.0,9,0.2222222222222222
98060828,2,7,2.0,9,0.2222222222222222
98061614,1,19,1.0,20,0.05
98080490,2,7,2.0,9,0.2222222222222222
98101944,5,5,5.0,10,0.5
98102043,1,9,1.0,10,0.1
98102090,1,9,1.0,10,0.1
98102456,8,2,2.0,10,0.2
98118045,8,2,2.0,10,0.2
98118828,1,8,1.0,9,0.1111111111111111
98125890,1,16,1.0,17,0.058823529411764705
98132520,1,8,1.0,9,0.1111111111111111
98135546,2,8,2.0,10,0.2
98135783,3,7,3.0,10,0.3
98191488,2,8,2.0,10,0.2
98204754,2,8,2.0,10,0.2
98223068,1,9,1.0,10,0.1
98237681,1,9,1.0,10,0.1
98246232,1,9,1.0,10,0.1
98247813,6,4,4.0,10,0.4
98248205,2,8,2.0,10,0.2
98266819,1,9,1.0,10,0.1
98270270,3,6,3.0,9,0.3333333333333333
98271689,1,8,1.0,9,0.1111111111111111
98276830,1,9,1.0,10,0.1
98279130,2,8,2.0,10,0.2
98293061,7,2,2.0,9,0.2222222222222222
98330514,1,8,1.0,9,0.1111111111111111
98345838,2,8,2.0,10,0.2
98357800,2,7,2.0,9,0.2222222222222222
98358388,2,15,2.0,17,0.11764705882352941
98359948,1,19,1.0,20,0.05
98360360,1,8,1.0,9,0.1111111111111111
98361493,2,8,2.0,10,0.2
98380468,9,1,1.0,10,0.1
98396931,2,8,2.0,10,0.2
98399355,2,8,2.0,10,0.2
98428057,1,18,1.0,19,0.05263157894736842
98454047,1,9,1.0,10,0.1
98467646,27,3,3.0,30,0.1
98467933,1,8,1.0,9,0.1111111111111111
98474393,2,7,2.0,9,0.2222222222222222
98499991,1,28,1.0,29,0.034482758620689655
98500743,2,8,2.0,10,0.2
98503329,3,26,3.0,29,0.10344827586206896
98518237,1,8,1.0,9,0.1111111111111111
98540103,2,7,2.0,9,0.2222222222222222
98605506,5,5,5.0,10,0.5
98613333,2,18,2.0,20,0.1
98643655,1,8,1.0,9,0.1111111111111111
98644095,2,25,2.0,27,0.07407407407407407
98682871,2,18,2.0,20,0.1
98733623,5,4,4.0,9,0.4444444444444444
98734617,1,9,1.0,10,0.1
98734872,1,9,1.0,10,0.1
98736889,6,3,3.0,9,0.3333333333333333
98737244,6,2,2.0,8,0.25
98737396,1,8,1.0,9,0.1111111111111111
98738733,2,8,2.0,10,0.2
98738950,5,4,4.0,9,0.4444444444444444
98756559,8,1,1.0,9,0.1111111111111111
98756929,5,3,3.0,8,0.375
98758857,8,1,1.0,9,0.1111111111111111
98770109,1,17,1.0,18,0.05555555555555555
98775031,4,6,4.0,10,0.4
98797079,1,8,1.0,9,0.1111111111111111
98814284,3,5,3.0,8,0.375
98823823,9,1,1.0,10,0.1
98824580,9,1,1.0,10,0.1
98833206,9,1,1.0,10,0.1
98836837,1,9,1.0,10,0.1
98853509,9,1,1.0,10,0.1
98854814,7,2,2.0,9,0.2222222222222222
98855980,4,5,4.0,9,0.4444444444444444
98856251,8,2,2.0,10,0.2
98947065,3,6,3.0,9,0.3333333333333333
98952757,7,2,2.0,9,0.2222222222222222
98968382,2,8,2.0,10,0.2
98968828,3,7,3.0,10,0.3
98972153,1,9,1.0,10,0.1
98974901,3,16,3.0,19,0.15789473684210525
98986127,1,9,1.0,10,0.1
98995159,7,2,2.0,9,0.2222222222222222
99004433,2,8,2.0,10,0.2
99033326,2,8,2.0,10,0.2
99094824,2,17,2.0,19,0.10526315789473684
99122454,2,18,2.0,20,0.1
99129395,6,3,3.0,9,0.3333333333333333
99171008,1,9,1.0,10,0.1
99171680,18,9,9.0,27,0.3333333333333333
99194021,1,8,1.0,9,0.1111111111111111
99194051,1,18,1.0,19,0.05263157894736842
99195491,1,9,1.0,10,0.1
99199902,7,3,3.0,10,0.3
99203922,2,8,2.0,10,0.2
99206055,1,9,1.0,10,0.1
99207063,4,6,4.0,10,0.4
99207836,6,4,4.0,10,0.4
99208343,24,5,5.0,29,0.1724137931034483
99208613,1,8,1.0,9,0.1111111111111111
99209484,3,7,3.0,10,0.3
99216179,4,6,4.0,10,0.4
99221223,2,8,2.0,10,0.2
99225030,5,5,5.0,10,0.5
99226727,1,9,1.0,10,0.1
99258232,7,2,2.0,9,0.2222222222222222
99274085,1,16,1.0,17,0.058823529411764705
99280314,6,4,4.0,10,0.4
99280641,5,4,4.0,9,0.4444444444444444
99311130,6,3,3.0,9,0.3333333333333333
99339166,5,5,5.0,10,0.5
99385069,1,18,1.0,19,0.05263157894736842
99386589,1,9,1.0,10,0.1
99386764,3,7,3.0,10,0.3
99387014,1,15,1.0,16,0.0625
99390851,2,8,2.0,10,0.2
99391137,2,7,2.0,9,0.2222222222222222
99391371,4,5,4.0,9,0.4444444444444444
99396764,21,8,8.0,29,0.27586206896551724
99421925,4,6,4.0,10,0.4
99466865,1,17,1.0,18,0.05555555555555555
99467197,2,7,2.0,9,0.2222222222222222
99481394,2,7,2.0,9,0.2222222222222222
99495760,2,18,2.0,20,0.1
99519624,1,9,1.0,10,0.1
99580376,2,17,2.0,19,0.10526315789473684
99589613,2,18,2.0,20,0.1
99613541,1,9,1.0,10,0.1
99614723,9,1,1.0,10,0.1
99615478,7,3,3.0,10,0.3
99615905,24,5,5.0,29,0.1724137931034483
99640920,2,8,2.0,10,0.2
99649859,1,9,1.0,10,0.1
99658116,10,18,10.0,28,0.35714285714285715
99660190,1,8,1.0,9,0.1111111111111111
99664193,1,9,1.0,10,0.1
99665506,1,9,1.0,10,0.1
99673020,9,1,1.0,10,0.1
99673526,8,1,1.0,9,0.1111111111111111
99682974,3,7,3.0,10,0.3
99683135,3,7,3.0,10,0.3
99716622,5,5,5.0,10,0.5
99716802,2,8,2.0,10,0.2
99726047,4,5,4.0,9,0.4444444444444444
99729108,1,8,1.0,9,0.1111111111111111
99754623,2,6,2.0,8,0.25
99761558,1,7,1.0,8,0.125
99774339,1,8,1.0,9,0.1111111111111111
99787300,6,4,4.0,10,0.4
99789477,3,7,3.0,10,0.3
99790317,2,7,2.0,9,0.2222222222222222
99809813,1,17,1.0,18,0.05555555555555555
99809819,1,9,1.0,10,0.1
99821150,1,9,1.0,10,0.1
99825850,3,7,3.0,10,0.3
99833972,5,5,5.0,10,0.5
99836305,3,6,3.0,9,0.3333333333333333
99849241,2,8,2.0,10,0.2
99860219,1,9,1.0,10,0.1
99866685,3,7,3.0,10,0.3
99872131,4,15,4.0,19,0.21052631578947367
99881120,2,8,2.0,10,0.2
99882751,8,2,2.0,10,0.2
99883228,8,1,1.0,9,0.1111111111111111
99889047,3,7,3.0,10,0.3
99916600,2,7,2.0,9,0.2222222222222222
99925776,8,2,2.0,10,0.2
99926866,4,5,4.0,9,0.4444444444444444
99932689,1,12,1.0,13,0.07692307692307693
99946148,1,9,1.0,10,0.1
99972658,2,7,2.0,9,0.2222222222222222
99982623,1,9,1.0,10,0.1
99992855,1,8,1.0,9,0.1111111111111111
100031365,4,15,4.0,19,0.21052631578947367
100038261,1,7,1.0,8,0.125
100047200,2,8,2.0,10,0.2
100094366,1,17,1.0,18,0.05555555555555555
100094452,3,6,3.0,9,0.3333333333333333
100094552,2,8,2.0,10,0.2
100126852,1,18,1.0,19,0.05263157894736842
100129613,1,19,1.0,20,0.05
100129687,3,6,3.0,9,0.3333333333333333
100133817,7,3,3.0,10,0.3
100134295,4,25,4.0,29,0.13793103448275862
100169349,7,2,2.0,9,0.2222222222222222
100201374,2,17,2.0,19,0.10526315789473684
100210363,8,2,2.0,10,0.2
100215192,1,7,1.0,8,0.125
100216280,1,16,1.0,17,0.058823529411764705
100216389,9,1,1.0,10,0.1
100242903,1,7,1.0,8,0.125
100276741,1,7,1.0,8,0.125
100286349,5,5,5.0,10,0.5
100296855,1,7,1.0,8,0.125
100348040,1,8,1.0,9,0.1111111111111111
100352474,2,8,2.0,10,0.2
100354330,1,18,1.0,19,0.05263157894736842
100355169,1,17,1.0,18,0.05555555555555555
100357965,2,8,2.0,10,0.2
100370400,6,3,3.0,9,0.3333333333333333
100370577,1,8,1.0,9,0.1111111111111111
100370829,7,3,3.0,10,0.3
100371822,6,4,4.0,10,0.4
100372227,9,1,1.0,10,0.1
100383204,1,9,1.0,10,0.1
100406143,2,8,2.0,10,0.2
100478182,1,9,1.0,10,0.1
100495100,3,6,3.0,9,0.3333333333333333
100556236,8,2,2.0,10,0.2
100560400,7,1,1.0,8,0.125
100566834,2,8,2.0,10,0.2
100584951,1,17,1.0,18,0.05555555555555555
100587364,6,4,4.0,10,0.4
100630369,1,8,1.0,9,0.1111111111111111
100635496,2,7,2.0,9,0.2222222222222222
100660008,1,17,1.0,18,0.05555555555555555
100684506,1,9,1.0,10,0.1
100691029,1,8,1.0,9,0.1111111111111111
100729198,1,19,1.0,20,0.05
100750022,1,9,1.0,10,0.1
100804851,3,5,3.0,8,0.375
100810051,1,9,1.0,10,0.1
100814819,1,9,1.0,10,0.1
100817351,4,5,4.0,9,0.4444444444444444
100821353,1,19,1.0,20,0.05
100835055,2,7,2.0,9,0.2222222222222222
100854737,2,8,2.0,10,0.2
100858963,9,1,1.0,10,0.1
100891693,9,1,1.0,10,0.1
100894272,1,9,1.0,10,0.1
100898834,4,6,4.0,10,0.4
100900822,4,6,4.0,10,0.4
100979675,5,5,5.0,10,0.5
101001927,2,8,2.0,10,0.2
101003624,2,8,2.0,10,0.2
101032015,2,8,2.0,10,0.2
101061776,1,17,1.0,18,0.05555555555555555
101086646,1,19,1.0,20,0.05
101098201,1,9,1.0,10,0.1
101188551,2,16,2.0,18,0.1111111111111111
101193124,1,14,1.0,15,0.06666666666666667
101194322,1,8,1.0,9,0.1111111111111111
101196866,3,7,3.0,10,0.3
101198348,2,18,2.0,20,0.1
101219253,6,4,4.0,10,0.4
101223357,1,9,1.0,10,0.1
101224400,1,8,1.0,9,0.1111111111111111
101245964,2,8,2.0,10,0.2
101269824,1,9,1.0,10,0.1
101272207,4,6,4.0,10,0.4
101276798,2,8,2.0,10,0.2
101278069,1,7,1.0,8,0.125
101320278,1,9,1.0,10,0.1
101349403,5,3,3.0,8,0.375
101356781,1,17,1.0,18,0.05555555555555555
101357088,2,8,2.0,10,0.2
101371799,2,8,2.0,10,0.2
101382202,1,9,1.0,10,0.1
101406432,2,8,2.0,10,0.2
101407459,1,19,1.0,20,0.05
101421419,23,7,7.0,30,0.23333333333333334
101458447,1,19,1.0,20,0.05
101463030,7,3,3.0,10,0.3
101471351,1,9,1.0,10,0.1
101490281,1,18,1.0,19,0.05263157894736842
101518045,1,9,1.0,10,0.1
101529454,2,6,2.0,8,0.25
101548233,1,8,1.0,9,0.1111111111111111
101573786,1,9,1.0,10,0.1
101608125,1,9,1.0,10,0.1
101608226,2,7,2.0,9,0.2222222222222222
101611754,1,9,1.0,10,0.1
101634997,2,8,2.0,10,0.2
101643041,2,17,2.0,19,0.10526315789473684
101688710,2,8,2.0,10,0.2
101690209,2,7,2.0,9,0.2222222222222222
101692746,12,16,12.0,28,0.42857142857142855
101695113,1,8,1.0,9,0.1111111111111111
101700853,5,5,5.0,10,0.5
101706148,6,4,4.0,10,0.4
101711899,3,6,3.0,9,0.3333333333333333
101715970,2,8,2.0,10,0.2
101721622,1,19,1.0,20,0.05
101744921,1,9,1.0,10,0.1
101780073,3,7,3.0,10,0.3
101781437,1,8,1.0,9,0.1111111111111111
101785613,7,1,1.0,8,0.125
101808031,3,17,3.0,20,0.15
101817582,1,7,1.0,8,0.125
101840061,1,17,1.0,18,0.05555555555555555
101857248,6,4,4.0,10,0.4
101881131,1,8,1.0,9,0.1111111111111111
101910871,1,8,1.0,9,0.1111111111111111
101916378,4,6,4.0,10,0.4
101930467,6,22,6.0,28,0.21428571428571427
101932472,4,5,4.0,9,0.4444444444444444
101934770,3,5,3.0,8,0.375
101936335,1,9,1.0,10,0.1
101942812,1,19,1.0,20,0.05
101945221,4,5,4.0,9,0.4444444444444444
101946774,7,3,3.0,10,0.3
101950876,2,8,2.0,10,0.2
102000695,3,6,3.0,9,0.3333333333333333
102015116,1,19,1.0,20,0.05
102075841,1,8,1.0,9,0.1111111111111111
102081847,2,17,2.0,19,0.10526315789473684
102104755,1,18,1.0,19,0.05263157894736842
102115230,1,19,1.0,20,0.05
102126022,9,1,1.0,10,0.1
102136921,1,9,1.0,10,0.1
102141137,15,3,3.0,18,0.16666666666666666
102152591,8,2,2.0,10,0.2
102154008,4,6,4.0,10,0.4
102181600,1,9,1.0,10,0.1
102184533,26,3,3.0,29,0.10344827586206896
102184770,1,19,1.0,20,0.05
102188942,5,4,4.0,9,0.4444444444444444
102204944,7,13,7.0,20,0.35
102216643,9,10,9.0,19,0.47368421052631576
102220028,1,19,1.0,20,0.05
102291593,7,2,2.0,9,0.2222222222222222
102295748,1,8,1.0,9,0.1111111111111111
102302710,2,8,2.0,10,0.2
102324416,1,8,1.0,9,0.1111111111111111
102330106,3,7,3.0,10,0.3
102338648,2,8,2.0,10,0.2
102340884,9,1,1.0,10,0.1
102342516,4,6,4.0,10,0.4
102361351,1,8,1.0,9,0.1111111111111111
102388794,1,15,1.0,16,0.0625
102402390,2,6,2.0,8,0.25
102403449,2,8,2.0,10,0.2
102407701,8,2,2.0,10,0.2
102408249,2,8,2.0,10,0.2
102408527,6,4,4.0,10,0.4
102409086,4,4,4.0,8,0.5
102428539,1,7,1.0,8,0.125
102458951,1,8,1.0,9,0.1111111111111111
102466907,5,14,5.0,19,0.2631578947368421
102468194,2,6,2.0,8,0.25
102512974,1,9,1.0,10,0.1
102550051,1,8,1.0,9,0.1111111111111111
102577962,6,4,4.0,10,0.4
102610817,8,1,1.0,9,0.1111111111111111
102627241,3,17,3.0,20,0.15
102627777,1,9,1.0,10,0.1
102630380,2,17,2.0,19,0.10526315789473684
102644464,5,15,5.0,20,0.25
102661357,1,8,1.0,9,0.1111111111111111
102692273,1,19,1.0,20,0.05
102692465,8,1,1.0,9,0.1111111111111111
102739011,1,17,1.0,18,0.05555555555555555
102745293,7,1,1.0,8,0.125
102759111,2,17,2.0,19,0.10526315789473684
102763283,1,8,1.0,9,0.1111111111111111
102770083,2,8,2.0,10,0.2
102781275,1,8,1.0,9,0.1111111111111111
102812512,2,16,2.0,18,0.1111111111111111
102819716,5,5,5.0,10,0.5
102840062,2,8,2.0,10,0.2
102842293,1,9,1.0,10,0.1
102846914,8,2,2.0,10,0.2
102853616,1,9,1.0,10,0.1
102867285,6,4,4.0,10,0.4
102886816,7,12,7.0,19,0.3684210526315789
102919820,1,9,1.0,10,0.1
102927608,2,8,2.0,10,0.2
102935279,1,18,1.0,19,0.05263157894736842
102988872,2,8,2.0,10,0.2
102994337,1,8,1.0,9,0.1111111111111111
102995808,1,9,1.0,10,0.1
102997112,2,8,2.0,10,0.2
103008592,8,1,1.0,9,0.1111111111111111
103012348,9,1,1.0,10,0.1
103020092,7,2,2.0,9,0.2222222222222222
103029829,1,9,1.0,10,0.1
103039548,1,18,1.0,19,0.05263157894736842
103048426,13,13,13.0,26,0.5
103048650,4,5,4.0,9,0.4444444444444444
103113377,4,24,4.0,28,0.14285714285714285
103130531,1,8,1.0,9,0.1111111111111111
103144494,9,1,1.0,10,0.1
103153988,1,9,1.0,10,0.1
103154632,6,4,4.0,10,0.4
103164387,1,9,1.0,10,0.1
103177057,1,9,1.0,10,0.1
103253913,1,8,1.0,9,0.1111111111111111
103257796,1,9,1.0,10,0.1
103271869,1,19,1.0,20,0.05
103280174,6,23,6.0,29,0.20689655172413793
103280794,2,8,2.0,10,0.2
103281230,1,9,1.0,10,0.1
103281992,6,4,4.0,10,0.4
103284203,1,9,1.0,10,0.1
103292679,1,9,1.0,10,0.1
103293801,3,7,3.0,10,0.3
103295147,4,6,4.0,10,0.4
103297763,8,1,1.0,9,0.1111111111111111
103348410,2,6,2.0,8,0.25
103352485,1,9,1.0,10,0.1
103353087,6,4,4.0,10,0.4
103368243,8,2,2.0,10,0.2
103381660,8,12,8.0,20,0.4
103386435,1,9,1.0,10,0.1
103394490,2,14,2.0,16,0.125
103413752,1,9,1.0,10,0.1
103452654,1,18,1.0,19,0.05263157894736842
103455561,7,2,2.0,9,0.2222222222222222
103492084,2,7,2.0,9,0.2222222222222222
103495767,1,8,1.0,9,0.1111111111111111
103511298,2,8,2.0,10,0.2
103511501,1,20,1.0,21,0.047619047619047616
103540838,2,8,2.0,10,0.2
103551100,1,7,1.0,8,0.125
103559980,6,3,3.0,9,0.3333333333333333
103560349,4,6,4.0,10,0.4
103561062,2,7,2.0,9,0.2222222222222222
103570703,9,1,1.0,10,0.1
103631087,1,28,1.0,29,0.034482758620689655
103637028,1,9,1.0,10,0.1
103650735,2,8,2.0,10,0.2
103655971,1,8,1.0,9,0.1111111111111111
103657084,2,17,2.0,19,0.10526315789473684
103661031,1,18,1.0,19,0.05263157894736842
103704885,9,1,1.0,10,0.1
103706307,8,2,2.0,10,0.2
103706412,5,4,4.0,9,0.4444444444444444
103732312,1,18,1.0,19,0.05263157894736842
103773188,1,7,1.0,8,0.125
103778928,1,9,1.0,10,0.1
103785565,7,2,2.0,9,0.2222222222222222
103824567,5,5,5.0,10,0.5
103841904,1,9,1.0,10,0.1
103845477,1,8,1.0,9,0.1111111111111111
103846837,3,7,3.0,10,0.3
103857374,1,18,1.0,19,0.05263157894736842
103858720,5,4,4.0,9,0.4444444444444444
103876405,1,9,1.0,10,0.1
103885134,1,9,1.0,10,0.1
103885970,2,8,2.0,10,0.2
103886711,2,7,2.0,9,0.2222222222222222
103887773,1,9,1.0,10,0.1
103904536,3,7,3.0,10,0.3
103921600,4,5,4.0,9,0.4444444444444444
103937749,2,18,2.0,20,0.1
103961770,2,7,2.0,9,0.2222222222222222
103971153,1,18,1.0,19,0.05263157894736842
103984589,4,5,4.0,9,0.4444444444444444
103990359,1,8,1.0,9,0.1111111111111111
103991756,1,9,1.0,10,0.1
103992827,1,9,1.0,10,0.1
103995065,9,1,1.0,10,0.1
104004465,8,11,8.0,19,0.42105263157894735
104011480,1,16,1.0,17,0.058823529411764705
104029005,1,9,1.0,10,0.1
104029298,1,9,1.0,10,0.1
104044684,1,19,1.0,20,0.05
104048500,5,14,5.0,19,0.2631578947368421
104065386,3,7,3.0,10,0.3
104084917,1,8,1.0,9,0.1111111111111111
104090229,7,3,3.0,10,0.3
104098596,1,16,1.0,17,0.058823529411764705
104100153,4,5,4.0,9,0.4444444444444444
104105439,10,19,10.0,29,0.3448275862068966
104106414,1,9,1.0,10,0.1
104106768,1,8,1.0,9,0.1111111111111111
104118514,4,6,4.0,10,0.4
104123063,2,8,2.0,10,0.2
104125967,3,5,3.0,8,0.375
104130638,5,5,5.0,10,0.5
104141997,7,2,2.0,9,0.2222222222222222
104150853,7,3,3.0,10,0.3
104178991,1,9,1.0,10,0.1
104197694,1,8,1.0,9,0.1111111111111111
104202796,1,9,1.0,10,0.1
104230487,1,9,1.0,10,0.1
104250897,1,17,1.0,18,0.05555555555555555
104262340,8,1,1.0,9,0.1111111111111111
104262510,1,9,1.0,10,0.1
104281377,1,9,1.0,10,0.1
104289719,1,9,1.0,10,0.1
104291165,1,17,1.0,18,0.05555555555555555
104297460,6,4,4.0,10,0.4
104322853,2,6,2.0,8,0.25
104374570,1,8,1.0,9,0.1111111111111111
104413860,4,5,4.0,9,0.4444444444444444
104432504,3,7,3.0,10,0.3
104434084,3,6,3.0,9,0.3333333333333333
104438149,8,1,1.0,9,0.1111111111111111
104448963,1,9,1.0,10,0.1
104449143,1,8,1.0,9,0.1111111111111111
104459527,5,5,5.0,10,0.5
104479230,1,9,1.0,10,0.1
104501629,2,8,2.0,10,0.2
104526723,1,9,1.0,10,0.1
104529043,1,9,1.0,10,0.1
104570355,6,4,4.0,10,0.4
104573122,2,8,2.0,10,0.2
104583322,7,2,2.0,9,0.2222222222222222
104585438,1,8,1.0,9,0.1111111111111111
104586732,1,8,1.0,9,0.1111111111111111
104606116,7,2,2.0,9,0.2222222222222222
104649395,1,8,1.0,9,0.1111111111111111
104668874,3,7,3.0,10,0.3
104670131,2,6,2.0,8,0.25
104673416,2,26,2.0,28,0.07142857142857142
104677692,1,8,1.0,9,0.1111111111111111
104680988,2,7,2.0,9,0.2222222222222222
104688318,1,8,1.0,9,0.1111111111111111
104702134,1,8,1.0,9,0.1111111111111111
104702450,7,3,3.0,10,0.3
104702914,2,7,2.0,9,0.2222222222222222
104707174,1,9,1.0,10,0.1
104709467,1,7,1.0,8,0.125
104711131,6,4,4.0,10,0.4
104712694,1,8,1.0,9,0.1111111111111111
104727537,8,2,2.0,10,0.2
104735464,2,6,2.0,8,0.25
104736721,7,3,3.0,10,0.3
104740914,5,5,5.0,10,0.5
104761026,1,9,1.0,10,0.1
104768081,1,8,1.0,9,0.1111111111111111
104775466,28,2,2.0,30,0.06666666666666667
104794926,8,1,1.0,9,0.1111111111111111
104805565,2,8,2.0,10,0.2
104805773,16,14,14.0,30,0.4666666666666667
104805884,3,7,3.0,10,0.3
104806254,6,4,4.0,10,0.4
104831979,1,9,1.0,10,0.1
104832274,1,8,1.0,9,0.1111111111111111
104848839,1,9,1.0,10,0.1
104861135,1,17,1.0,18,0.05555555555555555
104861684,7,13,7.0,20,0.35
104873216,1,19,1.0,20,0.05
104881516,1,9,1.0,10,0.1
104881801,2,7,2.0,9,0.2222222222222222
104941331,1,18,1.0,19,0.05263157894736842
104945307,2,7,2.0,9,0.2222222222222222
104973795,6,4,4.0,10,0.4
104974299,5,5,5.0,10,0.5
104975461,8,2,2.0,10,0.2
104976139,8,1,1.0,9,0.1111111111111111
104989181,22,6,6.0,28,0.21428571428571427
105012945,9,1,1.0,10,0.1
105016810,9,1,1.0,10,0.1
105016956,23,6,6.0,29,0.20689655172413793
105026810,2,16,2.0,18,0.1111111111111111
105050808,4,5,4.0,9,0.4444444444444444
105052896,2,8,2.0,10,0.2
105053852,8,1,1.0,9,0.1111111111111111
105058056,1,9,1.0,10,0.1
105070567,3,7,3.0,10,0.3
105083137,1,9,1.0,10,0.1
105119244,1,9,1.0,10,0.1
105128929,1,8,1.0,9,0.1111111111111111
105131508,2,8,2.0,10,0.2
105133645,23,5,5.0,28,0.17857142857142858
105136093,4,6,4.0,10,0.4
105163503,9,1,1.0,10,0.1
105164684,1,9,1.0,10,0.1
105166761,10,9,9.0,19,0.47368421052631576
105168138,6,4,4.0,10,0.4
105169058,3,6,3.0,9,0.3333333333333333
105170019,5,5,5.0,10,0.5
105173339,6,4,4.0,10,0.4
105174234,1,8,1.0,9,0.1111111111111111
105181924,1,9,1.0,10,0.1
105195311,3,7,3.0,10,0.3
105199075,5,5,5.0,10,0.5
105200034,2,7,2.0,9,0.2222222222222222
105217483,1,28,1.0,29,0.034482758620689655
105220299,1,8,1.0,9,0.1111111111111111
105240882,2,8,2.0,10,0.2
105241792,7,2,2.0,9,0.2222222222222222
105243301,1,19,1.0,20,0.05
105245665,2,17,2.0,19,0.10526315789473684
105254421,3,6,3.0,9,0.3333333333333333
105269967,2,8,2.0,10,0.2
105280373,6,4,4.0,10,0.4
105302362,2,18,2.0,20,0.1
105304818,4,6,4.0,10,0.4
105309302,1,19,1.0,20,0.05
105348925,3,7,3.0,10,0.3
105349717,5,5,5.0,10,0.5
105350344,6,4,4.0,10,0.4
105350456,5,4,4.0,9,0.4444444444444444
105371000,18,1,1.0,19,0.05263157894736842
105394682,1,9,1.0,10,0.1
105406937,1,9,1.0,10,0.1
105431425,4,15,4.0,19,0.21052631578947367
105435266,8,11,8.0,19,0.42105263157894735
105446934,1,9,1.0,10,0.1
105458258,4,24,4.0,28,0.14285714285714285
105459745,5,3,3.0,8,0.375
105460045,3,6,3.0,9,0.3333333333333333
105460408,1,9,1.0,10,0.1
105463424,3,7,3.0,10,0.3
105463752,2,8,2.0,10,0.2
105464273,1,9,1.0,10,0.1
105466991,3,6,3.0,9,0.3333333333333333
105484402,8,1,1.0,9,0.1111111111111111
105492918,2,27,2.0,29,0.06896551724137931
105495564,1,8,1.0,9,0.1111111111111111
105499076,1,8,1.0,9,0.1111111111111111
105504134,6,3,3.0,9,0.3333333333333333
105507067,1,9,1.0,10,0.1
105507949,3,7,3.0,10,0.3
105509237,2,7,2.0,9,0.2222222222222222
105514102,2,7,2.0,9,0.2222222222222222
105561007,1,9,1.0,10,0.1
105580492,3,6,3.0,9,0.3333333333333333
105607605,1,9,1.0,10,0.1
105613578,3,7,3.0,10,0.3
105630314,1,19,1.0,20,0.05
105636848,1,8,1.0,9,0.1111111111111111
105675750,2,26,2.0,28,0.07142857142857142
105685983,1,8,1.0,9,0.1111111111111111
105688390,1,8,1.0,9,0.1111111111111111
105692808,5,5,5.0,10,0.5
105702771,6,13,6.0,19,0.3157894736842105
105703949,1,7,1.0,8,0.125
105721952,3,5,3.0,8,0.375
105744338,2,8,2.0,10,0.2
105748507,1,9,1.0,10,0.1
105770543,1,8,1.0,9,0.1111111111111111
105774214,3,6,3.0,9,0.3333333333333333
105786219,1,8,1.0,9,0.1111111111111111
105794115,9,17,9.0,26,0.34615384615384615
105795354,1,18,1.0,19,0.05263157894736842
105798432,4,4,4.0,8,0.5
105800115,17,12,12.0,29,0.41379310344827586
105801332,1,7,1.0,8,0.125
105812535,1,19,1.0,20,0.05
105818469,3,7,3.0,10,0.3
105835045,5,5,5.0,10,0.5
105862972,2,8,2.0,10,0.2
105864619,3,25,3.0,28,0.10714285714285714
105879687,3,7,3.0,10,0.3
105880738,1,9,1.0,10,0.1
105888072,1,9,1.0,10,0.1
105895476,2,7,2.0,9,0.2222222222222222
105907636,2,25,2.0,27,0.07407407407407407
105908725,2,8,2.0,10,0.2
105911505,1,18,1.0,19,0.05263157894736842
105911611,21,6,6.0,27,0.2222222222222222
105912594,4,24,4.0,28,0.14285714285714285
105920620,1,9,1.0,10,0.1
105957226,8,2,2.0,10,0.2
105957581,7,3,3.0,10,0.3
105957708,9,1,1.0,10,0.1
105957996,2,7,2.0,9,0.2222222222222222
105969400,1,8,1.0,9,0.1111111111111111
105996649,1,9,1.0,10,0.1
105999133,2,8,2.0,10,0.2
106006380,5,5,5.0,10,0.5
106006435,7,2,2.0,9,0.2222222222222222
106006893,1,9,1.0,10,0.1
106007925,5,22,5.0,27,0.18518518518518517
106024803,7,1,1.0,8,0.125
106035459,3,7,3.0,10,0.3
106037315,3,7,3.0,10,0.3
106040056,3,16,3.0,19,0.15789473684210525
106067330,1,9,1.0,10,0.1
106075429,1,18,1.0,19,0.05263157894736842
106082108,2,8,2.0,10,0.2
106087256,6,3,3.0,9,0.3333333333333333
106089485,2,7,2.0,9,0.2222222222222222
106093329,1,9,1.0,10,0.1
106097184,2,8,2.0,10,0.2
106100172,4,6,4.0,10,0.4
106151368,8,2,2.0,10,0.2
106156387,8,2,2.0,10,0.2
106158254,4,20,4.0,24,0.16666666666666666
106175870,1,18,1.0,19,0.05263157894736842
106208117,1,17,1.0,18,0.05555555555555555
106229824,1,9,1.0,10,0.1
106235227,1,8,1.0,9,0.1111111111111111
106255030,3,7,3.0,10,0.3
106257749,1,19,1.0,20,0.05
106273007,4,5,4.0,9,0.4444444444444444
106276089,2,8,2.0,10,0.2
106303297,8,2,2.0,10,0.2
106311678,1,18,1.0,19,0.05263157894736842
106328409,2,27,2.0,29,0.06896551724137931
106343625,1,9,1.0,10,0.1
106349300,2,8,2.0,10,0.2
106350627,3,16,3.0,19,0.15789473684210525
106360242,1,7,1.0,8,0.125
106361915,12,14,12.0,26,0.46153846153846156
106362478,2,8,2.0,10,0.2
106369648,1,9,1.0,10,0.1
106400547,2,7,2.0,9,0.2222222222222222
106404862,7,3,3.0,10,0.3
106408936,7,3,3.0,10,0.3
106419765,4,6,4.0,10,0.4
106426551,2,6,2.0,8,0.25
106430013,7,2,2.0,9,0.2222222222222222
106432421,5,5,5.0,10,0.5
106433343,1,9,1.0,10,0.1
106433765,5,5,5.0,10,0.5
106451460,4,5,4.0,9,0.4444444444444444
106454176,2,7,2.0,9,0.2222222222222222
106458603,3,7,3.0,10,0.3
106459687,2,8,2.0,10,0.2
106464372,1,8,1.0,9,0.1111111111111111
106465575,1,9,1.0,10,0.1
106467721,6,13,6.0,19,0.3157894736842105
106468923,9,1,1.0,10,0.1
106473959,1,8,1.0,9,0.1111111111111111
106490327,1,8,1.0,9,0.1111111111111111
106494881,5,5,5.0,10,0.5
106497149,8,1,1.0,9,0.1111111111111111
106540207,7,3,3.0,10,0.3
106540558,4,5,4.0,9,0.4444444444444444
106541476,2,7,2.0,9,0.2222222222222222
106546833,2,8,2.0,10,0.2
106555915,1,8,1.0,9,0.1111111111111111
106616697,8,2,2.0,10,0.2
106617639,7,3,3.0,10,0.3
106620755,2,8,2.0,10,0.2
106622320,1,9,1.0,10,0.1
106623584,1,9,1.0,10,0.1
106625811,1,9,1.0,10,0.1
106634500,1,19,1.0,20,0.05
106635250,5,5,5.0,10,0.5
106662837,1,9,1.0,10,0.1
106663287,5,5,5.0,10,0.5
106678727,1,18,1.0,19,0.05263157894736842
106680923,1,9,1.0,10,0.1
106690405,4,5,4.0,9,0.4444444444444444
106691668,1,9,1.0,10,0.1
106697319,1,9,1.0,10,0.1
106702350,1,8,1.0,9,0.1111111111111111
106703561,1,9,1.0,10,0.1
106705524,2,8,2.0,10,0.2
106709072,11,16,11.0,27,0.4074074074074074
106710435,7,3,3.0,10,0.3
106717045,1,18,1.0,19,0.05263157894736842
106756944,1,8,1.0,9,0.1111111111111111
106769652,3,25,3.0,28,0.10714285714285714
106789492,1,9,1.0,10,0.1
106794287,1,9,1.0,10,0.1
106829247,2,8,2.0,10,0.2
106840078,1,9,1.0,10,0.1
106848695,3,7,3.0,10,0.3
106859548,4,6,4.0,10,0.4
106873998,5,5,5.0,10,0.5
106897036,5,5,5.0,10,0.5
106918995,9,1,1.0,10,0.1
106924530,1,9,1.0,10,0.1
106928368,4,6,4.0,10,0.4
106930134,2,8,2.0,10,0.2
106938454,1,8,1.0,9,0.1111111111111111
106939405,1,8,1.0,9,0.1111111111111111
106953907,5,5,5.0,10,0.5
106971995,3,7,3.0,10,0.3
106976916,2,8,2.0,10,0.2
106978042,1,8,1.0,9,0.1111111111111111
106979839,1,8,1.0,9,0.1111111111111111
106982983,2,17,2.0,19,0.10526315789473684
107003476,2,8,2.0,10,0.2
107003838,5,5,5.0,10,0.5
107006458,7,3,3.0,10,0.3
107011204,8,1,1.0,9,0.1111111111111111
107011776,13,14,13.0,27,0.48148148148148145
107020623,1,9,1.0,10,0.1
107055845,1,9,1.0,10,0.1
107119088,1,9,1.0,10,0.1
107145080,1,8,1.0,9,0.1111111111111111
107184206,1,18,1.0,19,0.05263157894736842
107185075,4,6,4.0,10,0.4
107187884,1,9,1.0,10,0.1
107192929,6,3,3.0,9,0.3333333333333333
107206800,2,7,2.0,9,0.2222222222222222
107210932,1,8,1.0,9,0.1111111111111111
107211574,1,9,1.0,10,0.1
107213327,4,24,4.0,28,0.14285714285714285
107231866,3,7,3.0,10,0.3
107232627,5,4,4.0,9,0.4444444444444444
107248802,1,8,1.0,9,0.1111111111111111
107250678,1,9,1.0,10,0.1
107256568,1,9,1.0,10,0.1
107257284,1,9,1.0,10,0.1
107272554,1,9,1.0,10,0.1
107272720,10,9,9.0,19,0.47368421052631576
107275091,1,7,1.0,8,0.125
107296429,2,16,2.0,18,0.1111111111111111
107314325,1,26,1.0,27,0.037037037037037035
107315087,4,6,4.0,10,0.4
107316274,1,8,1.0,9,0.1111111111111111
107340305,1,17,1.0,18,0.05555555555555555
107349014,3,7,3.0,10,0.3
107349173,2,8,2.0,10,0.2
107356908,1,8,1.0,9,0.1111111111111111
107376891,4,5,4.0,9,0.4444444444444444
107379255,3,7,3.0,10,0.3
107404575,1,19,1.0,20,0.05
107409005,1,8,1.0,9,0.1111111111111111
107425824,1,9,1.0,10,0.1
107517227,4,6,4.0,10,0.4
107549316,1,9,1.0,10,0.1
107572767,2,8,2.0,10,0.2
107600936,2,18,2.0,20,0.1
107604293,3,6,3.0,9,0.3333333333333333
107610321,1,8,1.0,9,0.1111111111111111
107664373,5,5,5.0,10,0.5
107716899,2,7,2.0,9,0.2222222222222222
107720047,2,8,2.0,10,0.2
107720263,5,3,3.0,8,0.375
107720440,9,1,1.0,10,0.1
107720591,4,4,4.0,8,0.5
107721169,21,7,7.0,28,0.25
107721859,7,20,7.0,27,0.25925925925925924
107722431,3,7,3.0,10,0.3
107726099,8,1,1.0,9,0.1111111111111111
107726406,3,7,3.0,10,0.3
107737666,2,17,2.0,19,0.10526315789473684
107746368,2,7,2.0,9,0.2222222222222222
107746591,5,5,5.0,10,0.5
107746981,4,5,4.0,9,0.4444444444444444
107748364,8,2,2.0,10,0.2
107749957,6,4,4.0,10,0.4
107751083,3,7,3.0,10,0.3
107771340,1,8,1.0,9,0.1111111111111111
107771946,1,9,1.0,10,0.1
107778516,2,6,2.0,8,0.25
107779211,3,6,3.0,9,0.3333333333333333
107781819,2,8,2.0,10,0.2
107782149,17,9,9.0,26,0.34615384615384615
107797584,1,9,1.0,10,0.1
107797704,2,17,2.0,19,0.10526315789473684
107813456,18,11,11.0,29,0.3793103448275862
107822190,3,16,3.0,19,0.15789473684210525
107847359,7,3,3.0,10,0.3
107854904,1,8,1.0,9,0.1111111111111111
107887420,2,8,2.0,10,0.2
107889068,11,12,11.0,23,0.4782608695652174
107889304,3,6,3.0,9,0.3333333333333333
107908961,1,9,1.0,10,0.1
107911259,1,8,1.0,9,0.1111111111111111
107921758,1,19,1.0,20,0.05
107945491,1,8,1.0,9,0.1111111111111111
107955029,6,21,6.0,27,0.2222222222222222
107959571,2,6,2.0,8,0.25
107960493,6,2,2.0,8,0.25
107979184,1,8,1.0,9,0.1111111111111111
107983613,8,2,2.0,10,0.2
107984024,10,19,10.0,29,0.3448275862068966
107985346,1,9,1.0,10,0.1
107986646,2,8,2.0,10,0.2
107986853,5,5,5.0,10,0.5
107988551,6,4,4.0,10,0.4
107989491,2,7,2.0,9,0.2222222222222222
107990742,3,7,3.0,10,0.3
107997941,2,7,2.0,9,0.2222222222222222
108005554,1,19,1.0,20,0.05
108024093,3,7,3.0,10,0.3
108033510,2,8,2.0,10,0.2
108035381,3,15,3.0,18,0.16666666666666666
108067167,1,9,1.0,10,0.1
108094798,1,8,1.0,9,0.1111111111111111
108120064,3,23,3.0,26,0.11538461538461539
108125415,1,19,1.0,20,0.05
108129560,8,1,1.0,9,0.1111111111111111
108129784,25,3,3.0,28,0.10714285714285714
108145091,1,17,1.0,18,0.05555555555555555
108151074,1,28,1.0,29,0.034482758620689655
108154182,3,7,3.0,10,0.3
108159720,1,9,1.0,10,0.1
108186859,3,7,3.0,10,0.3
108192308,2,8,2.0,10,0.2
108211920,1,9,1.0,10,0.1
108213372,1,8,1.0,9,0.1111111111111111
108217134,4,14,4.0,18,0.2222222222222222
108231863,2,8,2.0,10,0.2
108236018,1,7,1.0,8,0.125
108240716,4,6,4.0,10,0.4
108241054,2,8,2.0,10,0.2
108247734,2,7,2.0,9,0.2222222222222222
108255357,5,5,5.0,10,0.5
108257182,1,9,1.0,10,0.1
108257543,1,8,1.0,9,0.1111111111111111
108257730,3,7,3.0,10,0.3
108282284,1,9,1.0,10,0.1
108299578,2,7,2.0,9,0.2222222222222222
108305023,2,8,2.0,10,0.2
108310436,4,24,4.0,28,0.14285714285714285
108317026,1,8,1.0,9,0.1111111111111111
108317444,2,7,2.0,9,0.2222222222222222
108320649,1,9,1.0,10,0.1
108324659,3,7,3.0,10,0.3
108325644,1,9,1.0,10,0.1
108332654,2,8,2.0,10,0.2
108333270,1,9,1.0,10,0.1
108335241,4,6,4.0,10,0.4
108350725,2,8,2.0,10,0.2
108387204,3,7,3.0,10,0.3
108390085,2,7,2.0,9,0.2222222222222222
108392396,4,6,4.0,10,0.4
108395212,3,26,3.0,29,0.10344827586206896
108396784,1,9,1.0,10,0.1
108400317,1,9,1.0,10,0.1
108402603,3,7,3.0,10,0.3
108403948,1,8,1.0,9,0.1111111111111111
108416656,2,16,2.0,18,0.1111111111111111
108460267,4,6,4.0,10,0.4
108477086,1,8,1.0,9,0.1111111111111111
108482637,3,7,3.0,10,0.3
108489155,1,9,1.0,10,0.1
108491188,9,1,1.0,10,0.1
108491663,9,1,1.0,10,0.1
108492088,6,4,4.0,10,0.4
108492834,7,3,3.0,10,0.3
108517867,2,17,2.0,19,0.10526315789473684
108527026,7,3,3.0,10,0.3
108539193,1,9,1.0,10,0.1
108543215,1,9,1.0,10,0.1
108547729,4,6,4.0,10,0.4
108547896,2,7,2.0,9,0.2222222222222222
108548753,2,13,2.0,15,0.13333333333333333
108549586,3,7,3.0,10,0.3
108563962,1,8,1.0,9,0.1111111111111111
108576758,4,6,4.0,10,0.4
108591632,6,4,4.0,10,0.4
108614099,3,5,3.0,8,0.375
108623470,3,6,3.0,9,0.3333333333333333
108653825,3,6,3.0,9,0.3333333333333333
108656594,1,8,1.0,9,0.1111111111111111
108657198,2,18,2.0,20,0.1
108669872,1,9,1.0,10,0.1
108673895,1,8,1.0,9,0.1111111111111111
108674689,1,8,1.0,9,0.1111111111111111
108679437,1,9,1.0,10,0.1
108680275,3,26,3.0,29,0.10344827586206896
108680488,1,17,1.0,18,0.05555555555555555
108712444,4,24,4.0,28,0.14285714285714285
108713290,7,3,3.0,10,0.3
108719443,1,9,1.0,10,0.1
108738226,1,9,1.0,10,0.1
108782557,6,3,3.0,9,0.3333333333333333
108788312,2,8,2.0,10,0.2
108798987,5,4,4.0,9,0.4444444444444444
108799439,1,8,1.0,9,0.1111111111111111
108813074,2,8,2.0,10,0.2
108813129,2,7,2.0,9,0.2222222222222222
108813952,1,9,1.0,10,0.1
108816243,9,1,1.0,10,0.1
108844708,3,6,3.0,9,0.3333333333333333
108854641,1,9,1.0,10,0.1
108875354,1,9,1.0,10,0.1
108880476,2,8,2.0,10,0.2
108882059,3,6,3.0,9,0.3333333333333333
108909249,2,8,2.0,10,0.2
108921731,3,7,3.0,10,0.3
108922725,1,8,1.0,9,0.1111111111111111
108987857,2,8,2.0,10,0.2
109007979,1,18,1.0,19,0.05263157894736842
109020689,1,9,1.0,10,0.1
109052696,2,27,2.0,29,0.06896551724137931
109072527,1,17,1.0,18,0.05555555555555555
109074799,6,3,3.0,9,0.3333333333333333
109075785,2,8,2.0,10,0.2
109085987,1,19,1.0,20,0.05
109108007,1,9,1.0,10,0.1
109109391,4,6,4.0,10,0.4
109110326,1,17,1.0,18,0.05555555555555555
109137319,1,9,1.0,10,0.1
109153176,9,1,1.0,10,0.1
109154278,1,7,1.0,8,0.125
109162467,6,3,3.0,9,0.3333333333333333
109178872,1,9,1.0,10,0.1
109191402,6,4,4.0,10,0.4
109192877,7,2,2.0,9,0.2222222222222222
109206283,3,7,3.0,10,0.3
109209671,2,7,2.0,9,0.2222222222222222
109211432,3,7,3.0,10,0.3
109218538,2,6,2.0,8,0.25
109237334,24,4,4.0,28,0.14285714285714285
109237629,8,2,2.0,10,0.2
109240059,8,2,2.0,10,0.2
109240413,3,5,3.0,8,0.375
109241109,7,2,2.0,9,0.2222222222222222
109241139,2,7,2.0,9,0.2222222222222222
109242647,6,3,3.0,9,0.3333333333333333
109242658,3,7,3.0,10,0.3
109244265,3,7,3.0,10,0.3
109248263,3,6,3.0,9,0.3333333333333333
109254135,1,8,1.0,9,0.1111111111111111
109256707,2,8,2.0,10,0.2
109257422,2,8,2.0,10,0.2
109257724,3,6,3.0,9,0.3333333333333333
109258045,4,16,4.0,20,0.2
109260587,2,8,2.0,10,0.2
109266962,5,5,5.0,10,0.5
109274681,1,17,1.0,18,0.05555555555555555
109319327,1,19,1.0,20,0.05
109327001,1,9,1.0,10,0.1
109329438,5,5,5.0,10,0.5
109330461,1,9,1.0,10,0.1
109331473,7,3,3.0,10,0.3
109339302,1,9,1.0,10,0.1
109345761,2,6,2.0,8,0.25
109352998,5,3,3.0,8,0.375
109358805,1,8,1.0,9,0.1111111111111111
109361807,1,9,1.0,10,0.1
109362273,5,5,5.0,10,0.5
109365690,3,6,3.0,9,0.3333333333333333
109367307,2,8,2.0,10,0.2
109396929,3,7,3.0,10,0.3
109407592,7,2,2.0,9,0.2222222222222222
109409103,5,4,4.0,9,0.4444444444444444
109411804,6,22,6.0,28,0.21428571428571427
109415895,1,9,1.0,10,0.1
109419711,8,1,1.0,9,0.1111111111111111
109426324,4,6,4.0,10,0.4
109426474,3,5,3.0,8,0.375
109426759,9,1,1.0,10,0.1
109427069,1,9,1.0,10,0.1
109434381,4,6,4.0,10,0.4
109434749,1,9,1.0,10,0.1
109437670,1,9,1.0,10,0.1
109449545,1,18,1.0,19,0.05263157894736842
109482361,2,7,2.0,9,0.2222222222222222
109482815,6,4,4.0,10,0.4
109486301,1,8,1.0,9,0.1111111111111111
109490326,2,8,2.0,10,0.2
109492093,1,9,1.0,10,0.1
109495100,7,3,3.0,10,0.3
109499655,1,9,1.0,10,0.1
109515815,1,7,1.0,8,0.125
109544034,6,4,4.0,10,0.4
109544338,1,9,1.0,10,0.1
109555944,1,9,1.0,10,0.1
109557105,1,8,1.0,9,0.1111111111111111
109574347,1,18,1.0,19,0.05263157894736842
109580884,8,2,2.0,10,0.2
109587159,5,5,5.0,10,0.5
109587256,3,14,3.0,17,0.17647058823529413
109591734,1,28,1.0,29,0.034482758620689655
109595108,7,3,3.0,10,0.3
109600643,2,8,2.0,10,0.2
109603217,2,7,2.0,9,0.2222222222222222
109605619,5,3,3.0,8,0.375
109622759,2,7,2.0,9,0.2222222222222222
109630124,1,8,1.0,9,0.1111111111111111
109646520,3,5,3.0,8,0.375
109648116,11,7,7.0,18,0.3888888888888889
109654408,4,5,4.0,9,0.4444444444444444
109657330,2,18,2.0,20,0.1
109662699,2,27,2.0,29,0.06896551724137931
109669447,1,19,1.0,20,0.05
109670079,1,9,1.0,10,0.1
109673111,6,2,2.0,8,0.25
109693625,2,8,2.0,10,0.2
109713609,1,9,1.0,10,0.1
109713888,5,23,5.0,28,0.17857142857142858
109715704,3,6,3.0,9,0.3333333333333333
109716252,1,8,1.0,9,0.1111111111111111
109717374,3,7,3.0,10,0.3
109722516,3,15,3.0,18,0.16666666666666666
109723387,1,8,1.0,9,0.1111111111111111
109738808,5,25,5.0,30,0.16666666666666666
109743914,2,8,2.0,10,0.2
109746045,1,8,1.0,9,0.1111111111111111
109748222,2,8,2.0,10,0.2
109749275,1,9,1.0,10,0.1
109749429,8,2,2.0,10,0.2
109756491,3,15,3.0,18,0.16666666666666666
109756755,3,5,3.0,8,0.375
109762680,5,5,5.0,10,0.5
109769548,4,21,4.0,25,0.16
109784433,3,7,3.0,10,0.3
109785726,2,8,2.0,10,0.2
109794781,2,15,2.0,17,0.11764705882352941
109798008,1,8,1.0,9,0.1111111111111111
109804090,4,6,4.0,10,0.4
109812317,1,9,1.0,10,0.1
109824105,9,1,1.0,10,0.1
109824507,8,2,2.0,10,0.2
109846353,3,15,3.0,18,0.16666666666666666
109848051,2,8,2.0,10,0.2
109848709,4,6,4.0,10,0.4
109849999,9,1,1.0,10,0.1
109851131,7,2,2.0,9,0.2222222222222222
109852186,8,2,2.0,10,0.2
109863684,22,8,8.0,30,0.26666666666666666
109863852,4,5,4.0,9,0.4444444444444444
109864158,2,8,2.0,10,0.2
109874009,2,7,2.0,9,0.2222222222222222
109886400,2,6,2.0,8,0.25
109898234,3,7,3.0,10,0.3
109913233,2,17,2.0,19,0.10526315789473684
109913390,7,2,2.0,9,0.2222222222222222
109930560,3,5,3.0,8,0.375
109938475,4,5,4.0,9,0.4444444444444444
109940778,6,3,3.0,9,0.3333333333333333
109947108,1,18,1.0,19,0.05263157894736842
109947821,1,7,1.0,8,0.125
109964284,1,9,1.0,10,0.1
109970978,6,4,4.0,10,0.4
109971909,2,8,2.0,10,0.2
109972720,2,8,2.0,10,0.2
109976449,3,16,3.0,19,0.15789473684210525
109992723,9,1,1.0,10,0.1
109997246,2,8,2.0,10,0.2
110018389,6,4,4.0,10,0.4
110023019,2,8,2.0,10,0.2
110036140,1,18,1.0,19,0.05263157894736842
110038816,2,8,2.0,10,0.2
110045298,1,9,1.0,10,0.1
110061557,1,8,1.0,9,0.1111111111111111
110067029,1,8,1.0,9,0.1111111111111111
110074779,5,15,5.0,20,0.25
110092999,1,9,1.0,10,0.1
110110268,8,2,2.0,10,0.2
110112983,3,7,3.0,10,0.3
110126628,1,9,1.0,10,0.1
110126865,2,7,2.0,9,0.2222222222222222
110128938,1,9,1.0,10,0.1
110133100,5,23,5.0,28,0.17857142857142858
110138733,8,2,2.0,10,0.2
110139868,7,2,2.0,9,0.2222222222222222
110194315,1,8,1.0,9,0.1111111111111111
110263034,1,8,1.0,9,0.1111111111111111
110263820,1,8,1.0,9,0.1111111111111111
110263867,1,7,1.0,8,0.125
110264335,2,8,2.0,10,0.2
110265934,9,11,9.0,20,0.45
110271206,2,7,2.0,9,0.2222222222222222
110310543,2,8,2.0,10,0.2
110331634,8,1,1.0,9,0.1111111111111111
110334583,3,6,3.0,9,0.3333333333333333
110338919,2,7,2.0,9,0.2222222222222222
110339701,5,5,5.0,10,0.5
110349461,1,28,1.0,29,0.034482758620689655
110365021,1,9,1.0,10,0.1
110365468,4,16,4.0,20,0.2
110367126,1,9,1.0,10,0.1
110371076,1,19,1.0,20,0.05
110383778,2,8,2.0,10,0.2
110393847,1,9,1.0,10,0.1
110394473,8,21,8.0,29,0.27586206896551724
110416386,4,6,4.0,10,0.4
110439204,3,7,3.0,10,0.3
110440114,4,5,4.0,9,0.4444444444444444
110461873,2,8,2.0,10,0.2
110464861,2,8,2.0,10,0.2
110479484,2,6,2.0,8,0.25
110508906,9,1,1.0,10,0.1
110516285,1,19,1.0,20,0.05
110542577,8,2,2.0,10,0.2
110545862,18,9,9.0,27,0.3333333333333333
110546186,4,6,4.0,10,0.4
110547024,6,4,4.0,10,0.4
110547677,7,3,3.0,10,0.3
110580326,2,8,2.0,10,0.2
110580452,1,9,1.0,10,0.1
110587228,1,8,1.0,9,0.1111111111111111
110617640,1,16,1.0,17,0.058823529411764705
110621362,1,17,1.0,18,0.05555555555555555
110655525,6,14,6.0,20,0.3
110657746,5,14,5.0,19,0.2631578947368421
110661388,9,1,1.0,10,0.1
110665598,6,4,4.0,10,0.4
110667471,1,9,1.0,10,0.1
110667835,7,22,7.0,29,0.2413793103448276
110683196,9,1,1.0,10,0.1
110723182,1,17,1.0,18,0.05555555555555555
110735567,6,3,3.0,9,0.3333333333333333
110772730,2,7,2.0,9,0.2222222222222222
110785411,5,5,5.0,10,0.5
110793830,1,9,1.0,10,0.1
110801764,1,8,1.0,9,0.1111111111111111
110829821,6,4,4.0,10,0.4
110831697,2,8,2.0,10,0.2
110836916,3,7,3.0,10,0.3
110851333,2,8,2.0,10,0.2
110870152,1,9,1.0,10,0.1
110878791,9,1,1.0,10,0.1
110890679,1,18,1.0,19,0.05263157894736842
110909993,6,3,3.0,9,0.3333333333333333
110917917,3,7,3.0,10,0.3
110927409,4,16,4.0,20,0.2
110930051,1,8,1.0,9,0.1111111111111111
110931128,1,8,1.0,9,0.1111111111111111
110947254,2,7,2.0,9,0.2222222222222222
110973275,3,5,3.0,8,0.375
110978285,14,15,14.0,29,0.4827586206896552
110985806,4,4,4.0,8,0.5
110991331,14,15,14.0,29,0.4827586206896552
111012623,16,13,13.0,29,0.4482758620689655
111014466,3,25,3.0,28,0.10714285714285714
111015976,1,9,1.0,10,0.1
111028321,1,28,1.0,29,0.034482758620689655
111042855,3,7,3.0,10,0.3
111055980,1,18,1.0,19,0.05263157894736842
111069547,2,8,2.0,10,0.2
111077418,3,16,3.0,19,0.15789473684210525
111082178,3,7,3.0,10,0.3
111083364,4,6,4.0,10,0.4
111083453,2,8,2.0,10,0.2
111085454,1,9,1.0,10,0.1
111088495,1,8,1.0,9,0.1111111111111111
111091751,1,8,1.0,9,0.1111111111111111
111092552,4,6,4.0,10,0.4
111110875,8,2,2.0,10,0.2
111112123,5,4,4.0,9,0.4444444444444444
111141580,1,9,1.0,10,0.1
111166997,5,5,5.0,10,0.5
111181905,4,4,4.0,8,0.5
111182555,6,4,4.0,10,0.4
111183876,1,9,1.0,10,0.1
111185071,4,6,4.0,10,0.4
111186092,2,8,2.0,10,0.2
111195216,5,5,5.0,10,0.5
111195278,1,18,1.0,19,0.05263157894736842
111208470,1,9,1.0,10,0.1
111213530,2,18,2.0,20,0.1
111219589,6,4,4.0,10,0.4
111244186,2,8,2.0,10,0.2
111245666,2,8,2.0,10,0.2
111249095,3,6,3.0,9,0.3333333333333333
111252348,1,7,1.0,8,0.125
111297571,1,9,1.0,10,0.1
111320593,1,19,1.0,20,0.05
111320751,1,7,1.0,8,0.125
111330309,27,1,1.0,28,0.03571428571428571
111330583,2,7,2.0,9,0.2222222222222222
111332626,9,1,1.0,10,0.1
111364718,1,9,1.0,10,0.1
111378154,1,8,1.0,9,0.1111111111111111
111395100,5,5,5.0,10,0.5
111399274,2,8,2.0,10,0.2
111405278,1,9,1.0,10,0.1
111414172,3,6,3.0,9,0.3333333333333333
111433890,1,18,1.0,19,0.05263157894736842
111446883,1,8,1.0,9,0.1111111111111111
111453559,1,7,1.0,8,0.125
111454360,1,9,1.0,10,0.1
111457309,4,25,4.0,29,0.13793103448275862
111461635,1,9,1.0,10,0.1
111465363,1,9,1.0,10,0.1
111488227,2,8,2.0,10,0.2
111500529,1,9,1.0,10,0.1
111507157,1,9,1.0,10,0.1
111518531,1,9,1.0,10,0.1
111545642,3,6,3.0,9,0.3333333333333333
111548081,2,8,2.0,10,0.2
111552592,1,9,1.0,10,0.1
111576247,5,5,5.0,10,0.5
111576520,25,2,2.0,27,0.07407407407407407
111578046,1,8,1.0,9,0.1111111111111111
111603474,3,15,3.0,18,0.16666666666666666
111612580,6,3,3.0,9,0.3333333333333333
111633376,1,9,1.0,10,0.1
111644166,9,11,9.0,20,0.45
111646397,2,8,2.0,10,0.2
111658563,1,9,1.0,10,0.1
111666702,3,7,3.0,10,0.3
111682197,1,9,1.0,10,0.1
111684435,3,7,3.0,10,0.3
111687756,8,2,2.0,10,0.2
111701388,2,7,2.0,9,0.2222222222222222
111704773,4,6,4.0,10,0.4
111707523,3,7,3.0,10,0.3
111710498,1,9,1.0,10,0.1
111721804,1,9,1.0,10,0.1
111721999,1,8,1.0,9,0.1111111111111111
111739983,1,9,1.0,10,0.1
111753557,5,5,5.0,10,0.5
111756065,4,6,4.0,10,0.4
111756857,2,8,2.0,10,0.2
111758140,1,9,1.0,10,0.1
111758512,7,20,7.0,27,0.25925925925925924
111758759,2,8,2.0,10,0.2
111759285,2,8,2.0,10,0.2
111761058,6,3,3.0,9,0.3333333333333333
111762321,4,15,4.0,19,0.21052631578947367
111772550,1,9,1.0,10,0.1
111794940,6,14,6.0,20,0.3
111804879,2,8,2.0,10,0.2
111805371,2,7,2.0,9,0.2222222222222222
111822040,10,10,10.0,20,0.5
111822226,1,9,1.0,10,0.1
111824359,1,9,1.0,10,0.1
111826257,1,9,1.0,10,0.1
111831912,3,7,3.0,10,0.3
111875038,1,8,1.0,9,0.1111111111111111
111880310,1,9,1.0,10,0.1
111902200,1,9,1.0,10,0.1
111903370,4,6,4.0,10,0.4
111904134,3,16,3.0,19,0.15789473684210525
111905784,3,6,3.0,9,0.3333333333333333
111906109,7,2,2.0,9,0.2222222222222222
111907165,22,8,8.0,30,0.26666666666666666
111908701,3,7,3.0,10,0.3
111911249,3,7,3.0,10,0.3
111917653,2,26,2.0,28,0.07142857142857142
111966664,2,8,2.0,10,0.2
111973202,7,1,1.0,8,0.125
111987141,1,19,1.0,20,0.05
111994571,6,13,6.0,19,0.3157894736842105
112059855,1,18,1.0,19,0.05263157894736842
112073909,7,3,3.0,10,0.3
112082606,1,18,1.0,19,0.05263157894736842
112084167,1,8,1.0,9,0.1111111111111111
112108227,1,9,1.0,10,0.1
112111566,2,8,2.0,10,0.2
112111690,2,7,2.0,9,0.2222222222222222
112112361,3,16,3.0,19,0.15789473684210525
112131451,1,18,1.0,19,0.05263157894736842
112150689,1,9,1.0,10,0.1
112154841,2,8,2.0,10,0.2
112174855,1,17,1.0,18,0.05555555555555555
112184565,7,3,3.0,10,0.3
112186889,1,9,1.0,10,0.1
112201778,1,9,1.0,10,0.1
112209580,3,7,3.0,10,0.3
112241751,9,1,1.0,10,0.1
112243143,14,6,6.0,20,0.3
112261337,2,8,2.0,10,0.2
112261903,4,5,4.0,9,0.4444444444444444
112262083,2,8,2.0,10,0.2
112264246,3,6,3.0,9,0.3333333333333333
112265749,3,7,3.0,10,0.3
112266926,6,4,4.0,10,0.4
112267229,1,9,1.0,10,0.1
112267349,1,9,1.0,10,0.1
112271145,17,12,12.0,29,0.41379310344827586
112273300,7,3,3.0,10,0.3
112273319,1,8,1.0,9,0.1111111111111111
112276596,2,8,2.0,10,0.2
112291442,4,6,4.0,10,0.4
112304325,3,5,3.0,8,0.375
112327201,1,19,1.0,20,0.05
112328769,1,9,1.0,10,0.1
112334137,2,7,2.0,9,0.2222222222222222
112343026,1,18,1.0,19,0.05263157894736842
112352376,1,17,1.0,18,0.05555555555555555
112390619,3,7,3.0,10,0.3
112392097,2,8,2.0,10,0.2
112393322,1,9,1.0,10,0.1
112394689,8,2,2.0,10,0.2
112395891,1,9,1.0,10,0.1
112398550,1,9,1.0,10,0.1
112452367,7,13,7.0,20,0.35
112460397,2,8,2.0,10,0.2
112464411,9,1,1.0,10,0.1
112467055,1,8,1.0,9,0.1111111111111111
112467627,1,9,1.0,10,0.1
112471575,2,18,2.0,20,0.1
112484200,1,19,1.0,20,0.05
112489693,10,16,10.0,26,0.38461538461538464
112491190,6,4,4.0,10,0.4
112492093,3,6,3.0,9,0.3333333333333333
112492836,7,3,3.0,10,0.3
112505829,2,7,2.0,9,0.2222222222222222
112508460,5,3,3.0,8,0.375
112508465,6,3,3.0,9,0.3333333333333333
112537981,3,7,3.0,10,0.3
112539828,3,7,3.0,10,0.3
112542302,7,1,1.0,8,0.125
112542327,7,2,2.0,9,0.2222222222222222
112542718,7,2,2.0,9,0.2222222222222222
112543095,9,18,9.0,27,0.3333333333333333
112543438,2,7,2.0,9,0.2222222222222222
112544019,2,8,2.0,10,0.2
112544116,8,2,2.0,10,0.2
112546710,1,9,1.0,10,0.1
112552688,1,9,1.0,10,0.1
112553887,2,8,2.0,10,0.2
112572250,1,9,1.0,10,0.1
112588765,1,19,1.0,20,0.05
112590768,1,9,1.0,10,0.1
112596762,5,5,5.0,10,0.5
112599678,3,7,3.0,10,0.3
112603771,5,5,5.0,10,0.5
112635219,2,7,2.0,9,0.2222222222222222
112635490,2,8,2.0,10,0.2
112640207,2,28,2.0,30,0.06666666666666667
112640664,2,7,2.0,9,0.2222222222222222
112641331,7,1,1.0,8,0.125
112645605,2,8,2.0,10,0.2
112648968,2,8,2.0,10,0.2
112656032,1,7,1.0,8,0.125
112657052,1,7,1.0,8,0.125
112661805,1,18,1.0,19,0.05263157894736842
112691656,1,18,1.0,19,0.05263157894736842
112699275,1,8,1.0,9,0.1111111111111111
112699953,4,14,4.0,18,0.2222222222222222
112706670,4,15,4.0,19,0.21052631578947367
112735222,1,9,1.0,10,0.1
112737971,1,9,1.0,10,0.1
112754386,1,18,1.0,19,0.05263157894736842
112764900,1,19,1.0,20,0.05
112768606,8,2,2.0,10,0.2
112769498,1,9,1.0,10,0.1
112777024,1,9,1.0,10,0.1
112811334,1,19,1.0,20,0.05
112813391,7,2,2.0,9,0.2222222222222222
112814895,1,9,1.0,10,0.1
112815778,7,22,7.0,29,0.2413793103448276
112825283,1,19,1.0,20,0.05
112837206,3,7,3.0,10,0.3
112837355,1,8,1.0,9,0.1111111111111111
112837962,7,20,7.0,27,0.25925925925925924
112838855,4,6,4.0,10,0.4
112838925,22,8,8.0,30,0.26666666666666666
112839353,4,6,4.0,10,0.4
112846277,8,2,2.0,10,0.2
112854061,2,18,2.0,20,0.1
112861879,3,27,3.0,30,0.1
112870029,1,18,1.0,19,0.05263157894736842
112879784,1,9,1.0,10,0.1
112917683,9,1,1.0,10,0.1
112926387,1,8,1.0,9,0.1111111111111111
112952940,6,4,4.0,10,0.4
112953836,1,7,1.0,8,0.125
112961957,1,9,1.0,10,0.1
112966571,1,8,1.0,9,0.1111111111111111
112970720,5,25,5.0,30,0.16666666666666666
112971147,1,9,1.0,10,0.1
112972645,3,7,3.0,10,0.3
112973820,3,6,3.0,9,0.3333333333333333
112985485,9,1,1.0,10,0.1
112986075,3,16,3.0,19,0.15789473684210525
112990202,1,18,1.0,19,0.05263157894736842
112993008,2,7,2.0,9,0.2222222222222222
112996577,9,1,1.0,10,0.1
113005543,1,9,1.0,10,0.1
113028134,2,16,2.0,18,0.1111111111111111
113035882,2,8,2.0,10,0.2
113044391,4,5,4.0,9,0.4444444444444444
113066075,1,8,1.0,9,0.1111111111111111
113066757,7,2,2.0,9,0.2222222222222222
113077235,2,8,2.0,10,0.2
113082022,2,7,2.0,9,0.2222222222222222
113082078,1,8,1.0,9,0.1111111111111111
113085543,3,7,3.0,10,0.3
113094401,2,8,2.0,10,0.2
113096005,1,9,1.0,10,0.1
113104452,5,5,5.0,10,0.5
113111757,1,17,1.0,18,0.05555555555555555
113115903,6,4,4.0,10,0.4
113119674,4,4,4.0,8,0.5
113121502,3,7,3.0,10,0.3
113126421,2,8,2.0,10,0.2
113159746,4,4,4.0,8,0.5
113227770,8,2,2.0,10,0.2
113230656,6,3,3.0,9,0.3333333333333333
113232538,6,3,3.0,9,0.3333333333333333
113236188,4,5,4.0,9,0.4444444444444444
113242336,3,5,3.0,8,0.375
113243466,2,8,2.0,10,0.2
113244357,2,8,2.0,10,0.2
113246954,1,9,1.0,10,0.1
113253076,5,5,5.0,10,0.5
113253194,8,2,2.0,10,0.2
113259257,1,7,1.0,8,0.125
113259719,2,18,2.0,20,0.1
113293507,1,19,1.0,20,0.05
113297007,3,6,3.0,9,0.3333333333333333
113301606,1,19,1.0,20,0.05
113305220,3,7,3.0,10,0.3
113319250,1,9,1.0,10,0.1
113320954,1,9,1.0,10,0.1
113395708,4,6,4.0,10,0.4
113395987,5,5,5.0,10,0.5
113413809,4,6,4.0,10,0.4
113421483,3,15,3.0,18,0.16666666666666666
113437910,2,8,2.0,10,0.2
113441976,1,18,1.0,19,0.05263157894736842
113446390,8,2,2.0,10,0.2
113474984,2,16,2.0,18,0.1111111111111111
113526571,1,9,1.0,10,0.1
113547560,1,9,1.0,10,0.1
113548441,4,16,4.0,20,0.2
113550660,1,8,1.0,9,0.1111111111111111
113583716,1,9,1.0,10,0.1
113588926,1,8,1.0,9,0.1111111111111111
113589450,3,16,3.0,19,0.15789473684210525
113590746,2,8,2.0,10,0.2
113594379,11,9,9.0,20,0.45
113619045,2,7,2.0,9,0.2222222222222222
113619705,11,16,11.0,27,0.4074074074074074
113622535,1,18,1.0,19,0.05263157894736842
113635323,1,9,1.0,10,0.1
113651487,2,7,2.0,9,0.2222222222222222
113659696,2,8,2.0,10,0.2
113662920,11,7,7.0,18,0.3888888888888889
113667379,1,8,1.0,9,0.1111111111111111
113692263,1,8,1.0,9,0.1111111111111111
113699497,13,6,6.0,19,0.3157894736842105
113705916,4,6,4.0,10,0.4
113718839,1,18,1.0,19,0.05263157894736842
113723409,1,9,1.0,10,0.1
113731419,1,9,1.0,10,0.1
113770535,1,8,1.0,9,0.1111111111111111
113786961,1,9,1.0,10,0.1
113812228,3,6,3.0,9,0.3333333333333333
113822812,9,1,1.0,10,0.1
113825047,3,7,3.0,10,0.3
113839151,7,2,2.0,9,0.2222222222222222
113866460,6,3,3.0,9,0.3333333333333333
113867101,2,8,2.0,10,0.2
113883000,1,18,1.0,19,0.05263157894736842
113894526,1,18,1.0,19,0.05263157894736842
113897000,1,9,1.0,10,0.1
113907186,1,16,1.0,17,0.058823529411764705
113916466,1,9,1.0,10,0.1
113922361,4,5,4.0,9,0.4444444444444444
113945057,1,9,1.0,10,0.1
113950042,1,8,1.0,9,0.1111111111111111
113966018,3,6,3.0,9,0.3333333333333333
113968666,1,8,1.0,9,0.1111111111111111
113983019,7,3,3.0,10,0.3
114014710,1,9,1.0,10,0.1
114020974,1,9,1.0,10,0.1
114048890,6,21,6.0,27,0.2222222222222222
114051335,2,8,2.0,10,0.2
114054225,1,8,1.0,9,0.1111111111111111
114077699,2,7,2.0,9,0.2222222222222222
114130574,1,8,1.0,9,0.1111111111111111
114131454,8,1,1.0,9,0.1111111111111111
114145813,1,8,1.0,9,0.1111111111111111
114157174,2,7,2.0,9,0.2222222222222222
114170184,7,2,2.0,9,0.2222222222222222
114172479,16,13,13.0,29,0.4482758620689655
114173422,1,9,1.0,10,0.1
114173991,3,6,3.0,9,0.3333333333333333
114177974,27,2,2.0,29,0.06896551724137931
114179379,1,9,1.0,10,0.1
114230400,7,3,3.0,10,0.3
114238996,1,9,1.0,10,0.1
114240448,1,18,1.0,19,0.05263157894736842
114249179,9,1,1.0,10,0.1
114252964,5,14,5.0,19,0.2631578947368421
114274422,5,5,5.0,10,0.5
114287278,1,8,1.0,9,0.1111111111111111
114287880,1,8,1.0,9,0.1111111111111111
114310605,7,3,3.0,10,0.3
114311189,1,9,1.0,10,0.1
114317101,8,2,2.0,10,0.2
114317720,3,7,3.0,10,0.3
114318294,5,5,5.0,10,0.5
114318958,7,2,2.0,9,0.2222222222222222
114320763,25,5,5.0,30,0.16666666666666666
114320998,1,8,1.0,9,0.1111111111111111
114336210,9,1,1.0,10,0.1
114397927,1,18,1.0,19,0.05263157894736842
114408205,3,7,3.0,10,0.3
114418435,7,2,2.0,9,0.2222222222222222
114420599,9,9,9.0,18,0.5
114421458,3,7,3.0,10,0.3
114421706,4,4,4.0,8,0.5
114431171,4,4,4.0,8,0.5
114443726,4,5,4.0,9,0.4444444444444444
114454094,1,8,1.0,9,0.1111111111111111
114466220,15,14,14.0,29,0.4827586206896552
114470685,6,2,2.0,8,0.25
114484659,1,9,1.0,10,0.1
114494216,2,18,2.0,20,0.1
114494385,1,9,1.0,10,0.1
114510623,2,8,2.0,10,0.2
114511350,3,6,3.0,9,0.3333333333333333
114518123,24,4,4.0,28,0.14285714285714285
114522269,2,8,2.0,10,0.2
114533053,2,7,2.0,9,0.2222222222222222
114565845,3,6,3.0,9,0.3333333333333333
114566432,4,6,4.0,10,0.4
114567610,4,6,4.0,10,0.4
114568347,2,8,2.0,10,0.2
114573884,2,6,2.0,8,0.25
114606865,2,8,2.0,10,0.2
114611381,1,9,1.0,10,0.1
114616049,1,9,1.0,10,0.1
114632591,1,8,1.0,9,0.1111111111111111
114640449,1,9,1.0,10,0.1
114661155,1,9,1.0,10,0.1
114661222,1,8,1.0,9,0.1111111111111111
114663604,4,6,4.0,10,0.4
114664203,1,9,1.0,10,0.1
114703419,6,3,3.0,9,0.3333333333333333
114712839,7,3,3.0,10,0.3
114755446,3,17,3.0,20,0.15
114762206,6,4,4.0,10,0.4
114788729,2,8,2.0,10,0.2
114791198,1,9,1.0,10,0.1
114797325,2,8,2.0,10,0.2
114802038,1,9,1.0,10,0.1
114814051,1,18,1.0,19,0.05263157894736842
114843186,1,9,1.0,10,0.1
114864833,2,8,2.0,10,0.2
114871001,1,9,1.0,10,0.1
114877993,23,4,4.0,27,0.14814814814814814
114883180,9,1,1.0,10,0.1
114891600,1,9,1.0,10,0.1
114919011,1,9,1.0,10,0.1
114919434,5,4,4.0,9,0.4444444444444444
114922839,1,8,1.0,9,0.1111111111111111
114961109,9,1,1.0,10,0.1
114962992,8,2,2.0,10,0.2
114971232,8,2,2.0,10,0.2
114975577,3,7,3.0,10,0.3
115014577,4,16,4.0,20,0.2
115017314,1,18,1.0,19,0.05263157894736842
115023051,2,8,2.0,10,0.2
115054798,1,18,1.0,19,0.05263157894736842
115073477,5,4,4.0,9,0.4444444444444444
115084709,3,7,3.0,10,0.3
115084735,4,6,4.0,10,0.4
115086303,5,5,5.0,10,0.5
115087698,1,7,1.0,8,0.125
115089204,4,5,4.0,9,0.4444444444444444
115089848,1,8,1.0,9,0.1111111111111111
115092489,6,13,6.0,19,0.3157894736842105
115093362,1,9,1.0,10,0.1
115094141,1,9,1.0,10,0.1
115094775,2,8,2.0,10,0.2
115096158,8,1,1.0,9,0.1111111111111111
115100054,4,6,4.0,10,0.4
115100336,9,1,1.0,10,0.1
115109535,2,16,2.0,18,0.1111111111111111
115117362,3,7,3.0,10,0.3
115148993,1,19,1.0,20,0.05
115176725,4,5,4.0,9,0.4444444444444444
115177250,1,9,1.0,10,0.1
115182177,7,23,7.0,30,0.23333333333333334
115187198,4,6,4.0,10,0.4
115196808,3,17,3.0,20,0.15
115200620,1,8,1.0,9,0.1111111111111111
115205461,2,8,2.0,10,0.2
115208452,1,7,1.0,8,0.125
115209615,2,6,2.0,8,0.25
115210096,8,2,2.0,10,0.2
115210601,2,8,2.0,10,0.2
115211592,1,9,1.0,10,0.1
115211861,8,1,1.0,9,0.1111111111111111
115212845,19,11,11.0,30,0.36666666666666664
115213975,4,6,4.0,10,0.4
115215708,9,1,1.0,10,0.1
115220620,2,8,2.0,10,0.2
115230901,4,6,4.0,10,0.4
115244396,2,7,2.0,9,0.2222222222222222
115247300,2,17,2.0,19,0.10526315789473684
115270411,1,26,1.0,27,0.037037037037037035
115292540,8,2,2.0,10,0.2
115294357,2,8,2.0,10,0.2
115296112,1,7,1.0,8,0.125
115302502,2,8,2.0,10,0.2
115316795,7,1,1.0,8,0.125
115318319,1,8,1.0,9,0.1111111111111111
115318623,2,8,2.0,10,0.2
115319227,1,9,1.0,10,0.1
115320884,23,5,5.0,28,0.17857142857142858
115325952,5,5,5.0,10,0.5
115354162,8,1,1.0,9,0.1111111111111111
115361924,2,7,2.0,9,0.2222222222222222
115369895,1,9,1.0,10,0.1
115400398,9,1,1.0,10,0.1
115425285,8,2,2.0,10,0.2
115427175,2,8,2.0,10,0.2
115430733,1,7,1.0,8,0.125
115431166,5,5,5.0,10,0.5
115432004,9,1,1.0,10,0.1
115434339,1,9,1.0,10,0.1
115437685,1,9,1.0,10,0.1
115439276,1,9,1.0,10,0.1
115446487,1,9,1.0,10,0.1
115458309,2,8,2.0,10,0.2
115459480,1,9,1.0,10,0.1
115459767,4,4,4.0,8,0.5
115463525,1,8,1.0,9,0.1111111111111111
115465667,4,15,4.0,19,0.21052631578947367
115468393,1,7,1.0,8,0.125
115507363,1,7,1.0,8,0.125
115516460,1,8,1.0,9,0.1111111111111111
115518796,1,8,1.0,9,0.1111111111111111
115535263,1,9,1.0,10,0.1
115538787,1,9,1.0,10,0.1
115568351,1,9,1.0,10,0.1
115571349,1,9,1.0,10,0.1
115601894,1,17,1.0,18,0.05555555555555555
115606566,1,18,1.0,19,0.05263157894736842
115617304,1,16,1.0,17,0.058823529411764705
115622310,2,7,2.0,9,0.2222222222222222
115645131,3,6,3.0,9,0.3333333333333333
115653405,2,8,2.0,10,0.2
115665249,8,2,2.0,10,0.2
115666534,1,9,1.0,10,0.1
115676884,1,8,1.0,9,0.1111111111111111
115747794,5,3,3.0,8,0.375
115771428,8,2,2.0,10,0.2
115789787,2,8,2.0,10,0.2
115829847,1,9,1.0,10,0.1
115833500,1,9,1.0,10,0.1
115874870,2,8,2.0,10,0.2
115881616,3,7,3.0,10,0.3
115892666,2,8,2.0,10,0.2
115899889,2,6,2.0,8,0.25
115930217,1,7,1.0,8,0.125
115932271,1,18,1.0,19,0.05263157894736842
115937723,13,5,5.0,18,0.2777777777777778
115942041,2,8,2.0,10,0.2
115955020,3,6,3.0,9,0.3333333333333333
115955857,4,6,4.0,10,0.4
115956535,6,4,4.0,10,0.4
115957353,6,3,3.0,9,0.3333333333333333
115968496,2,8,2.0,10,0.2
115969632,2,8,2.0,10,0.2
115971912,1,19,1.0,20,0.05
115977479,1,8,1.0,9,0.1111111111111111
115987099,3,7,3.0,10,0.3
115989708,8,2,2.0,10,0.2
115994878,2,8,2.0,10,0.2
116028243,2,8,2.0,10,0.2
116042245,1,9,1.0,10,0.1
116051856,2,7,2.0,9,0.2222222222222222
116073633,7,3,3.0,10,0.3
116083121,6,14,6.0,20,0.3
116090029,5,5,5.0,10,0.5
116095529,6,3,3.0,9,0.3333333333333333
116121091,5,5,5.0,10,0.5
116121213,6,2,2.0,8,0.25
116137354,1,16,1.0,17,0.058823529411764705
116148720,2,8,2.0,10,0.2
116158719,1,8,1.0,9,0.1111111111111111
116167744,1,16,1.0,17,0.058823529411764705
116173525,14,6,6.0,20,0.3
116174839,5,5,5.0,10,0.5
116175795,17,11,11.0,28,0.39285714285714285
116195271,3,5,3.0,8,0.375
116212991,3,5,3.0,8,0.375
116250876,2,8,2.0,10,0.2
116251340,3,6,3.0,9,0.3333333333333333
116260244,1,8,1.0,9,0.1111111111111111
116261980,1,9,1.0,10,0.1
116271722,5,3,3.0,8,0.375
116321932,2,7,2.0,9,0.2222222222222222
116322842,2,7,2.0,9,0.2222222222222222
116344071,5,13,5.0,18,0.2777777777777778
116357347,14,5,5.0,19,0.2631578947368421
116359463,2,17,2.0,19,0.10526315789473684
116362921,6,4,4.0,10,0.4
116374613,4,6,4.0,10,0.4
116398699,6,4,4.0,10,0.4
116401444,1,18,1.0,19,0.05263157894736842
116402675,1,17,1.0,18,0.05555555555555555
116439637,6,13,6.0,19,0.3157894736842105
116479743,1,9,1.0,10,0.1
116480217,1,9,1.0,10,0.1
116482664,1,9,1.0,10,0.1
116489970,6,2,2.0,8,0.25
116490818,5,15,5.0,20,0.25
116491396,9,1,1.0,10,0.1
116492305,8,2,2.0,10,0.2
116495682,5,5,5.0,10,0.5
116505766,2,8,2.0,10,0.2
116512820,2,7,2.0,9,0.2222222222222222
116522843,4,5,4.0,9,0.4444444444444444
116525243,4,5,4.0,9,0.4444444444444444
116527811,1,9,1.0,10,0.1
116571961,2,8,2.0,10,0.2
116583991,1,18,1.0,19,0.05263157894736842
116598203,9,1,1.0,10,0.1
116626980,1,8,1.0,9,0.1111111111111111
116634956,3,7,3.0,10,0.3
116635616,1,17,1.0,18,0.05555555555555555
116636062,1,9,1.0,10,0.1
116640863,1,8,1.0,9,0.1111111111111111
116648850,3,16,3.0,19,0.15789473684210525
116654547,9,1,1.0,10,0.1
116655696,1,9,1.0,10,0.1
116659786,1,8,1.0,9,0.1111111111111111
116667997,8,2,2.0,10,0.2
116668328,9,1,1.0,10,0.1
116670118,2,8,2.0,10,0.2
116673665,1,8,1.0,9,0.1111111111111111
116679394,9,1,1.0,10,0.1
116680680,5,14,5.0,19,0.2631578947368421
116681484,4,5,4.0,9,0.4444444444444444
116687406,7,2,2.0,9,0.2222222222222222
116687866,2,28,2.0,30,0.06666666666666667
116691228,2,8,2.0,10,0.2
116709082,1,9,1.0,10,0.1
116712943,4,6,4.0,10,0.4
116728261,7,1,1.0,8,0.125
116728944,8,2,2.0,10,0.2
116733630,1,9,1.0,10,0.1
116735216,7,1,1.0,8,0.125
116737967,1,9,1.0,10,0.1
116751031,1,9,1.0,10,0.1
116751268,1,9,1.0,10,0.1
116754039,2,8,2.0,10,0.2
116755799,1,8,1.0,9,0.1111111111111111
116756840,3,7,3.0,10,0.3
116757373,1,8,1.0,9,0.1111111111111111
116764302,3,7,3.0,10,0.3
116765934,3,17,3.0,20,0.15
116778855,2,7,2.0,9,0.2222222222222222
116779895,3,6,3.0,9,0.3333333333333333
116781550,1,7,1.0,8,0.125
116834455,9,1,1.0,10,0.1
116846522,9,1,1.0,10,0.1
116851212,2,8,2.0,10,0.2
116857774,5,23,5.0,28,0.17857142857142858
116868601,1,9,1.0,10,0.1
116869287,1,16,1.0,17,0.058823529411764705
116870257,1,8,1.0,9,0.1111111111111111
116895572,7,3,3.0,10,0.3
116900916,1,9,1.0,10,0.1
116928410,9,1,1.0,10,0.1
116929949,2,8,2.0,10,0.2
116930852,1,28,1.0,29,0.034482758620689655
116934348,1,7,1.0,8,0.125
116936118,1,9,1.0,10,0.1
116947267,1,9,1.0,10,0.1
116950152,9,1,1.0,10,0.1
116964324,8,2,2.0,10,0.2
116974059,1,9,1.0,10,0.1
116974268,6,4,4.0,10,0.4
116974292,3,6,3.0,9,0.3333333333333333
116974456,8,1,1.0,9,0.1111111111111111
116974785,3,7,3.0,10,0.3
116975578,3,6,3.0,9,0.3333333333333333
116978323,3,6,3.0,9,0.3333333333333333
116984776,6,4,4.0,10,0.4
116985307,2,7,2.0,9,0.2222222222222222
117004660,1,9,1.0,10,0.1
117028285,1,8,1.0,9,0.1111111111111111
117034590,1,9,1.0,10,0.1
117034610,5,15,5.0,20,0.25
117066491,2,16,2.0,18,0.1111111111111111
117069849,2,8,2.0,10,0.2
117126665,2,8,2.0,10,0.2
117138119,1,18,1.0,19,0.05263157894736842
117138667,1,9,1.0,10,0.1
117144737,1,9,1.0,10,0.1
117145892,3,7,3.0,10,0.3
117171202,6,4,4.0,10,0.4
117173252,1,18,1.0,19,0.05263157894736842
117187822,1,9,1.0,10,0.1
117188908,1,8,1.0,9,0.1111111111111111
117200530,1,17,1.0,18,0.05555555555555555
117205186,1,9,1.0,10,0.1
117206455,2,8,2.0,10,0.2
117213781,2,8,2.0,10,0.2
117214672,2,26,2.0,28,0.07142857142857142
117215041,1,9,1.0,10,0.1
117215942,2,8,2.0,10,0.2
117216783,8,20,8.0,28,0.2857142857142857
117217730,1,9,1.0,10,0.1
117222760,4,5,4.0,9,0.4444444444444444
117223117,5,5,5.0,10,0.5
117254695,1,9,1.0,10,0.1
117260626,8,1,1.0,9,0.1111111111111111
117267677,6,2,2.0,8,0.25
117268538,1,9,1.0,10,0.1
117268986,1,18,1.0,19,0.05263157894736842
117269863,1,9,1.0,10,0.1
117270893,3,7,3.0,10,0.3
117276483,2,8,2.0,10,0.2
117351188,6,4,4.0,10,0.4
117364870,5,4,4.0,9,0.4444444444444444
117370921,1,9,1.0,10,0.1
117371650,1,18,1.0,19,0.05263157894736842
117376122,1,9,1.0,10,0.1
117379755,2,8,2.0,10,0.2
117450859,26,4,4.0,30,0.13333333333333333
117459683,7,2,2.0,9,0.2222222222222222
117460823,14,14,14.0,28,0.5
117463282,7,2,2.0,9,0.2222222222222222
117463948,6,3,3.0,9,0.3333333333333333
117465749,9,1,1.0,10,0.1
117471396,5,5,5.0,10,0.5
117471607,2,6,2.0,8,0.25
117474194,2,8,2.0,10,0.2
117494836,1,9,1.0,10,0.1
117501315,4,15,4.0,19,0.21052631578947367
117506847,7,11,7.0,18,0.3888888888888889
117509150,1,8,1.0,9,0.1111111111111111
117512872,3,7,3.0,10,0.3
117513200,3,7,3.0,10,0.3
117513371,3,6,3.0,9,0.3333333333333333
117514335,2,7,2.0,9,0.2222222222222222
117514956,11,17,11.0,28,0.39285714285714285
117516031,1,9,1.0,10,0.1
117516671,7,3,3.0,10,0.3
117534750,3,7,3.0,10,0.3
117535768,2,6,2.0,8,0.25
117536194,7,1,1.0,8,0.125
117540785,1,19,1.0,20,0.05
117595763,2,8,2.0,10,0.2
117609590,4,6,4.0,10,0.4
117610007,2,7,2.0,9,0.2222222222222222
117613604,5,5,5.0,10,0.5
117617966,5,5,5.0,10,0.5
117618489,3,6,3.0,9,0.3333333333333333
117618785,1,9,1.0,10,0.1
117619570,3,7,3.0,10,0.3
117620032,3,7,3.0,10,0.3
117665497,3,16,3.0,19,0.15789473684210525
117685442,1,8,1.0,9,0.1111111111111111
117695409,1,18,1.0,19,0.05263157894736842
117734521,1,7,1.0,8,0.125
117748063,5,12,5.0,17,0.29411764705882354
117769588,7,2,2.0,9,0.2222222222222222
117787181,5,5,5.0,10,0.5
117788502,7,3,3.0,10,0.3
117796083,9,1,1.0,10,0.1
117808127,2,8,2.0,10,0.2
117826394,1,28,1.0,29,0.034482758620689655
117826523,1,27,1.0,28,0.03571428571428571
117829816,1,9,1.0,10,0.1
117855658,3,7,3.0,10,0.3
117857317,2,7,2.0,9,0.2222222222222222
117858546,2,7,2.0,9,0.2222222222222222
117859505,3,7,3.0,10,0.3
117870958,1,9,1.0,10,0.1
117889017,2,8,2.0,10,0.2
117889987,1,8,1.0,9,0.1111111111111111
117916740,4,5,4.0,9,0.4444444444444444
117934672,2,8,2.0,10,0.2
117966125,1,8,1.0,9,0.1111111111111111
117969177,4,6,4.0,10,0.4
117983519,3,7,3.0,10,0.3
117996882,1,9,1.0,10,0.1
117997277,1,19,1.0,20,0.05
118001295,1,9,1.0,10,0.1
118006978,23,4,4.0,27,0.14814814814814814
118021991,9,1,1.0,10,0.1
118025106,3,7,3.0,10,0.3
118048386,1,9,1.0,10,0.1
118055027,2,15,2.0,17,0.11764705882352941
118111976,1,9,1.0,10,0.1
118120406,4,6,4.0,10,0.4
118134193,7,2,2.0,9,0.2222222222222222
118148055,15,14,14.0,29,0.4827586206896552
118153715,2,8,2.0,10,0.2
118160835,1,18,1.0,19,0.05263157894736842
118164627,1,19,1.0,20,0.05
118174557,1,9,1.0,10,0.1
118176179,3,6,3.0,9,0.3333333333333333
118177029,12,16,12.0,28,0.42857142857142855
118181705,1,16,1.0,17,0.058823529411764705
118201757,9,1,1.0,10,0.1
118206758,2,8,2.0,10,0.2
118211480,8,2,2.0,10,0.2
118215436,4,5,4.0,9,0.4444444444444444
118220710,3,7,3.0,10,0.3
118229234,1,18,1.0,19,0.05263157894736842
118230587,1,9,1.0,10,0.1
118293959,5,5,5.0,10,0.5
118294275,9,1,1.0,10,0.1
118295327,9,1,1.0,10,0.1
118299244,9,1,1.0,10,0.1
118300954,2,8,2.0,10,0.2
118302922,8,1,1.0,9,0.1111111111111111
118311668,1,17,1.0,18,0.05555555555555555
118327561,1,9,1.0,10,0.1
118371914,5,5,5.0,10,0.5
118389230,5,5,5.0,10,0.5
118392466,4,6,4.0,10,0.4
118400294,3,6,3.0,9,0.3333333333333333
118402683,1,15,1.0,16,0.0625
118406146,7,2,2.0,9,0.2222222222222222
118407987,3,6,3.0,9,0.3333333333333333
118408682,9,1,1.0,10,0.1
118408966,9,1,1.0,10,0.1
118410371,1,9,1.0,10,0.1
118418279,15,3,3.0,18,0.16666666666666666
118440741,4,6,4.0,10,0.4
118442285,5,4,4.0,9,0.4444444444444444
118443961,1,8,1.0,9,0.1111111111111111
118450006,3,6,3.0,9,0.3333333333333333
118450691,2,6,2.0,8,0.25
118451162,4,6,4.0,10,0.4
118451472,3,17,3.0,20,0.15
118454326,1,9,1.0,10,0.1
118458825,3,6,3.0,9,0.3333333333333333
118469379,11,6,6.0,17,0.35294117647058826
118475552,1,9,1.0,10,0.1
118478109,2,7,2.0,9,0.2222222222222222
118500848,1,9,1.0,10,0.1
118506703,1,9,1.0,10,0.1
118526249,8,2,2.0,10,0.2
118530015,8,1,1.0,9,0.1111111111111111
118532910,3,6,3.0,9,0.3333333333333333
118533934,25,3,3.0,28,0.10714285714285714
118541592,9,1,1.0,10,0.1
118547980,5,3,3.0,8,0.375
118552463,5,5,5.0,10,0.5
118553926,5,4,4.0,9,0.4444444444444444
118554216,6,2,2.0,8,0.25
118575738,2,8,2.0,10,0.2
118575819,1,9,1.0,10,0.1
118578119,4,6,4.0,10,0.4
118578504,17,12,12.0,29,0.41379310344827586
118582918,5,5,5.0,10,0.5
118601220,1,9,1.0,10,0.1
118607147,2,25,2.0,27,0.07407407407407407
118621170,5,5,5.0,10,0.5
118627585,3,7,3.0,10,0.3
118631095,1,8,1.0,9,0.1111111111111111
118653885,6,14,6.0,20,0.3
118661093,1,8,1.0,9,0.1111111111111111
118681899,1,7,1.0,8,0.125
118684528,6,4,4.0,10,0.4
118705652,1,8,1.0,9,0.1111111111111111
118708245,1,19,1.0,20,0.05
118710271,1,18,1.0,19,0.05263157894736842
118723042,9,1,1.0,10,0.1
118726824,5,4,4.0,9,0.4444444444444444
118759416,1,8,1.0,9,0.1111111111111111
118773317,3,6,3.0,9,0.3333333333333333
118789723,4,6,4.0,10,0.4
118796724,2,7,2.0,9,0.2222222222222222
118802048,17,11,11.0,28,0.39285714285714285
118821813,1,9,1.0,10,0.1
118822359,1,18,1.0,19,0.05263157894736842
118847939,2,8,2.0,10,0.2
118854005,6,2,2.0,8,0.25
118855877,2,7,2.0,9,0.2222222222222222
118862095,8,1,1.0,9,0.1111111111111111
118876282,1,8,1.0,9,0.1111111111111111
118878584,2,8,2.0,10,0.2
118884928,4,6,4.0,10,0.4
118886711,6,3,3.0,9,0.3333333333333333
118888715,1,8,1.0,9,0.1111111111111111
118918597,4,6,4.0,10,0.4
118924180,3,7,3.0,10,0.3
118926019,1,9,1.0,10,0.1
118951612,3,7,3.0,10,0.3
118969136,2,8,2.0,10,0.2
118980743,6,4,4.0,10,0.4
118980941,1,9,1.0,10,0.1
118981586,1,8,1.0,9,0.1111111111111111
118982281,6,4,4.0,10,0.4
119001416,12,18,12.0,30,0.4
119057997,9,1,1.0,10,0.1
119060978,6,20,6.0,26,0.23076923076923078
119076640,9,1,1.0,10,0.1
119083270,1,18,1.0,19,0.05263157894736842
119096722,7,1,1.0,8,0.125
119117060,8,2,2.0,10,0.2
119117159,9,1,1.0,10,0.1
119130310,1,9,1.0,10,0.1
119135021,1,9,1.0,10,0.1
119141809,1,8,1.0,9,0.1111111111111111
119148069,2,8,2.0,10,0.2
119150362,4,15,4.0,19,0.21052631578947367
119150405,1,9,1.0,10,0.1
119156566,2,8,2.0,10,0.2
119172846,4,14,4.0,18,0.2222222222222222
119174418,1,9,1.0,10,0.1
119209088,1,8,1.0,9,0.1111111111111111
119209489,1,9,1.0,10,0.1
119239965,6,4,4.0,10,0.4
119263464,18,11,11.0,29,0.3793103448275862
119269232,1,19,1.0,20,0.05
119279651,1,26,1.0,27,0.037037037037037035
119281141,8,2,2.0,10,0.2
119281255,2,7,2.0,9,0.2222222222222222
119301762,8,2,2.0,10,0.2
119370109,2,8,2.0,10,0.2
119373580,1,7,1.0,8,0.125
119403722,1,17,1.0,18,0.05555555555555555
119405887,1,9,1.0,10,0.1
119408869,1,7,1.0,8,0.125
119439803,7,2,2.0,9,0.2222222222222222
119440096,8,1,1.0,9,0.1111111111111111
119472103,1,17,1.0,18,0.05555555555555555
119476113,1,9,1.0,10,0.1
119489188,2,8,2.0,10,0.2
119503953,19,9,9.0,28,0.32142857142857145
119504566,1,9,1.0,10,0.1
119512302,7,1,1.0,8,0.125
119512529,4,6,4.0,10,0.4
119524478,6,4,4.0,10,0.4
119574213,2,7,2.0,9,0.2222222222222222
119582542,2,8,2.0,10,0.2
119589904,1,9,1.0,10,0.1
119603338,8,2,2.0,10,0.2
119604306,8,1,1.0,9,0.1111111111111111
119604418,9,1,1.0,10,0.1
119612854,6,4,4.0,10,0.4
119630483,1,7,1.0,8,0.125
119646047,5,5,5.0,10,0.5
119706718,3,16,3.0,19,0.15789473684210525
119743080,2,16,2.0,18,0.1111111111111111
119750830,3,6,3.0,9,0.3333333333333333
119752621,1,9,1.0,10,0.1
119756761,1,8,1.0,9,0.1111111111111111
119769104,1,29,1.0,30,0.03333333333333333
119775853,2,7,2.0,9,0.2222222222222222
119799799,1,8,1.0,9,0.1111111111111111
119805950,2,8,2.0,10,0.2
119822279,3,14,3.0,17,0.17647058823529413
119865142,7,3,3.0,10,0.3
119867523,1,18,1.0,19,0.05263157894736842
119873160,1,9,1.0,10,0.1
119892887,3,6,3.0,9,0.3333333333333333
119893323,1,9,1.0,10,0.1
119894253,1,9,1.0,10,0.1
119898861,1,7,1.0,8,0.125
119930531,4,25,4.0,29,0.13793103448275862
119942665,1,9,1.0,10,0.1
119943072,6,4,4.0,10,0.4
119944210,1,9,1.0,10,0.1
119967809,6,4,4.0,10,0.4
119975761,3,7,3.0,10,0.3
119985269,2,7,2.0,9,0.2222222222222222
119996560,7,2,2.0,9,0.2222222222222222
120007150,12,13,12.0,25,0.48
120038697,8,1,1.0,9,0.1111111111111111
120040072,9,1,1.0,10,0.1
120045046,1,8,1.0,9,0.1111111111111111
120052347,5,4,4.0,9,0.4444444444444444
120054986,1,8,1.0,9,0.1111111111111111
120059177,5,3,3.0,8,0.375
120059930,2,7,2.0,9,0.2222222222222222
120060400,9,1,1.0,10,0.1
120061116,6,3,3.0,9,0.3333333333333333
120061563,1,8,1.0,9,0.1111111111111111
120145489,1,9,1.0,10,0.1
120150605,9,1,1.0,10,0.1
120180674,1,7,1.0,8,0.125
120187312,3,16,3.0,19,0.15789473684210525
120187336,1,9,1.0,10,0.1
120199105,4,6,4.0,10,0.4
120238247,5,5,5.0,10,0.5
120250868,2,17,2.0,19,0.10526315789473684
120270134,1,19,1.0,20,0.05
120273855,8,2,2.0,10,0.2
120274207,9,1,1.0,10,0.1
120274211,8,2,2.0,10,0.2
120274430,9,1,1.0,10,0.1
120274470,28,1,1.0,29,0.034482758620689655
120274550,8,1,1.0,9,0.1111111111111111
120294916,1,9,1.0,10,0.1
120301349,1,19,1.0,20,0.05
120301976,9,10,9.0,19,0.47368421052631576
120305393,1,9,1.0,10,0.1
120320675,1,9,1.0,10,0.1
120331873,26,3,3.0,29,0.10344827586206896
120355862,7,21,7.0,28,0.25
120368357,1,8,1.0,9,0.1111111111111111
120368377,1,8,1.0,9,0.1111111111111111
120378457,1,8,1.0,9,0.1111111111111111
120384148,3,7,3.0,10,0.3
120422420,1,9,1.0,10,0.1
120431317,2,8,2.0,10,0.2
120438988,1,9,1.0,10,0.1
120445210,1,7,1.0,8,0.125
120445266,3,25,3.0,28,0.10714285714285714
120451303,2,7,2.0,9,0.2222222222222222
120451473,2,8,2.0,10,0.2
120479690,2,8,2.0,10,0.2
120480452,1,7,1.0,8,0.125
120487839,8,2,2.0,10,0.2
120490861,5,23,5.0,28,0.17857142857142858
120514626,1,9,1.0,10,0.1
120517707,1,29,1.0,30,0.03333333333333333
120521200,8,2,2.0,10,0.2
120521295,7,2,2.0,9,0.2222222222222222
120548623,9,1,1.0,10,0.1
120559125,11,8,8.0,19,0.42105263157894735
120604968,7,21,7.0,28,0.25
120612204,17,11,11.0,28,0.39285714285714285
120613009,6,4,4.0,10,0.4
120613875,8,1,1.0,9,0.1111111111111111
120615168,3,7,3.0,10,0.3
120617726,3,6,3.0,9,0.3333333333333333
120633635,4,16,4.0,20,0.2
120655044,1,9,1.0,10,0.1
120668105,8,1,1.0,9,0.1111111111111111
120670260,4,5,4.0,9,0.4444444444444444
120677532,2,7,2.0,9,0.2222222222222222
120721405,1,9,1.0,10,0.1
120728577,7,1,1.0,8,0.125
120736319,3,7,3.0,10,0.3
120754136,1,19,1.0,20,0.05
120754339,1,8,1.0,9,0.1111111111111111
120765777,6,3,3.0,9,0.3333333333333333
120767577,7,3,3.0,10,0.3
120780114,1,9,1.0,10,0.1
120784287,1,9,1.0,10,0.1
120784689,2,8,2.0,10,0.2
120787097,1,9,1.0,10,0.1
120787637,1,8,1.0,9,0.1111111111111111
120789057,2,8,2.0,10,0.2
120789387,1,19,1.0,20,0.05
120796481,8,1,1.0,9,0.1111111111111111
120796587,7,2,2.0,9,0.2222222222222222
120824370,2,8,2.0,10,0.2
120836431,2,16,2.0,18,0.1111111111111111
120845507,1,19,1.0,20,0.05
120847298,2,8,2.0,10,0.2
120855136,1,19,1.0,20,0.05
120862482,1,7,1.0,8,0.125
120865476,6,4,4.0,10,0.4
120867010,1,9,1.0,10,0.1
120877856,9,1,1.0,10,0.1
120880185,3,7,3.0,10,0.3
120894998,6,3,3.0,9,0.3333333333333333
120897477,1,9,1.0,10,0.1
120978060,1,18,1.0,19,0.05263157894736842
120982940,1,8,1.0,9,0.1111111111111111
120996420,1,8,1.0,9,0.1111111111111111
121014763,1,9,1.0,10,0.1
121015471,2,7,2.0,9,0.2222222222222222
121015630,4,6,4.0,10,0.4
121015740,1,9,1.0,10,0.1
121017441,4,15,4.0,19,0.21052631578947367
121031484,2,8,2.0,10,0.2
121033224,3,7,3.0,10,0.3
121033431,26,2,2.0,28,0.07142857142857142
121038947,7,2,2.0,9,0.2222222222222222
121045400,4,6,4.0,10,0.4
121048377,3,24,3.0,27,0.1111111111111111
121066494,1,19,1.0,20,0.05
121075407,1,9,1.0,10,0.1
121215426,2,7,2.0,9,0.2222222222222222
121233916,7,22,7.0,29,0.2413793103448276
121239727,2,8,2.0,10,0.2
121240937,1,9,1.0,10,0.1
121242010,2,8,2.0,10,0.2
121247520,3,6,3.0,9,0.3333333333333333
121275972,1,18,1.0,19,0.05263157894736842
121297206,2,8,2.0,10,0.2
121298344,5,5,5.0,10,0.5
121299138,2,8,2.0,10,0.2
121302794,15,15,15.0,30,0.5
121302912,1,8,1.0,9,0.1111111111111111
121303142,4,5,4.0,9,0.4444444444444444
121303850,1,9,1.0,10,0.1
121305959,1,9,1.0,10,0.1
121309971,1,9,1.0,10,0.1
121317229,4,5,4.0,9,0.4444444444444444
121321224,4,23,4.0,27,0.14814814814814814
121335991,1,7,1.0,8,0.125
121357943,1,9,1.0,10,0.1
121359021,9,1,1.0,10,0.1
121379223,6,4,4.0,10,0.4
121379721,5,4,4.0,9,0.4444444444444444
121380900,1,16,1.0,17,0.058823529411764705
121380995,8,1,1.0,9,0.1111111111111111
121381858,6,4,4.0,10,0.4
121382309,4,6,4.0,10,0.4
121384985,4,6,4.0,10,0.4
121386003,4,16,4.0,20,0.2
121410205,8,1,1.0,9,0.1111111111111111
121422535,2,6,2.0,8,0.25
121448721,1,9,1.0,10,0.1
121457324,1,8,1.0,9,0.1111111111111111
121463809,1,8,1.0,9,0.1111111111111111
121464191,3,7,3.0,10,0.3
121464964,5,5,5.0,10,0.5
121507550,1,9,1.0,10,0.1
121509546,1,9,1.0,10,0.1
121525565,1,8,1.0,9,0.1111111111111111
121540966,2,8,2.0,10,0.2
121549572,1,8,1.0,9,0.1111111111111111
121577279,1,9,1.0,10,0.1
121585920,1,19,1.0,20,0.05
121597114,3,6,3.0,9,0.3333333333333333
121604900,9,1,1.0,10,0.1
121605682,7,3,3.0,10,0.3
121610519,2,8,2.0,10,0.2
121611975,2,8,2.0,10,0.2
121648307,1,16,1.0,17,0.058823529411764705
121648753,1,8,1.0,9,0.1111111111111111
121649068,4,6,4.0,10,0.4
121660283,6,4,4.0,10,0.4
121660425,3,6,3.0,9,0.3333333333333333
121661038,9,1,1.0,10,0.1
121664829,2,7,2.0,9,0.2222222222222222
121673599,1,7,1.0,8,0.125
121686543,8,2,2.0,10,0.2
121697346,1,8,1.0,9,0.1111111111111111
121733182,1,9,1.0,10,0.1
121742872,2,8,2.0,10,0.2
121747533,6,4,4.0,10,0.4
121760861,1,8,1.0,9,0.1111111111111111
121761138,8,2,2.0,10,0.2
121764886,8,2,2.0,10,0.2
121766710,6,3,3.0,9,0.3333333333333333
121769328,9,1,1.0,10,0.1
121774280,2,17,2.0,19,0.10526315789473684
121787026,3,5,3.0,8,0.375
121787639,2,7,2.0,9,0.2222222222222222
121837191,1,9,1.0,10,0.1
121870290,2,7,2.0,9,0.2222222222222222
121913890,3,7,3.0,10,0.3
121922810,11,6,6.0,17,0.35294117647058826
121943374,4,6,4.0,10,0.4
121943626,1,9,1.0,10,0.1
121943900,2,8,2.0,10,0.2
121955980,7,3,3.0,10,0.3
122003508,2,7,2.0,9,0.2222222222222222
122019243,8,1,1.0,9,0.1111111111111111
122019455,3,6,3.0,9,0.3333333333333333
122030808,3,6,3.0,9,0.3333333333333333
122032184,2,7,2.0,9,0.2222222222222222
122034530,6,3,3.0,9,0.3333333333333333
122037906,2,8,2.0,10,0.2
122045447,1,9,1.0,10,0.1
122048517,1,9,1.0,10,0.1
122057854,9,1,1.0,10,0.1
122061558,8,1,1.0,9,0.1111111111111111
122071353,1,8,1.0,9,0.1111111111111111
122090569,1,9,1.0,10,0.1
122091079,1,18,1.0,19,0.05263157894736842
122105892,3,16,3.0,19,0.15789473684210525
122109455,3,7,3.0,10,0.3
122112182,1,9,1.0,10,0.1
122164858,1,8,1.0,9,0.1111111111111111
122177840,1,17,1.0,18,0.05555555555555555
122177939,17,13,13.0,30,0.43333333333333335
122180630,3,7,3.0,10,0.3
122187402,1,9,1.0,10,0.1
122189450,3,16,3.0,19,0.15789473684210525
122193539,2,8,2.0,10,0.2
122211602,1,19,1.0,20,0.05
122249578,1,9,1.0,10,0.1
122251140,3,15,3.0,18,0.16666666666666666
122257636,1,9,1.0,10,0.1
122264996,16,11,11.0,27,0.4074074074074074
122272757,8,1,1.0,9,0.1111111111111111
122276259,8,1,1.0,9,0.1111111111111111
122287441,1,9,1.0,10,0.1
122290209,1,8,1.0,9,0.1111111111111111
122305732,3,6,3.0,9,0.3333333333333333
122314873,7,3,3.0,10,0.3
122316676,6,4,4.0,10,0.4
122320566,1,9,1.0,10,0.1
122325987,23,7,7.0,30,0.23333333333333334
122419989,1,8,1.0,9,0.1111111111111111
122430867,2,18,2.0,20,0.1
122432028,2,26,2.0,28,0.07142857142857142
122432140,1,9,1.0,10,0.1
122440018,1,18,1.0,19,0.05263157894736842
122483372,3,7,3.0,10,0.3
122494676,1,18,1.0,19,0.05263157894736842
122517881,8,2,2.0,10,0.2
122525687,1,9,1.0,10,0.1
122532283,5,5,5.0,10,0.5
122536896,2,17,2.0,19,0.10526315789473684
122548517,1,19,1.0,20,0.05
122560905,3,6,3.0,9,0.3333333333333333
122570190,1,8,1.0,9,0.1111111111111111
122589564,1,8,1.0,9,0.1111111111111111
122595029,9,1,1.0,10,0.1
122596608,9,1,1.0,10,0.1
122599359,1,8,1.0,9,0.1111111111111111
122616743,4,6,4.0,10,0.4
122620491,13,13,13.0,26,0.5
122625715,4,5,4.0,9,0.4444444444444444
122637272,2,7,2.0,9,0.2222222222222222
122640670,9,7,7.0,16,0.4375
122665003,8,2,2.0,10,0.2
122665758,8,2,2.0,10,0.2
122681596,1,9,1.0,10,0.1
122681766,27,1,1.0,28,0.03571428571428571
122688183,4,6,4.0,10,0.4
122690001,1,9,1.0,10,0.1
122690003,1,8,1.0,9,0.1111111111111111
122692110,1,8,1.0,9,0.1111111111111111
122729021,1,9,1.0,10,0.1
122734686,1,18,1.0,19,0.05263157894736842
122750088,2,18,2.0,20,0.1
122750693,1,9,1.0,10,0.1
122760672,5,4,4.0,9,0.4444444444444444
122762626,1,8,1.0,9,0.1111111111111111
122763319,3,27,3.0,30,0.1
122764960,5,24,5.0,29,0.1724137931034483
122786483,6,3,3.0,9,0.3333333333333333
122792874,2,8,2.0,10,0.2
122797427,3,15,3.0,18,0.16666666666666666
122807964,4,6,4.0,10,0.4
122826417,2,8,2.0,10,0.2
122833250,2,17,2.0,19,0.10526315789473684
122868080,1,19,1.0,20,0.05
122868807,1,8,1.0,9,0.1111111111111111
122890761,1,9,1.0,10,0.1
122897337,8,1,1.0,9,0.1111111111111111
122922847,1,9,1.0,10,0.1
122924239,3,5,3.0,8,0.375
122971552,2,17,2.0,19,0.10526315789473684
122986976,1,8,1.0,9,0.1111111111111111
122987123,2,8,2.0,10,0.2
123009567,5,3,3.0,8,0.375
123017049,1,9,1.0,10,0.1
123025363,1,8,1.0,9,0.1111111111111111
123028853,8,1,1.0,9,0.1111111111111111
123029802,8,1,1.0,9,0.1111111111111111
123030558,3,6,3.0,9,0.3333333333333333
123034779,1,8,1.0,9,0.1111111111111111
123035382,3,25,3.0,28,0.10714285714285714
123035906,1,7,1.0,8,0.125
123059858,1,8,1.0,9,0.1111111111111111
123061017,1,18,1.0,19,0.05263157894736842
123064891,4,6,4.0,10,0.4
123066120,1,7,1.0,8,0.125
123066497,3,7,3.0,10,0.3
123072094,2,17,2.0,19,0.10526315789473684
123072494,1,8,1.0,9,0.1111111111111111
123094824,2,7,2.0,9,0.2222222222222222
123094975,1,8,1.0,9,0.1111111111111111
123107991,1,9,1.0,10,0.1
123134762,3,7,3.0,10,0.3
123139053,6,4,4.0,10,0.4
123147430,2,8,2.0,10,0.2
123154069,21,8,8.0,29,0.27586206896551724
123169791,7,3,3.0,10,0.3
123170400,1,8,1.0,9,0.1111111111111111
123176930,2,7,2.0,9,0.2222222222222222
123177285,5,5,5.0,10,0.5
123200731,3,14,3.0,17,0.17647058823529413
123219608,1,9,1.0,10,0.1
123227237,1,9,1.0,10,0.1
123227569,3,7,3.0,10,0.3
123231194,1,9,1.0,10,0.1
123237800,1,8,1.0,9,0.1111111111111111
123239685,1,9,1.0,10,0.1
123257055,1,9,1.0,10,0.1
123271376,1,19,1.0,20,0.05
123276548,2,8,2.0,10,0.2
123278053,2,18,2.0,20,0.1
123278287,2,8,2.0,10,0.2
123279213,1,9,1.0,10,0.1
123282384,1,9,1.0,10,0.1
123311317,1,17,1.0,18,0.05555555555555555
123312547,1,18,1.0,19,0.05263157894736842
123343085,1,8,1.0,9,0.1111111111111111
123352363,4,6,4.0,10,0.4
123353030,5,5,5.0,10,0.5
123353688,2,8,2.0,10,0.2
123357461,1,9,1.0,10,0.1
123361059,9,1,1.0,10,0.1
123365681,2,8,2.0,10,0.2
123372246,1,9,1.0,10,0.1
123377223,5,23,5.0,28,0.17857142857142858
123385112,1,18,1.0,19,0.05263157894736842
123386981,7,2,2.0,9,0.2222222222222222
123390744,4,15,4.0,19,0.21052631578947367
123391328,17,11,11.0,28,0.39285714285714285
123402019,1,19,1.0,20,0.05
123449188,1,9,1.0,10,0.1
123475490,1,8,1.0,9,0.1111111111111111
123476569,1,9,1.0,10,0.1
123478472,1,9,1.0,10,0.1
123479619,1,7,1.0,8,0.125
123483793,1,18,1.0,19,0.05263157894736842
123484066,13,7,7.0,20,0.35
123500539,2,8,2.0,10,0.2
123510677,1,9,1.0,10,0.1
123558311,4,15,4.0,19,0.21052631578947367
123580687,2,8,2.0,10,0.2
123583076,6,23,6.0,29,0.20689655172413793
123583822,3,7,3.0,10,0.3
123584846,3,7,3.0,10,0.3
123593354,11,9,9.0,20,0.45
123604432,1,19,1.0,20,0.05
123653983,1,9,1.0,10,0.1
123657368,9,1,1.0,10,0.1
123688542,2,7,2.0,9,0.2222222222222222
123705619,2,24,2.0,26,0.07692307692307693
123728778,1,8,1.0,9,0.1111111111111111
123742978,1,9,1.0,10,0.1
123784778,8,1,1.0,9,0.1111111111111111
123791651,1,8,1.0,9,0.1111111111111111
123800052,8,2,2.0,10,0.2
123800591,5,4,4.0,9,0.4444444444444444
123808716,1,9,1.0,10,0.1
123808836,7,2,2.0,9,0.2222222222222222
123834892,2,6,2.0,8,0.25
123840458,8,1,1.0,9,0.1111111111111111
123842629,2,7,2.0,9,0.2222222222222222
123869894,5,4,4.0,9,0.4444444444444444
123877808,1,9,1.0,10,0.1
123879035,1,7,1.0,8,0.125
123880067,7,3,3.0,10,0.3
123940426,6,13,6.0,19,0.3157894736842105
123968117,5,5,5.0,10,0.5
123974683,1,9,1.0,10,0.1
124016851,1,9,1.0,10,0.1
124019368,1,9,1.0,10,0.1
124035042,3,6,3.0,9,0.3333333333333333
124045114,2,8,2.0,10,0.2
124047968,12,15,12.0,27,0.4444444444444444
124052945,1,9,1.0,10,0.1
124059356,1,9,1.0,10,0.1
124123495,9,1,1.0,10,0.1
124137685,6,22,6.0,28,0.21428571428571427
124148052,2,8,2.0,10,0.2
124195332,1,8,1.0,9,0.1111111111111111
124199849,7,2,2.0,9,0.2222222222222222
124218465,2,8,2.0,10,0.2
124222113,7,2,2.0,9,0.2222222222222222
124226365,6,3,3.0,9,0.3333333333333333
124241730,8,2,2.0,10,0.2
124247810,3,6,3.0,9,0.3333333333333333
124248712,6,3,3.0,9,0.3333333333333333
124252364,5,4,4.0,9,0.4444444444444444
124277549,1,8,1.0,9,0.1111111111111111
124284154,1,9,1.0,10,0.1
124287970,4,6,4.0,10,0.4
124288499,3,6,3.0,9,0.3333333333333333
124295346,2,7,2.0,9,0.2222222222222222
124297699,5,25,5.0,30,0.16666666666666666
124298951,1,9,1.0,10,0.1
124299869,3,7,3.0,10,0.3
124300857,1,9,1.0,10,0.1
124301279,1,9,1.0,10,0.1
124311681,3,7,3.0,10,0.3
124312011,2,8,2.0,10,0.2
124343584,1,8,1.0,9,0.1111111111111111
124349871,3,26,3.0,29,0.10344827586206896
124354101,7,2,2.0,9,0.2222222222222222
124358493,1,19,1.0,20,0.05
124378010,1,8,1.0,9,0.1111111111111111
124397485,7,2,2.0,9,0.2222222222222222
124423081,7,13,7.0,20,0.35
124423816,2,8,2.0,10,0.2
124452201,2,8,2.0,10,0.2
124452305,1,9,1.0,10,0.1
124458526,5,4,4.0,9,0.4444444444444444
124484032,1,9,1.0,10,0.1
124507097,1,9,1.0,10,0.1
124509728,16,13,13.0,29,0.4482758620689655
124524370,9,1,1.0,10,0.1
124525513,1,9,1.0,10,0.1
124532744,9,1,1.0,10,0.1
124554045,5,5,5.0,10,0.5
124563937,3,7,3.0,10,0.3
124576231,1,8,1.0,9,0.1111111111111111
124576736,6,3,3.0,9,0.3333333333333333
124585903,1,9,1.0,10,0.1
124595856,1,17,1.0,18,0.05555555555555555
124598902,2,7,2.0,9,0.2222222222222222
124621075,1,9,1.0,10,0.1
124633953,1,19,1.0,20,0.05
124641448,2,8,2.0,10,0.2
124645379,1,9,1.0,10,0.1
124657245,8,2,2.0,10,0.2
124660012,1,8,1.0,9,0.1111111111111111
124685583,4,5,4.0,9,0.4444444444444444
124735592,4,6,4.0,10,0.4
124737934,5,5,5.0,10,0.5
124751410,1,9,1.0,10,0.1
124757748,7,3,3.0,10,0.3
124761079,1,18,1.0,19,0.05263157894736842
124778143,1,8,1.0,9,0.1111111111111111
124779629,1,9,1.0,10,0.1
124814159,1,8,1.0,9,0.1111111111111111
124859159,1,9,1.0,10,0.1
124871410,2,8,2.0,10,0.2
124881522,8,1,1.0,9,0.1111111111111111
124882114,1,24,1.0,25,0.04
124915118,9,1,1.0,10,0.1
124915127,9,1,1.0,10,0.1
124916000,1,9,1.0,10,0.1
124916531,6,4,4.0,10,0.4
124917442,1,9,1.0,10,0.1
124920048,2,8,2.0,10,0.2
124954065,1,9,1.0,10,0.1
124957791,5,5,5.0,10,0.5
124968089,3,7,3.0,10,0.3
124968523,8,2,2.0,10,0.2
124969399,6,22,6.0,28,0.21428571428571427
124997750,2,8,2.0,10,0.2
124997801,5,3,3.0,8,0.375
124999772,6,4,4.0,10,0.4
125004954,11,16,11.0,27,0.4074074074074074
125006246,6,2,2.0,8,0.25
125008619,2,8,2.0,10,0.2
125012734,7,3,3.0,10,0.3
125017644,5,5,5.0,10,0.5
125018965,4,5,4.0,9,0.4444444444444444
125019487,9,1,1.0,10,0.1
125019683,7,3,3.0,10,0.3
125021257,8,21,8.0,29,0.27586206896551724
125021919,4,6,4.0,10,0.4
125031865,2,8,2.0,10,0.2
125032864,2,8,2.0,10,0.2
125034211,1,9,1.0,10,0.1
125040583,2,7,2.0,9,0.2222222222222222
125043169,2,7,2.0,9,0.2222222222222222
125050273,6,4,4.0,10,0.4
125051227,6,4,4.0,10,0.4
125082522,2,8,2.0,10,0.2
125083304,4,5,4.0,9,0.4444444444444444
125085194,2,8,2.0,10,0.2
125135248,1,7,1.0,8,0.125
125139040,4,6,4.0,10,0.4
125141410,2,8,2.0,10,0.2
125175634,7,3,3.0,10,0.3
125217210,1,9,1.0,10,0.1
125222061,5,5,5.0,10,0.5
125234175,2,6,2.0,8,0.25
125235087,4,6,4.0,10,0.4
125241836,8,1,1.0,9,0.1111111111111111
125258675,3,6,3.0,9,0.3333333333333333
125262251,3,6,3.0,9,0.3333333333333333
125274201,3,6,3.0,9,0.3333333333333333
125294430,9,1,1.0,10,0.1
125312392,4,14,4.0,18,0.2222222222222222
125324250,1,9,1.0,10,0.1
125328474,1,8,1.0,9,0.1111111111111111
125331121,1,19,1.0,20,0.05
125334192,2,12,2.0,14,0.14285714285714285
125334290,1,8,1.0,9,0.1111111111111111
125334972,4,5,4.0,9,0.4444444444444444
125336813,3,5,3.0,8,0.375
125337931,2,8,2.0,10,0.2
125339506,3,7,3.0,10,0.3
125340026,4,6,4.0,10,0.4
125341032,1,9,1.0,10,0.1
125341296,3,26,3.0,29,0.10344827586206896
125341686,7,1,1.0,8,0.125
125343699,5,5,5.0,10,0.5
125345878,4,6,4.0,10,0.4
125348592,1,9,1.0,10,0.1
125348991,1,9,1.0,10,0.1
125350225,2,7,2.0,9,0.2222222222222222
125353660,1,9,1.0,10,0.1
125363353,4,23,4.0,27,0.14814814814814814
125408954,7,3,3.0,10,0.3
125430205,1,9,1.0,10,0.1
125447251,6,22,6.0,28,0.21428571428571427
125448041,1,9,1.0,10,0.1
125449500,1,9,1.0,10,0.1
125451006,1,17,1.0,18,0.05555555555555555
125483034,1,18,1.0,19,0.05263157894736842
125483566,3,7,3.0,10,0.3
125484602,2,8,2.0,10,0.2
125495151,1,9,1.0,10,0.1
125496920,1,9,1.0,10,0.1
125514301,2,7,2.0,9,0.2222222222222222
125532395,5,5,5.0,10,0.5
125533560,1,28,1.0,29,0.034482758620689655
125539689,1,9,1.0,10,0.1
125574245,9,17,9.0,26,0.34615384615384615
125593935,1,8,1.0,9,0.1111111111111111
125614190,4,5,4.0,9,0.4444444444444444
125615405,2,7,2.0,9,0.2222222222222222
125650052,9,1,1.0,10,0.1
125652931,2,7,2.0,9,0.2222222222222222
125658948,2,8,2.0,10,0.2
125659827,3,7,3.0,10,0.3
125660949,6,3,3.0,9,0.3333333333333333
125661549,5,5,5.0,10,0.5
125669370,1,8,1.0,9,0.1111111111111111
125695814,2,8,2.0,10,0.2
125696566,5,5,5.0,10,0.5
125712295,7,2,2.0,9,0.2222222222222222
125714252,28,2,2.0,30,0.06666666666666667
125723962,9,1,1.0,10,0.1
125783157,3,5,3.0,8,0.375
125792617,1,9,1.0,10,0.1
125815894,1,9,1.0,10,0.1
125821284,1,9,1.0,10,0.1
125822345,6,3,3.0,9,0.3333333333333333
125822669,6,4,4.0,10,0.4
125830540,1,9,1.0,10,0.1
125843119,1,17,1.0,18,0.05555555555555555
125868490,8,1,1.0,9,0.1111111111111111
125869546,7,3,3.0,10,0.3
125871441,7,3,3.0,10,0.3
125873787,8,2,2.0,10,0.2
125889831,1,8,1.0,9,0.1111111111111111
125891923,4,6,4.0,10,0.4
125898472,1,18,1.0,19,0.05263157894736842
125904941,1,9,1.0,10,0.1
125906772,1,27,1.0,28,0.03571428571428571
125924942,6,4,4.0,10,0.4
125940621,8,2,2.0,10,0.2
125941124,3,6,3.0,9,0.3333333333333333
125950492,4,5,4.0,9,0.4444444444444444
125972045,1,8,1.0,9,0.1111111111111111
125994623,2,6,2.0,8,0.25
125998878,1,9,1.0,10,0.1
126014538,28,1,1.0,29,0.034482758620689655
126018634,1,9,1.0,10,0.1
126047224,4,23,4.0,27,0.14814814814814814
126107000,1,8,1.0,9,0.1111111111111111
126107958,1,8,1.0,9,0.1111111111111111
126120225,7,2,2.0,9,0.2222222222222222
126127306,1,18,1.0,19,0.05263157894736842
126128341,2,8,2.0,10,0.2
126141412,2,6,2.0,8,0.25
126209935,1,9,1.0,10,0.1
126233482,6,20,6.0,26,0.23076923076923078
126234202,1,9,1.0,10,0.1
126237469,6,4,4.0,10,0.4
126268982,3,6,3.0,9,0.3333333333333333
126274555,1,7,1.0,8,0.125
126278411,3,6,3.0,9,0.3333333333333333
126288031,2,8,2.0,10,0.2
126288865,1,9,1.0,10,0.1
126295415,3,7,3.0,10,0.3
126300108,1,8,1.0,9,0.1111111111111111
126307065,1,17,1.0,18,0.05555555555555555
126310471,1,7,1.0,8,0.125
126310666,2,7,2.0,9,0.2222222222222222
126326920,8,1,1.0,9,0.1111111111111111
126327188,3,6,3.0,9,0.3333333333333333
126348671,22,5,5.0,27,0.18518518518518517
126357626,1,8,1.0,9,0.1111111111111111
126373971,2,18,2.0,20,0.1
126381210,10,14,10.0,24,0.4166666666666667
126384475,1,9,1.0,10,0.1
126393280,8,15,8.0,23,0.34782608695652173
126409074,1,9,1.0,10,0.1
126429389,3,7,3.0,10,0.3
126432352,9,1,1.0,10,0.1
126436716,19,10,10.0,29,0.3448275862068966
126441894,2,8,2.0,10,0.2
126458362,1,9,1.0,10,0.1
126467655,1,9,1.0,10,0.1
126486822,2,8,2.0,10,0.2
126486968,2,6,2.0,8,0.25
126488683,8,1,1.0,9,0.1111111111111111
126493504,2,15,2.0,17,0.11764705882352941
126497034,1,8,1.0,9,0.1111111111111111
126498360,2,7,2.0,9,0.2222222222222222
126519465,1,17,1.0,18,0.05555555555555555
126529531,2,7,2.0,9,0.2222222222222222
126536827,2,8,2.0,10,0.2
126571272,1,7,1.0,8,0.125
126572317,3,7,3.0,10,0.3
126621910,4,6,4.0,10,0.4
126655241,14,3,3.0,17,0.17647058823529413
126669389,1,9,1.0,10,0.1
126719131,5,4,4.0,9,0.4444444444444444
126719639,4,6,4.0,10,0.4
126729210,2,6,2.0,8,0.25
126733119,2,8,2.0,10,0.2
126739544,1,9,1.0,10,0.1
126747750,4,5,4.0,9,0.4444444444444444
126751651,2,8,2.0,10,0.2
126752670,2,8,2.0,10,0.2
126754653,2,8,2.0,10,0.2
126756942,2,8,2.0,10,0.2
126758712,1,9,1.0,10,0.1
126762352,2,26,2.0,28,0.07142857142857142
126797958,1,9,1.0,10,0.1
126818984,1,9,1.0,10,0.1
126850782,3,15,3.0,18,0.16666666666666666
126881735,1,25,1.0,26,0.038461538461538464
126894646,9,1,1.0,10,0.1
126897385,5,3,3.0,8,0.375
126898153,4,6,4.0,10,0.4
126916411,2,8,2.0,10,0.2
126936114,2,16,2.0,18,0.1111111111111111
126941117,23,6,6.0,29,0.20689655172413793
126957321,6,4,4.0,10,0.4
126976215,1,8,1.0,9,0.1111111111111111
127004152,1,9,1.0,10,0.1
127004474,5,14,5.0,19,0.2631578947368421
127006901,4,6,4.0,10,0.4
127036234,11,8,8.0,19,0.42105263157894735
127050755,4,6,4.0,10,0.4
127059233,4,4,4.0,8,0.5
127070001,9,1,1.0,10,0.1
127076298,4,6,4.0,10,0.4
127077066,1,19,1.0,20,0.05
127077270,2,8,2.0,10,0.2
127077625,2,8,2.0,10,0.2
127152188,2,8,2.0,10,0.2
127159721,2,8,2.0,10,0.2
127170257,19,1,1.0,20,0.05
127176908,3,7,3.0,10,0.3
127185850,1,15,1.0,16,0.0625
127189977,2,7,2.0,9,0.2222222222222222
127192604,15,5,5.0,20,0.25
127216132,3,7,3.0,10,0.3
127222027,2,8,2.0,10,0.2
127223536,2,6,2.0,8,0.25
127246706,1,9,1.0,10,0.1
127257570,2,8,2.0,10,0.2
127260183,9,1,1.0,10,0.1
127271224,1,27,1.0,28,0.03571428571428571
127283029,2,8,2.0,10,0.2
127287889,7,2,2.0,9,0.2222222222222222
127302313,1,8,1.0,9,0.1111111111111111
127307270,8,2,2.0,10,0.2
127318409,1,9,1.0,10,0.1
127318589,1,9,1.0,10,0.1
127319003,23,5,5.0,28,0.17857142857142858
127319744,9,1,1.0,10,0.1
127332810,1,8,1.0,9,0.1111111111111111
127338302,7,2,2.0,9,0.2222222222222222
127339515,1,23,1.0,24,0.041666666666666664
127368798,6,4,4.0,10,0.4
127379824,1,9,1.0,10,0.1
127397856,1,8,1.0,9,0.1111111111111111
127416028,1,19,1.0,20,0.05
127420058,9,9,9.0,18,0.5
127428559,2,7,2.0,9,0.2222222222222222
127443274,3,7,3.0,10,0.3
127460684,1,9,1.0,10,0.1
127463053,1,8,1.0,9,0.1111111111111111
127475143,3,7,3.0,10,0.3
127475449,4,5,4.0,9,0.4444444444444444
127476403,1,9,1.0,10,0.1
127495611,2,7,2.0,9,0.2222222222222222
127549238,1,9,1.0,10,0.1
127599636,1,8,1.0,9,0.1111111111111111
127632456,1,9,1.0,10,0.1
127688043,9,1,1.0,10,0.1
127690443,9,1,1.0,10,0.1
127690761,1,17,1.0,18,0.05555555555555555
127713957,7,3,3.0,10,0.3
127721264,1,9,1.0,10,0.1
127742133,10,19,10.0,29,0.3448275862068966
127744049,1,27,1.0,28,0.03571428571428571
127748799,1,9,1.0,10,0.1
127767925,1,7,1.0,8,0.125
127775737,5,4,4.0,9,0.4444444444444444
127775890,1,15,1.0,16,0.0625
127783293,5,5,5.0,10,0.5
127784164,3,7,3.0,10,0.3
127784232,1,7,1.0,8,0.125
127784391,1,9,1.0,10,0.1
127784942,7,1,1.0,8,0.125
127786472,3,7,3.0,10,0.3
127787552,7,3,3.0,10,0.3
127791805,1,9,1.0,10,0.1
127800325,2,7,2.0,9,0.2222222222222222
127814340,4,6,4.0,10,0.4
127822045,1,9,1.0,10,0.1
127830810,2,8,2.0,10,0.2
127833147,2,6,2.0,8,0.25
127845333,1,8,1.0,9,0.1111111111111111
127847312,1,8,1.0,9,0.1111111111111111
127848502,5,5,5.0,10,0.5
127849591,1,9,1.0,10,0.1
127849880,1,8,1.0,9,0.1111111111111111
127850137,2,8,2.0,10,0.2
127850855,4,25,4.0,29,0.13793103448275862
127851137,2,7,2.0,9,0.2222222222222222
127854299,4,6,4.0,10,0.4
127860180,8,1,1.0,9,0.1111111111111111
127860261,2,7,2.0,9,0.2222222222222222
127880424,1,9,1.0,10,0.1
127880896,1,18,1.0,19,0.05263157894736842
127888168,1,8,1.0,9,0.1111111111111111
127906685,1,8,1.0,9,0.1111111111111111
127914004,1,18,1.0,19,0.05263157894736842
127914320,1,9,1.0,10,0.1
127926695,1,8,1.0,9,0.1111111111111111
127926714,1,18,1.0,19,0.05263157894736842
127942558,5,5,5.0,10,0.5
127964184,5,4,4.0,9,0.4444444444444444
127972105,1,7,1.0,8,0.125
127973704,1,8,1.0,9,0.1111111111111111
127977677,2,8,2.0,10,0.2
127978204,1,9,1.0,10,0.1
127983905,1,8,1.0,9,0.1111111111111111
128009684,1,28,1.0,29,0.034482758620689655
128019187,1,8,1.0,9,0.1111111111111111
128066573,6,4,4.0,10,0.4
128068293,1,18,1.0,19,0.05263157894736842
128076949,5,4,4.0,9,0.4444444444444444
128094440,2,16,2.0,18,0.1111111111111111
128105295,4,5,4.0,9,0.4444444444444444
128118203,5,4,4.0,9,0.4444444444444444
128118509,3,7,3.0,10,0.3
128119647,14,6,6.0,20,0.3
128147882,2,8,2.0,10,0.2
128154466,1,9,1.0,10,0.1
128155146,3,7,3.0,10,0.3
128164513,8,2,2.0,10,0.2
128164808,17,12,12.0,29,0.41379310344827586
128165085,1,8,1.0,9,0.1111111111111111
128165553,1,9,1.0,10,0.1
128167975,4,5,4.0,9,0.4444444444444444
128182811,1,19,1.0,20,0.05
128187838,3,6,3.0,9,0.3333333333333333
128194570,3,6,3.0,9,0.3333333333333333
128194768,6,4,4.0,10,0.4
128208578,18,10,10.0,28,0.35714285714285715
128211500,3,17,3.0,20,0.15
128213289,1,8,1.0,9,0.1111111111111111
128220172,1,17,1.0,18,0.05555555555555555
128227629,1,9,1.0,10,0.1
128258386,1,19,1.0,20,0.05
128260040,3,7,3.0,10,0.3
128268664,2,17,2.0,19,0.10526315789473684
128287498,2,8,2.0,10,0.2
128288358,1,8,1.0,9,0.1111111111111111
128303035,5,5,5.0,10,0.5
128312350,2,8,2.0,10,0.2
128357599,2,8,2.0,10,0.2
128359026,1,17,1.0,18,0.05555555555555555
128362199,1,9,1.0,10,0.1
128365045,5,4,4.0,9,0.4444444444444444
128367330,3,5,3.0,8,0.375
128368217,28,1,1.0,29,0.034482758620689655
128369517,1,8,1.0,9,0.1111111111111111
128389053,2,8,2.0,10,0.2
128413567,1,8,1.0,9,0.1111111111111111
128432795,4,5,4.0,9,0.4444444444444444
128433574,1,7,1.0,8,0.125
128445340,1,9,1.0,10,0.1
128459338,1,9,1.0,10,0.1
128459695,1,18,1.0,19,0.05263157894736842
128466863,2,8,2.0,10,0.2
128514789,1,8,1.0,9,0.1111111111111111
128522305,24,6,6.0,30,0.2
128536216,1,9,1.0,10,0.1
128539742,4,6,4.0,10,0.4
128546083,2,6,2.0,8,0.25
128573627,1,8,1.0,9,0.1111111111111111
128585242,1,9,1.0,10,0.1
128607086,2,7,2.0,9,0.2222222222222222
128607113,1,8,1.0,9,0.1111111111111111
128611375,1,8,1.0,9,0.1111111111111111
128625822,1,7,1.0,8,0.125
128630889,8,2,2.0,10,0.2
128631067,1,9,1.0,10,0.1
128631432,2,8,2.0,10,0.2
128635443,1,8,1.0,9,0.1111111111111111
128673936,1,18,1.0,19,0.05263157894736842
128681812,8,2,2.0,10,0.2
128682966,1,9,1.0,10,0.1
128726926,2,8,2.0,10,0.2
128750234,1,9,1.0,10,0.1
128751463,4,15,4.0,19,0.21052631578947367
128783900,4,15,4.0,19,0.21052631578947367
128787601,3,6,3.0,9,0.3333333333333333
128789332,4,6,4.0,10,0.4
128789741,2,25,2.0,27,0.07407407407407407
128821460,4,6,4.0,10,0.4
128821675,3,6,3.0,9,0.3333333333333333
128823320,1,7,1.0,8,0.125
128823745,1,8,1.0,9,0.1111111111111111
128824839,6,4,4.0,10,0.4
128825741,2,7,2.0,9,0.2222222222222222
128826097,3,7,3.0,10,0.3
128827034,3,7,3.0,10,0.3
128827430,3,6,3.0,9,0.3333333333333333
128828376,4,6,4.0,10,0.4
128843736,2,7,2.0,9,0.2222222222222222
128843885,1,9,1.0,10,0.1
128856130,1,8,1.0,9,0.1111111111111111
128924906,1,9,1.0,10,0.1
128970400,4,6,4.0,10,0.4
128991495,1,17,1.0,18,0.05555555555555555
129046382,1,9,1.0,10,0.1
129051509,1,9,1.0,10,0.1
129074501,9,1,1.0,10,0.1
129078330,2,8,2.0,10,0.2
129103227,1,9,1.0,10,0.1
129110018,1,18,1.0,19,0.05263157894736842
129117307,1,8,1.0,9,0.1111111111111111
129125670,2,8,2.0,10,0.2
129127959,2,8,2.0,10,0.2
129138313,2,7,2.0,9,0.2222222222222222
129140603,1,8,1.0,9,0.1111111111111111
129155455,2,8,2.0,10,0.2
129158917,7,22,7.0,29,0.2413793103448276
129161608,1,9,1.0,10,0.1
129164788,1,8,1.0,9,0.1111111111111111
129165989,11,18,11.0,29,0.3793103448275862
129176850,11,16,11.0,27,0.4074074074074074
129179422,8,21,8.0,29,0.27586206896551724
129192923,2,6,2.0,8,0.25
129194514,1,9,1.0,10,0.1
129275721,1,9,1.0,10,0.1
129280712,1,9,1.0,10,0.1
129308497,1,17,1.0,18,0.05555555555555555
129337236,1,8,1.0,9,0.1111111111111111
129399733,1,8,1.0,9,0.1111111111111111
129404429,2,8,2.0,10,0.2
129446876,1,8,1.0,9,0.1111111111111111
129470253,7,2,2.0,9,0.2222222222222222
129471561,6,3,3.0,9,0.3333333333333333
129483447,1,9,1.0,10,0.1
129485468,1,9,1.0,10,0.1
129485754,1,9,1.0,10,0.1
129486132,1,8,1.0,9,0.1111111111111111
129486928,1,9,1.0,10,0.1
129488488,2,18,2.0,20,0.1
129489957,2,7,2.0,9,0.2222222222222222
129490113,1,9,1.0,10,0.1
129492223,2,7,2.0,9,0.2222222222222222
129497001,4,6,4.0,10,0.4
129498559,21,5,5.0,26,0.19230769230769232
129513929,1,9,1.0,10,0.1
129515361,1,9,1.0,10,0.1
129520239,1,7,1.0,8,0.125
129537897,2,16,2.0,18,0.1111111111111111
129561173,1,9,1.0,10,0.1
129572382,1,8,1.0,9,0.1111111111111111
129595950,9,1,1.0,10,0.1
129598118,4,4,4.0,8,0.5
129605897,2,7,2.0,9,0.2222222222222222
129610840,4,5,4.0,9,0.4444444444444444
129616463,3,7,3.0,10,0.3
129617050,6,13,6.0,19,0.3157894736842105
129619848,5,4,4.0,9,0.4444444444444444
129621731,2,8,2.0,10,0.2
129628343,3,6,3.0,9,0.3333333333333333
129630313,1,9,1.0,10,0.1
129658958,1,8,1.0,9,0.1111111111111111
129660401,4,16,4.0,20,0.2
129664579,3,7,3.0,10,0.3
129673903,3,7,3.0,10,0.3
129682923,3,6,3.0,9,0.3333333333333333
129684623,3,6,3.0,9,0.3333333333333333
129685066,3,7,3.0,10,0.3
129700111,1,9,1.0,10,0.1
129703995,3,6,3.0,9,0.3333333333333333
129704059,3,6,3.0,9,0.3333333333333333
129707188,7,2,2.0,9,0.2222222222222222
129711007,1,8,1.0,9,0.1111111111111111
129718863,6,4,4.0,10,0.4
129720052,1,8,1.0,9,0.1111111111111111
129721620,5,23,5.0,28,0.17857142857142858
129767612,7,3,3.0,10,0.3
129780819,8,2,2.0,10,0.2
129792650,9,1,1.0,10,0.1
129853390,6,3,3.0,9,0.3333333333333333
129864822,2,8,2.0,10,0.2
129867688,7,3,3.0,10,0.3
129870612,5,5,5.0,10,0.5
129871433,9,1,1.0,10,0.1
129871722,3,7,3.0,10,0.3
129883255,1,9,1.0,10,0.1
129887484,1,8,1.0,9,0.1111111111111111
129888260,2,6,2.0,8,0.25
129894675,7,3,3.0,10,0.3
129898258,1,9,1.0,10,0.1
129916180,1,9,1.0,10,0.1
129941300,13,15,13.0,28,0.4642857142857143
129943093,4,4,4.0,8,0.5
129944186,5,3,3.0,8,0.375
129948411,3,15,3.0,18,0.16666666666666666
129965434,2,7,2.0,9,0.2222222222222222
129969322,1,8,1.0,9,0.1111111111111111
129970288,2,18,2.0,20,0.1
129975623,4,6,4.0,10,0.4
130004700,1,18,1.0,19,0.05263157894736842
130035055,1,8,1.0,9,0.1111111111111111
130061342,1,18,1.0,19,0.05263157894736842
130066530,13,14,13.0,27,0.48148148148148145
130066751,3,6,3.0,9,0.3333333333333333
130075255,3,5,3.0,8,0.375
130100227,4,25,4.0,29,0.13793103448275862
130100791,2,8,2.0,10,0.2
130102914,4,4,4.0,8,0.5
130125126,5,4,4.0,9,0.4444444444444444
130145114,1,9,1.0,10,0.1
130182834,4,6,4.0,10,0.4
130187280,3,7,3.0,10,0.3
130189196,6,4,4.0,10,0.4
130214769,1,9,1.0,10,0.1
130250459,4,5,4.0,9,0.4444444444444444
130252891,21,4,4.0,25,0.16
130253043,1,8,1.0,9,0.1111111111111111
130253621,12,16,12.0,28,0.42857142857142855
130262268,8,1,1.0,9,0.1111111111111111
130265082,4,6,4.0,10,0.4
130281747,1,9,1.0,10,0.1
130321738,1,9,1.0,10,0.1
130341339,1,8,1.0,9,0.1111111111111111
130372564,1,17,1.0,18,0.05555555555555555
130372650,1,9,1.0,10,0.1
130388555,3,6,3.0,9,0.3333333333333333
130390043,9,1,1.0,10,0.1
130415724,1,9,1.0,10,0.1
130417277,1,9,1.0,10,0.1
130428870,3,7,3.0,10,0.3
130436100,3,7,3.0,10,0.3
130442709,1,8,1.0,9,0.1111111111111111
130444816,1,9,1.0,10,0.1
130446240,2,18,2.0,20,0.1
130457909,3,7,3.0,10,0.3
130465558,4,6,4.0,10,0.4
130482628,1,15,1.0,16,0.0625
130496926,1,8,1.0,9,0.1111111111111111
130499859,4,6,4.0,10,0.4
130500168,7,2,2.0,9,0.2222222222222222
130508131,2,7,2.0,9,0.2222222222222222
130514153,8,2,2.0,10,0.2
130580335,10,17,10.0,27,0.37037037037037035
130581254,1,26,1.0,27,0.037037037037037035
130590310,1,8,1.0,9,0.1111111111111111
130592456,1,9,1.0,10,0.1
130617759,1,9,1.0,10,0.1
130625001,3,15,3.0,18,0.16666666666666666
130667900,8,2,2.0,10,0.2
130668212,6,3,3.0,9,0.3333333333333333
130670339,14,5,5.0,19,0.2631578947368421
130682806,5,14,5.0,19,0.2631578947368421
130712927,7,2,2.0,9,0.2222222222222222
130737598,5,5,5.0,10,0.5
130762876,1,8,1.0,9,0.1111111111111111
130774122,2,8,2.0,10,0.2
130786929,9,1,1.0,10,0.1
130799111,3,7,3.0,10,0.3
130803247,2,8,2.0,10,0.2
130810079,4,16,4.0,20,0.2
130810102,1,17,1.0,18,0.05555555555555555
130830208,2,6,2.0,8,0.25
130830972,2,7,2.0,9,0.2222222222222222
130831367,2,17,2.0,19,0.10526315789473684
130847113,1,9,1.0,10,0.1
130847487,3,7,3.0,10,0.3
130847972,2,8,2.0,10,0.2
130867961,1,9,1.0,10,0.1
130868249,1,9,1.0,10,0.1
130883816,9,1,1.0,10,0.1
130887110,4,5,4.0,9,0.4444444444444444
130926048,6,14,6.0,20,0.3
130935927,1,19,1.0,20,0.05
130958649,2,8,2.0,10,0.2
130967641,2,8,2.0,10,0.2
130976043,2,7,2.0,9,0.2222222222222222
130976790,4,6,4.0,10,0.4
130977130,3,6,3.0,9,0.3333333333333333
130984941,2,18,2.0,20,0.1
130987570,5,5,5.0,10,0.5
130998328,4,5,4.0,9,0.4444444444444444
130999173,1,9,1.0,10,0.1
130999235,1,7,1.0,8,0.125
131004477,4,5,4.0,9,0.4444444444444444
131011109,3,7,3.0,10,0.3
131021733,2,8,2.0,10,0.2
131040769,2,8,2.0,10,0.2
131042279,1,8,1.0,9,0.1111111111111111
131045087,1,18,1.0,19,0.05263157894736842
131051280,19,10,10.0,29,0.3448275862068966
131057829,4,6,4.0,10,0.4
131079300,7,10,7.0,17,0.4117647058823529
131082453,1,9,1.0,10,0.1
131087522,3,6,3.0,9,0.3333333333333333
131089093,1,16,1.0,17,0.058823529411764705
131133848,1,18,1.0,19,0.05263157894736842
131135244,3,6,3.0,9,0.3333333333333333
131141290,1,18,1.0,19,0.05263157894736842
131180747,4,14,4.0,18,0.2222222222222222
131191585,2,8,2.0,10,0.2
131202381,1,8,1.0,9,0.1111111111111111
131204560,1,8,1.0,9,0.1111111111111111
131211821,1,9,1.0,10,0.1
131217241,5,5,5.0,10,0.5
131221705,8,1,1.0,9,0.1111111111111111
131226283,2,6,2.0,8,0.25
131227716,4,6,4.0,10,0.4
131235306,4,5,4.0,9,0.4444444444444444
131245548,15,13,13.0,28,0.4642857142857143
131245670,3,6,3.0,9,0.3333333333333333
131246614,7,3,3.0,10,0.3
131247277,4,5,4.0,9,0.4444444444444444
131257477,2,7,2.0,9,0.2222222222222222
131264353,4,5,4.0,9,0.4444444444444444
131297711,1,9,1.0,10,0.1
131318380,2,8,2.0,10,0.2
131318930,1,7,1.0,8,0.125
131328639,1,9,1.0,10,0.1
131335101,1,8,1.0,9,0.1111111111111111
131336390,1,9,1.0,10,0.1
131346563,4,15,4.0,19,0.21052631578947367
131370720,3,6,3.0,9,0.3333333333333333
131371353,4,5,4.0,9,0.4444444444444444
131393466,2,8,2.0,10,0.2
131398229,2,7,2.0,9,0.2222222222222222
131425210,5,5,5.0,10,0.5
131426115,8,1,1.0,9,0.1111111111111111
131426405,8,2,2.0,10,0.2
131427457,6,3,3.0,9,0.3333333333333333
131427718,7,2,2.0,9,0.2222222222222222
131428243,13,15,13.0,28,0.4642857142857143
131431749,36,1,1.0,37,0.02702702702702703
131432768,2,18,2.0,20,0.1
131433305,1,8,1.0,9,0.1111111111111111
131434256,5,23,5.0,28,0.17857142857142858
131435154,4,6,4.0,10,0.4
131436141,7,3,3.0,10,0.3
131439721,3,5,3.0,8,0.375
131440142,7,3,3.0,10,0.3
131448148,3,7,3.0,10,0.3
131448382,1,9,1.0,10,0.1
131454205,5,15,5.0,20,0.25
131459096,1,9,1.0,10,0.1
131460755,5,3,3.0,8,0.375
131469871,1,9,1.0,10,0.1
131471952,1,9,1.0,10,0.1
131474188,1,7,1.0,8,0.125
131479183,1,8,1.0,9,0.1111111111111111
131479782,1,9,1.0,10,0.1
131480188,2,6,2.0,8,0.25
131490064,1,9,1.0,10,0.1
131505121,2,8,2.0,10,0.2
131506451,2,27,2.0,29,0.06896551724137931
131507053,1,7,1.0,8,0.125
131514940,1,28,1.0,29,0.034482758620689655
131525937,1,9,1.0,10,0.1
131562137,1,9,1.0,10,0.1
131578972,3,7,3.0,10,0.3
131609673,1,18,1.0,19,0.05263157894736842
131613417,4,6,4.0,10,0.4
131623776,2,7,2.0,9,0.2222222222222222
131629571,1,19,1.0,20,0.05
131635680,7,21,7.0,28,0.25
131637702,7,3,3.0,10,0.3
131640627,1,9,1.0,10,0.1
131652338,2,8,2.0,10,0.2
131653427,23,5,5.0,28,0.17857142857142858
131660328,9,1,1.0,10,0.1
131672506,7,2,2.0,9,0.2222222222222222
131727403,2,7,2.0,9,0.2222222222222222
131731662,4,25,4.0,29,0.13793103448275862
131741854,3,7,3.0,10,0.3
131756130,1,9,1.0,10,0.1
131774174,9,1,1.0,10,0.1
131798283,1,9,1.0,10,0.1
131807298,2,8,2.0,10,0.2
131808125,9,1,1.0,10,0.1
131809348,28,2,2.0,30,0.06666666666666667
131821931,3,16,3.0,19,0.15789473684210525
131836646,1,9,1.0,10,0.1
131837709,13,6,6.0,19,0.3157894736842105
131840564,1,9,1.0,10,0.1
131842105,1,9,1.0,10,0.1
131846717,3,7,3.0,10,0.3
131847233,2,8,2.0,10,0.2
131848143,2,8,2.0,10,0.2
131852646,2,8,2.0,10,0.2
131875221,7,1,1.0,8,0.125
131898435,8,1,1.0,9,0.1111111111111111
131898793,25,3,3.0,28,0.10714285714285714
131920866,5,5,5.0,10,0.5
131925871,4,5,4.0,9,0.4444444444444444
131926664,2,7,2.0,9,0.2222222222222222
131931212,1,8,1.0,9,0.1111111111111111
131943176,2,7,2.0,9,0.2222222222222222
131946833,4,6,4.0,10,0.4
131954206,4,15,4.0,19,0.21052631578947367
132002039,5,5,5.0,10,0.5
132003623,25,4,4.0,29,0.13793103448275862
132008511,1,8,1.0,9,0.1111111111111111
132012322,4,5,4.0,9,0.4444444444444444
132024855,2,8,2.0,10,0.2
132025256,1,8,1.0,9,0.1111111111111111
132034193,8,2,2.0,10,0.2
132052190,1,7,1.0,8,0.125
132062477,1,9,1.0,10,0.1
132070971,1,9,1.0,10,0.1
132100897,3,27,3.0,30,0.1
132102115,1,7,1.0,8,0.125
132104826,1,9,1.0,10,0.1
132114879,9,1,1.0,10,0.1
132134634,1,18,1.0,19,0.05263157894736842
132186555,1,19,1.0,20,0.05
132191453,2,6,2.0,8,0.25
132191676,9,1,1.0,10,0.1
132191792,7,2,2.0,9,0.2222222222222222
132192152,4,6,4.0,10,0.4
132193937,6,4,4.0,10,0.4
132194608,6,2,2.0,8,0.25
132195270,2,8,2.0,10,0.2
132222478,1,19,1.0,20,0.05
132231646,3,6,3.0,9,0.3333333333333333
132239545,2,17,2.0,19,0.10526315789473684
132249345,1,18,1.0,19,0.05263157894736842
132290907,2,8,2.0,10,0.2
132290924,3,7,3.0,10,0.3
132291696,29,1,1.0,30,0.03333333333333333
132293460,23,6,6.0,29,0.20689655172413793
132294103,2,8,2.0,10,0.2
132304129,1,9,1.0,10,0.1
132307348,2,8,2.0,10,0.2
132307557,1,7,1.0,8,0.125
132308042,1,9,1.0,10,0.1
132308421,2,8,2.0,10,0.2
132318201,1,28,1.0,29,0.034482758620689655
132320341,2,26,2.0,28,0.07142857142857142
132323281,1,9,1.0,10,0.1
132328283,1,8,1.0,9,0.1111111111111111
132344840,1,9,1.0,10,0.1
132352411,1,15,1.0,16,0.0625
132358657,20,7,7.0,27,0.25925925925925924
132365181,1,7,1.0,8,0.125
132388096,1,9,1.0,10,0.1
132389524,1,7,1.0,8,0.125
132390226,1,9,1.0,10,0.1
132391889,1,8,1.0,9,0.1111111111111111
132395016,2,7,2.0,9,0.2222222222222222
132402309,1,7,1.0,8,0.125
132405345,7,3,3.0,10,0.3
132460779,2,7,2.0,9,0.2222222222222222
132461852,1,19,1.0,20,0.05
132468323,3,6,3.0,9,0.3333333333333333
132496008,2,7,2.0,9,0.2222222222222222
132526525,1,9,1.0,10,0.1
132533129,6,4,4.0,10,0.4
132584319,1,9,1.0,10,0.1
132587570,1,9,1.0,10,0.1
132613155,1,8,1.0,9,0.1111111111111111
132639676,2,7,2.0,9,0.2222222222222222
132643528,1,9,1.0,10,0.1
132658538,2,7,2.0,9,0.2222222222222222
132659541,1,9,1.0,10,0.1
132717810,1,7,1.0,8,0.125
132738232,1,9,1.0,10,0.1
132740778,2,7,2.0,9,0.2222222222222222
132743300,1,8,1.0,9,0.1111111111111111
132748716,1,9,1.0,10,0.1
132759448,1,7,1.0,8,0.125
132760067,1,9,1.0,10,0.1
132762879,1,9,1.0,10,0.1
132767324,2,7,2.0,9,0.2222222222222222
132778607,1,8,1.0,9,0.1111111111111111
132778761,2,8,2.0,10,0.2
132813436,6,4,4.0,10,0.4
132817593,8,1,1.0,9,0.1111111111111111
132831929,1,8,1.0,9,0.1111111111111111
132840201,19,8,8.0,27,0.2962962962962963
132840853,7,2,2.0,9,0.2222222222222222
132841897,8,2,2.0,10,0.2
132851537,2,8,2.0,10,0.2
132868069,3,6,3.0,9,0.3333333333333333
132903226,7,21,7.0,28,0.25
132922131,1,17,1.0,18,0.05555555555555555
132942091,1,19,1.0,20,0.05
132949963,1,8,1.0,9,0.1111111111111111
132952132,1,8,1.0,9,0.1111111111111111
132972793,8,1,1.0,9,0.1111111111111111
132988899,1,9,1.0,10,0.1
133003659,3,6,3.0,9,0.3333333333333333
133008859,1,9,1.0,10,0.1
133032997,2,8,2.0,10,0.2
133035858,10,19,10.0,29,0.3448275862068966
133056146,1,8,1.0,9,0.1111111111111111
133057258,3,7,3.0,10,0.3
133073158,1,18,1.0,19,0.05263157894736842
133107005,3,7,3.0,10,0.3
133120664,3,7,3.0,10,0.3
133124572,7,3,3.0,10,0.3
133127136,1,9,1.0,10,0.1
133133549,5,5,5.0,10,0.5
133151711,1,9,1.0,10,0.1
133162138,1,17,1.0,18,0.05555555555555555
133175731,9,1,1.0,10,0.1
133190427,7,22,7.0,29,0.2413793103448276
133194816,3,7,3.0,10,0.3
133197847,3,6,3.0,9,0.3333333333333333
133200240,5,5,5.0,10,0.5
133200847,5,4,4.0,9,0.4444444444444444
133202333,3,7,3.0,10,0.3
133203430,6,4,4.0,10,0.4
133209113,4,5,4.0,9,0.4444444444444444
133216650,1,19,1.0,20,0.05
133216949,15,13,13.0,28,0.4642857142857143
133230955,6,24,6.0,30,0.2
133236717,1,7,1.0,8,0.125
133237462,25,1,1.0,26,0.038461538461538464
133238203,8,1,1.0,9,0.1111111111111111
133239679,2,6,2.0,8,0.25
133240361,2,8,2.0,10,0.2
133241631,9,1,1.0,10,0.1
133255580,11,7,7.0,18,0.3888888888888889
133287687,4,6,4.0,10,0.4
133293711,1,17,1.0,18,0.05555555555555555
133316080,9,1,1.0,10,0.1
133320627,1,19,1.0,20,0.05
133322231,4,6,4.0,10,0.4
133326304,2,6,2.0,8,0.25
133326455,8,1,1.0,9,0.1111111111111111
133327513,2,6,2.0,8,0.25
133333436,3,7,3.0,10,0.3
133336247,1,9,1.0,10,0.1
133336347,5,3,3.0,8,0.375
133337284,3,7,3.0,10,0.3
133341781,2,8,2.0,10,0.2
133345189,2,6,2.0,8,0.25
133347122,1,19,1.0,20,0.05
133350506,5,4,4.0,9,0.4444444444444444
133359998,1,9,1.0,10,0.1
133363316,26,2,2.0,28,0.07142857142857142
133375819,1,9,1.0,10,0.1
133382851,1,7,1.0,8,0.125
133392499,3,7,3.0,10,0.3
133394150,2,8,2.0,10,0.2
133399526,2,16,2.0,18,0.1111111111111111
133417754,5,4,4.0,9,0.4444444444444444
133445328,1,18,1.0,19,0.05263157894736842
133454375,1,19,1.0,20,0.05
133497231,4,14,4.0,18,0.2222222222222222
133497467,5,5,5.0,10,0.5
133509493,1,9,1.0,10,0.1
133519943,3,7,3.0,10,0.3
133523858,3,7,3.0,10,0.3
133526309,4,5,4.0,9,0.4444444444444444
133526468,1,9,1.0,10,0.1
133571707,9,8,8.0,17,0.47058823529411764
133577439,9,1,1.0,10,0.1
133579139,25,3,3.0,28,0.10714285714285714
133587010,1,9,1.0,10,0.1
133592341,4,15,4.0,19,0.21052631578947367
133605337,4,6,4.0,10,0.4
133624137,7,1,1.0,8,0.125
133637021,1,9,1.0,10,0.1
133637408,6,3,3.0,9,0.3333333333333333
133692928,1,9,1.0,10,0.1
133744587,1,18,1.0,19,0.05263157894736842
133772758,3,7,3.0,10,0.3
133776280,1,9,1.0,10,0.1
133779324,6,4,4.0,10,0.4
133783621,9,1,1.0,10,0.1
133791427,5,4,4.0,9,0.4444444444444444
133794554,4,14,4.0,18,0.2222222222222222
133815831,2,24,2.0,26,0.07692307692307693
133824082,1,8,1.0,9,0.1111111111111111
133824683,2,6,2.0,8,0.25
133826975,1,9,1.0,10,0.1
133839898,2,8,2.0,10,0.2
133852810,7,2,2.0,9,0.2222222222222222
133854226,4,25,4.0,29,0.13793103448275862
133854721,9,1,1.0,10,0.1
133855986,1,18,1.0,19,0.05263157894736842
133862395,2,7,2.0,9,0.2222222222222222
133883730,3,7,3.0,10,0.3
133919093,1,9,1.0,10,0.1
133941968,1,18,1.0,19,0.05263157894736842
133960774,1,8,1.0,9,0.1111111111111111
133973212,3,7,3.0,10,0.3
133981094,1,17,1.0,18,0.05555555555555555
133985037,1,17,1.0,18,0.05555555555555555
133988955,4,16,4.0,20,0.2
133990897,1,8,1.0,9,0.1111111111111111
134000579,1,8,1.0,9,0.1111111111111111
134002230,1,9,1.0,10,0.1
134002393,1,9,1.0,10,0.1
134003345,1,8,1.0,9,0.1111111111111111
134006626,2,7,2.0,9,0.2222222222222222
134007277,1,9,1.0,10,0.1
134026233,2,8,2.0,10,0.2
134032392,1,9,1.0,10,0.1
134044335,1,8,1.0,9,0.1111111111111111
134057832,1,8,1.0,9,0.1111111111111111
134120298,4,6,4.0,10,0.4
134125101,4,23,4.0,27,0.14814814814814814
134127103,1,18,1.0,19,0.05263157894736842
134128234,1,9,1.0,10,0.1
134128442,1,7,1.0,8,0.125
134134471,1,9,1.0,10,0.1
134136897,3,7,3.0,10,0.3
134137275,1,9,1.0,10,0.1
134138866,8,2,2.0,10,0.2
134150429,6,2,2.0,8,0.25
134161596,3,16,3.0,19,0.15789473684210525
134172067,1,9,1.0,10,0.1
134186146,1,18,1.0,19,0.05263157894736842
134206000,1,7,1.0,8,0.125
134212400,2,18,2.0,20,0.1
134229962,5,5,5.0,10,0.5
134230426,2,8,2.0,10,0.2
134270071,1,8,1.0,9,0.1111111111111111
134270915,2,8,2.0,10,0.2
134287513,2,8,2.0,10,0.2
134289666,1,8,1.0,9,0.1111111111111111
134296678,4,24,4.0,28,0.14285714285714285
134298271,1,17,1.0,18,0.05555555555555555
134316744,9,19,9.0,28,0.32142857142857145
134317526,6,3,3.0,9,0.3333333333333333
134323848,5,5,5.0,10,0.5
134324114,1,8,1.0,9,0.1111111111111111
134375365,1,7,1.0,8,0.125
134396514,3,6,3.0,9,0.3333333333333333
134408279,9,1,1.0,10,0.1
134447219,7,1,1.0,8,0.125
134455800,1,9,1.0,10,0.1
134460276,22,8,8.0,30,0.26666666666666666
134499872,3,15,3.0,18,0.16666666666666666
134530000,6,4,4.0,10,0.4
134550524,1,9,1.0,10,0.1
134561077,4,6,4.0,10,0.4
134579113,4,5,4.0,9,0.4444444444444444
134588706,1,9,1.0,10,0.1
134599215,5,5,5.0,10,0.5
134612242,4,6,4.0,10,0.4
134632249,1,9,1.0,10,0.1
134636879,8,12,8.0,20,0.4
134638929,3,24,3.0,27,0.1111111111111111
134673697,2,7,2.0,9,0.2222222222222222
134712801,1,17,1.0,18,0.05555555555555555
134713984,6,3,3.0,9,0.3333333333333333
134731294,6,3,3.0,9,0.3333333333333333
134732940,8,1,1.0,9,0.1111111111111111
134739488,3,13,3.0,16,0.1875
134752863,1,19,1.0,20,0.05
134757926,1,9,1.0,10,0.1
134787491,5,23,5.0,28,0.17857142857142858
134799461,1,9,1.0,10,0.1
134893630,1,27,1.0,28,0.03571428571428571
134911741,1,9,1.0,10,0.1
134914875,1,19,1.0,20,0.05
134923028,8,1,1.0,9,0.1111111111111111
134929864,2,6,2.0,8,0.25
134945133,1,16,1.0,17,0.058823529411764705
134953956,2,6,2.0,8,0.25
134954789,1,9,1.0,10,0.1
134982309,7,3,3.0,10,0.3
134982761,8,1,1.0,9,0.1111111111111111
134983905,8,1,1.0,9,0.1111111111111111
134991573,1,8,1.0,9,0.1111111111111111
134996235,2,8,2.0,10,0.2
135000199,7,3,3.0,10,0.3
135021639,2,8,2.0,10,0.2
135025619,2,8,2.0,10,0.2
135038391,9,1,1.0,10,0.1
135050228,6,4,4.0,10,0.4
135051313,3,7,3.0,10,0.3
135053063,1,18,1.0,19,0.05263157894736842
135062089,4,6,4.0,10,0.4
135090175,5,4,4.0,9,0.4444444444444444
135147935,3,6,3.0,9,0.3333333333333333
135149543,1,9,1.0,10,0.1
135150371,1,8,1.0,9,0.1111111111111111
135158189,1,8,1.0,9,0.1111111111111111
135159424,1,8,1.0,9,0.1111111111111111
135160848,3,7,3.0,10,0.3
135160986,1,8,1.0,9,0.1111111111111111
135162777,2,7,2.0,9,0.2222222222222222
135194450,12,8,8.0,20,0.4
135195187,1,8,1.0,9,0.1111111111111111
135195833,2,8,2.0,10,0.2
135197117,4,20,4.0,24,0.16666666666666666
135206225,6,4,4.0,10,0.4
135209696,26,3,3.0,29,0.10344827586206896
135218044,5,5,5.0,10,0.5
135228243,3,7,3.0,10,0.3
135229796,2,7,2.0,9,0.2222222222222222
135241002,7,18,7.0,25,0.28
135243736,2,7,2.0,9,0.2222222222222222
135245102,7,13,7.0,20,0.35
135279812,4,6,4.0,10,0.4
135281180,1,9,1.0,10,0.1
135307807,2,7,2.0,9,0.2222222222222222
135334228,4,5,4.0,9,0.4444444444444444
135366244,5,13,5.0,18,0.2777777777777778
135366842,6,2,2.0,8,0.25
135367358,3,7,3.0,10,0.3
135378436,2,7,2.0,9,0.2222222222222222
135379025,1,9,1.0,10,0.1
135381524,1,8,1.0,9,0.1111111111111111
135405795,4,6,4.0,10,0.4
135414609,3,17,3.0,20,0.15
135415337,2,8,2.0,10,0.2
135426233,4,5,4.0,9,0.4444444444444444
135439523,2,8,2.0,10,0.2
135442518,2,7,2.0,9,0.2222222222222222
135444747,3,7,3.0,10,0.3
135448520,6,4,4.0,10,0.4
135454691,4,6,4.0,10,0.4
135459285,5,4,4.0,9,0.4444444444444444
135466630,1,8,1.0,9,0.1111111111111111
135467210,2,7,2.0,9,0.2222222222222222
135474807,5,5,5.0,10,0.5
135477629,3,7,3.0,10,0.3
135489237,1,9,1.0,10,0.1
135490299,1,9,1.0,10,0.1
135493511,1,9,1.0,10,0.1
135497207,4,5,4.0,9,0.4444444444444444
135501154,5,4,4.0,9,0.4444444444444444
135507470,1,9,1.0,10,0.1
135516514,1,27,1.0,28,0.03571428571428571
135516929,1,9,1.0,10,0.1
135520579,2,7,2.0,9,0.2222222222222222
135542740,2,18,2.0,20,0.1
135543095,1,8,1.0,9,0.1111111111111111
135619723,2,8,2.0,10,0.2
135645748,6,13,6.0,19,0.3157894736842105
135646733,8,2,2.0,10,0.2
135659768,1,27,1.0,28,0.03571428571428571
135664892,2,6,2.0,8,0.25
135673744,1,9,1.0,10,0.1
135683305,1,18,1.0,19,0.05263157894736842
135726716,1,7,1.0,8,0.125
135736909,1,15,1.0,16,0.0625
135764989,5,5,5.0,10,0.5
135773561,1,9,1.0,10,0.1
135774315,6,2,2.0,8,0.25
135774766,1,9,1.0,10,0.1
135789022,1,9,1.0,10,0.1
135796134,3,7,3.0,10,0.3
135801327,7,2,2.0,9,0.2222222222222222
135803695,7,2,2.0,9,0.2222222222222222
135804481,9,1,1.0,10,0.1
135843444,1,8,1.0,9,0.1111111111111111
135849657,3,17,3.0,20,0.15
135867034,1,8,1.0,9,0.1111111111111111
135867658,5,5,5.0,10,0.5
135867968,16,12,12.0,28,0.42857142857142855
135868124,5,4,4.0,9,0.4444444444444444
135868284,6,3,3.0,9,0.3333333333333333
135868528,7,3,3.0,10,0.3
135881147,1,8,1.0,9,0.1111111111111111
135906790,2,28,2.0,30,0.06666666666666667
135910189,3,7,3.0,10,0.3
135915938,1,8,1.0,9,0.1111111111111111
135917388,1,9,1.0,10,0.1
135926395,4,6,4.0,10,0.4
135937981,4,25,4.0,29,0.13793103448275862
135948555,4,5,4.0,9,0.4444444444444444
135949078,2,8,2.0,10,0.2
135949626,6,4,4.0,10,0.4
135950783,1,8,1.0,9,0.1111111111111111
135963901,8,2,2.0,10,0.2
135995363,4,16,4.0,20,0.2
136007340,1,9,1.0,10,0.1
136013180,1,8,1.0,9,0.1111111111111111
136033780,1,9,1.0,10,0.1
136037477,8,2,2.0,10,0.2
136037577,6,4,4.0,10,0.4
136039913,6,4,4.0,10,0.4
136039943,8,2,2.0,10,0.2
136042558,1,18,1.0,19,0.05263157894736842
136048783,5,5,5.0,10,0.5
136054655,1,8,1.0,9,0.1111111111111111
136056217,5,4,4.0,9,0.4444444444444444
136056566,2,8,2.0,10,0.2
136068612,3,15,3.0,18,0.16666666666666666
136092114,2,6,2.0,8,0.25
136152411,2,17,2.0,19,0.10526315789473684
136174454,1,8,1.0,9,0.1111111111111111
136180909,1,9,1.0,10,0.1
136213598,4,6,4.0,10,0.4
136215121,1,18,1.0,19,0.05263157894736842
136257238,8,21,8.0,29,0.27586206896551724
136303015,2,8,2.0,10,0.2
136315947,1,9,1.0,10,0.1
136322138,1,8,1.0,9,0.1111111111111111
136322435,1,9,1.0,10,0.1
136326451,2,8,2.0,10,0.2
136387822,6,2,2.0,8,0.25
136449468,1,18,1.0,19,0.05263157894736842
136477176,4,5,4.0,9,0.4444444444444444
136486886,2,15,2.0,17,0.11764705882352941
136535814,2,17,2.0,19,0.10526315789473684
136555100,9,1,1.0,10,0.1
136590175,1,9,1.0,10,0.1
136612802,2,7,2.0,9,0.2222222222222222
136613480,9,1,1.0,10,0.1
136623564,1,9,1.0,10,0.1
136625350,26,1,1.0,27,0.037037037037037035
136649283,1,8,1.0,9,0.1111111111111111
136702520,1,9,1.0,10,0.1
136704565,1,18,1.0,19,0.05263157894736842
136724909,2,8,2.0,10,0.2
136732741,2,15,2.0,17,0.11764705882352941
136749720,2,17,2.0,19,0.10526315789473684
136751146,2,8,2.0,10,0.2
136800942,4,5,4.0,9,0.4444444444444444
136813472,1,25,1.0,26,0.038461538461538464
136837165,3,7,3.0,10,0.3
136847770,1,8,1.0,9,0.1111111111111111
136848560,3,7,3.0,10,0.3
136870732,2,6,2.0,8,0.25
136880074,3,7,3.0,10,0.3
136896098,3,7,3.0,10,0.3
136906246,9,1,1.0,10,0.1
136907063,7,2,2.0,9,0.2222222222222222
136917730,2,7,2.0,9,0.2222222222222222
136925433,1,8,1.0,9,0.1111111111111111
136960228,2,8,2.0,10,0.2
136961637,2,8,2.0,10,0.2
136976574,1,9,1.0,10,0.1
136977375,3,7,3.0,10,0.3
136977510,3,7,3.0,10,0.3
136979686,7,1,1.0,8,0.125
136981937,11,15,11.0,26,0.4230769230769231
137035579,1,8,1.0,9,0.1111111111111111
137039831,8,2,2.0,10,0.2
137043429,2,8,2.0,10,0.2
137050493,5,5,5.0,10,0.5
137050566,1,24,1.0,25,0.04
137054328,1,18,1.0,19,0.05263157894736842
137088400,3,6,3.0,9,0.3333333333333333
137149492,2,8,2.0,10,0.2
137170254,1,9,1.0,10,0.1
137183882,7,2,2.0,9,0.2222222222222222
137188383,1,18,1.0,19,0.05263157894736842
137203506,1,8,1.0,9,0.1111111111111111
137206324,1,9,1.0,10,0.1
137207632,1,9,1.0,10,0.1
137208245,2,8,2.0,10,0.2
137252815,1,8,1.0,9,0.1111111111111111
137257152,1,9,1.0,10,0.1
137262575,3,7,3.0,10,0.3
137326424,1,8,1.0,9,0.1111111111111111
137339106,1,17,1.0,18,0.05555555555555555
137345809,4,6,4.0,10,0.4
137349948,1,9,1.0,10,0.1
137353018,3,7,3.0,10,0.3
137353638,4,6,4.0,10,0.4
137356118,1,9,1.0,10,0.1
137358458,4,5,4.0,9,0.4444444444444444
137362799,8,2,2.0,10,0.2
137369243,18,1,1.0,19,0.05263157894736842
137410713,3,25,3.0,28,0.10714285714285714
137418665,1,9,1.0,10,0.1
137419436,2,8,2.0,10,0.2
137424044,3,7,3.0,10,0.3
137436539,18,1,1.0,19,0.05263157894736842
137463774,1,9,1.0,10,0.1
137469145,5,5,5.0,10,0.5
137477377,1,17,1.0,18,0.05555555555555555
137484174,2,8,2.0,10,0.2
137485980,5,3,3.0,8,0.375
137486897,1,8,1.0,9,0.1111111111111111
137487195,2,7,2.0,9,0.2222222222222222
137499510,8,2,2.0,10,0.2
137566947,1,9,1.0,10,0.1
137571555,1,8,1.0,9,0.1111111111111111
137597329,1,7,1.0,8,0.125
137607381,1,27,1.0,28,0.03571428571428571
137610291,2,7,2.0,9,0.2222222222222222
137612733,2,8,2.0,10,0.2
137613562,2,27,2.0,29,0.06896551724137931
137613587,2,26,2.0,28,0.07142857142857142
137627908,7,2,2.0,9,0.2222222222222222
137634044,1,19,1.0,20,0.05
137653345,5,5,5.0,10,0.5
137655408,1,9,1.0,10,0.1
137685430,1,16,1.0,17,0.058823529411764705
137692800,1,8,1.0,9,0.1111111111111111
137716049,1,9,1.0,10,0.1
137728955,3,7,3.0,10,0.3
137749086,2,8,2.0,10,0.2
137764553,4,4,4.0,8,0.5
137766459,9,1,1.0,10,0.1
137777789,1,9,1.0,10,0.1
137778017,1,9,1.0,10,0.1
137780583,1,8,1.0,9,0.1111111111111111
137790199,3,7,3.0,10,0.3
137804994,1,18,1.0,19,0.05263157894736842
137821779,9,1,1.0,10,0.1
137841179,1,9,1.0,10,0.1
137871545,1,9,1.0,10,0.1
137892698,2,8,2.0,10,0.2
137892933,2,18,2.0,20,0.1
137896220,2,8,2.0,10,0.2
137923296,1,8,1.0,9,0.1111111111111111
137929805,1,9,1.0,10,0.1
137931502,6,4,4.0,10,0.4
137981666,2,6,2.0,8,0.25
138004072,1,8,1.0,9,0.1111111111111111
138014041,2,16,2.0,18,0.1111111111111111
138046708,4,6,4.0,10,0.4
138056955,6,4,4.0,10,0.4
138065917,9,1,1.0,10,0.1
138125146,1,9,1.0,10,0.1
138133247,1,9,1.0,10,0.1
138143870,1,8,1.0,9,0.1111111111111111
138145638,3,24,3.0,27,0.1111111111111111
138153816,3,7,3.0,10,0.3
138159301,10,19,10.0,29,0.3448275862068966
138159673,6,4,4.0,10,0.4
138161073,2,8,2.0,10,0.2
138163062,4,6,4.0,10,0.4
138163921,7,21,7.0,28,0.25
138174235,2,17,2.0,19,0.10526315789473684
138182365,12,16,12.0,28,0.42857142857142855
138231441,3,17,3.0,20,0.15
138232680,1,9,1.0,10,0.1
138233609,6,4,4.0,10,0.4
138236803,2,8,2.0,10,0.2
138243313,1,7,1.0,8,0.125
138247372,7,3,3.0,10,0.3
138261754,1,9,1.0,10,0.1
138261909,1,9,1.0,10,0.1
138264943,3,14,3.0,17,0.17647058823529413
138267100,1,18,1.0,19,0.05263157894736842
138270153,1,9,1.0,10,0.1
138274632,6,3,3.0,9,0.3333333333333333
138353086,1,8,1.0,9,0.1111111111111111
138388728,2,8,2.0,10,0.2
138388780,1,8,1.0,9,0.1111111111111111
138398552,1,9,1.0,10,0.1
138399176,4,12,4.0,16,0.25
138406035,2,8,2.0,10,0.2
138410062,3,7,3.0,10,0.3
138443503,1,8,1.0,9,0.1111111111111111
138448278,2,28,2.0,30,0.06666666666666667
138485458,8,1,1.0,9,0.1111111111111111
138491057,1,9,1.0,10,0.1
138523698,1,9,1.0,10,0.1
138532531,2,8,2.0,10,0.2
138532758,2,8,2.0,10,0.2
138543432,1,19,1.0,20,0.05
138573306,3,16,3.0,19,0.15789473684210525
138576390,1,9,1.0,10,0.1
138580618,2,7,2.0,9,0.2222222222222222
138585906,1,17,1.0,18,0.05555555555555555
138616498,1,9,1.0,10,0.1
138693388,1,9,1.0,10,0.1
138695274,1,7,1.0,8,0.125
138697284,1,9,1.0,10,0.1
138699144,8,2,2.0,10,0.2
138711004,1,7,1.0,8,0.125
138731411,4,5,4.0,9,0.4444444444444444
138761888,12,17,12.0,29,0.41379310344827586
138776791,1,8,1.0,9,0.1111111111111111
138796981,1,19,1.0,20,0.05
138799406,10,10,10.0,20,0.5
138810829,5,5,5.0,10,0.5
138821790,1,9,1.0,10,0.1
138833643,4,5,4.0,9,0.4444444444444444
138838973,3,6,3.0,9,0.3333333333333333
138865843,7,2,2.0,9,0.2222222222222222
138875002,1,18,1.0,19,0.05263157894736842
138899157,5,5,5.0,10,0.5
138910363,1,8,1.0,9,0.1111111111111111
138920692,3,17,3.0,20,0.15
138946440,16,2,2.0,18,0.1111111111111111
138963195,2,7,2.0,9,0.2222222222222222
138963245,3,5,3.0,8,0.375
138977329,1,9,1.0,10,0.1
138977667,13,14,13.0,27,0.48148148148148145
138980344,5,5,5.0,10,0.5
138992599,5,21,5.0,26,0.19230769230769232
138994689,6,4,4.0,10,0.4
139032471,4,6,4.0,10,0.4
139035804,1,9,1.0,10,0.1
139041048,20,5,5.0,25,0.2
139041712,1,9,1.0,10,0.1
139046368,1,7,1.0,8,0.125
139068274,7,3,3.0,10,0.3
139069854,7,22,7.0,29,0.2413793103448276
139072231,2,7,2.0,9,0.2222222222222222
139073095,2,7,2.0,9,0.2222222222222222
139073599,3,7,3.0,10,0.3
139075691,1,9,1.0,10,0.1
139078864,2,8,2.0,10,0.2
139083408,1,8,1.0,9,0.1111111111111111
139087095,5,5,5.0,10,0.5
139088805,9,9,9.0,18,0.5
139118060,5,4,4.0,9,0.4444444444444444
139123752,8,1,1.0,9,0.1111111111111111
139129209,18,11,11.0,29,0.3793103448275862
139130496,1,9,1.0,10,0.1
139130669,1,7,1.0,8,0.125
139134364,1,9,1.0,10,0.1
139148834,1,9,1.0,10,0.1
139156310,2,8,2.0,10,0.2
139158216,1,9,1.0,10,0.1
139162417,1,9,1.0,10,0.1
139166962,3,7,3.0,10,0.3
139198597,7,3,3.0,10,0.3
139199827,9,1,1.0,10,0.1
139203979,1,8,1.0,9,0.1111111111111111
139206712,9,19,9.0,28,0.32142857142857145
139215778,1,9,1.0,10,0.1
139217434,1,18,1.0,19,0.05263157894736842
139224760,5,5,5.0,10,0.5
139229019,1,9,1.0,10,0.1
139235216,7,13,7.0,20,0.35
139248488,3,25,3.0,28,0.10714285714285714
139249255,7,1,1.0,8,0.125
139254749,2,8,2.0,10,0.2
139254916,1,28,1.0,29,0.034482758620689655
139256664,1,9,1.0,10,0.1
139256791,9,1,1.0,10,0.1
139266813,1,18,1.0,19,0.05263157894736842
139271453,1,28,1.0,29,0.034482758620689655
139283830,4,5,4.0,9,0.4444444444444444
139297926,4,6,4.0,10,0.4
139300491,9,1,1.0,10,0.1
139306765,1,9,1.0,10,0.1
139314341,9,1,1.0,10,0.1
139317206,1,8,1.0,9,0.1111111111111111
139353673,5,5,5.0,10,0.5
139358747,8,2,2.0,10,0.2
139358966,1,17,1.0,18,0.05555555555555555
139359379,2,7,2.0,9,0.2222222222222222
139360529,4,6,4.0,10,0.4
139371471,1,9,1.0,10,0.1
139387410,1,9,1.0,10,0.1
139407788,1,9,1.0,10,0.1
139417141,1,19,1.0,20,0.05
139425824,1,8,1.0,9,0.1111111111111111
139451217,2,7,2.0,9,0.2222222222222222
139475820,4,6,4.0,10,0.4
139476629,1,14,1.0,15,0.06666666666666667
139483128,3,6,3.0,9,0.3333333333333333
139493730,2,8,2.0,10,0.2
139494171,2,17,2.0,19,0.10526315789473684
139494663,4,6,4.0,10,0.4
139494752,2,8,2.0,10,0.2
139500144,1,9,1.0,10,0.1
139502899,7,1,1.0,8,0.125
139509672,5,5,5.0,10,0.5
139545772,1,9,1.0,10,0.1
139577578,9,1,1.0,10,0.1
139577654,1,18,1.0,19,0.05263157894736842
139585447,1,17,1.0,18,0.05555555555555555
139593311,2,8,2.0,10,0.2
139602680,3,16,3.0,19,0.15789473684210525
139607510,1,9,1.0,10,0.1
139670822,6,4,4.0,10,0.4
139702852,8,11,8.0,19,0.42105263157894735
139704520,2,17,2.0,19,0.10526315789473684
139707468,5,5,5.0,10,0.5
139709085,4,5,4.0,9,0.4444444444444444
139710948,3,7,3.0,10,0.3
139714487,2,7,2.0,9,0.2222222222222222
139719312,1,18,1.0,19,0.05263157894736842
139722305,3,7,3.0,10,0.3
139724872,4,5,4.0,9,0.4444444444444444
139725933,1,9,1.0,10,0.1
139731160,1,9,1.0,10,0.1
139734765,3,7,3.0,10,0.3
139749181,1,8,1.0,9,0.1111111111111111
139752066,1,8,1.0,9,0.1111111111111111
139760693,3,7,3.0,10,0.3
139762574,2,8,2.0,10,0.2
139763229,1,9,1.0,10,0.1
139764345,1,9,1.0,10,0.1
139764870,1,28,1.0,29,0.034482758620689655
139776594,1,9,1.0,10,0.1
139778595,2,7,2.0,9,0.2222222222222222
139787164,6,12,6.0,18,0.3333333333333333
139792444,2,15,2.0,17,0.11764705882352941
139792979,1,9,1.0,10,0.1
139799099,1,9,1.0,10,0.1
139805180,2,7,2.0,9,0.2222222222222222
139806885,3,7,3.0,10,0.3
139807559,6,4,4.0,10,0.4
139809246,1,9,1.0,10,0.1
139811352,4,6,4.0,10,0.4
139811649,4,6,4.0,10,0.4
139812360,5,3,3.0,8,0.375
139812672,4,5,4.0,9,0.4444444444444444
139813988,1,9,1.0,10,0.1
139814139,4,6,4.0,10,0.4
139817968,3,7,3.0,10,0.3
139818243,9,10,9.0,19,0.47368421052631576
139823498,7,13,7.0,20,0.35
139830234,2,17,2.0,19,0.10526315789473684
139841674,15,12,12.0,27,0.4444444444444444
139842746,2,8,2.0,10,0.2
139843052,1,8,1.0,9,0.1111111111111111
139845122,1,9,1.0,10,0.1
139881985,1,9,1.0,10,0.1
139882504,1,29,1.0,30,0.03333333333333333
139889364,1,18,1.0,19,0.05263157894736842
139916768,1,9,1.0,10,0.1
139924824,9,19,9.0,28,0.32142857142857145
139977809,2,18,2.0,20,0.1
139992589,1,8,1.0,9,0.1111111111111111
139994000,1,17,1.0,18,0.05555555555555555
140034281,18,11,11.0,29,0.3793103448275862
140036997,5,5,5.0,10,0.5
140037611,2,8,2.0,10,0.2
140049673,2,7,2.0,9,0.2222222222222222
140056348,1,8,1.0,9,0.1111111111111111
140063751,2,8,2.0,10,0.2
140064258,4,5,4.0,9,0.4444444444444444
140071418,2,7,2.0,9,0.2222222222222222
140073297,3,6,3.0,9,0.3333333333333333
140094364,3,6,3.0,9,0.3333333333333333
140095066,5,4,4.0,9,0.4444444444444444
140126313,1,8,1.0,9,0.1111111111111111
140135743,3,7,3.0,10,0.3
140142687,1,9,1.0,10,0.1
140171794,1,8,1.0,9,0.1111111111111111
140190860,1,9,1.0,10,0.1
140191920,3,17,3.0,20,0.15
140191927,1,7,1.0,8,0.125
140192521,3,7,3.0,10,0.3
140193955,2,16,2.0,18,0.1111111111111111
140194718,8,2,2.0,10,0.2
140194851,7,13,7.0,20,0.35
140199432,1,8,1.0,9,0.1111111111111111
140221602,5,5,5.0,10,0.5
140229084,2,8,2.0,10,0.2
140237096,1,8,1.0,9,0.1111111111111111
140295582,9,1,1.0,10,0.1
140295894,6,4,4.0,10,0.4
140310082,2,18,2.0,20,0.1
140337956,1,8,1.0,9,0.1111111111111111
140345303,3,17,3.0,20,0.15
140357442,2,16,2.0,18,0.1111111111111111
140361368,1,9,1.0,10,0.1
140367600,1,9,1.0,10,0.1
140383293,3,6,3.0,9,0.3333333333333333
140385226,8,1,1.0,9,0.1111111111111111
140387915,4,16,4.0,20,0.2
140399458,6,13,6.0,19,0.3157894736842105
140406367,1,9,1.0,10,0.1
140409509,7,23,7.0,30,0.23333333333333334
140423675,1,18,1.0,19,0.05263157894736842
140423821,3,6,3.0,9,0.3333333333333333
140428800,13,7,7.0,20,0.35
140442980,2,18,2.0,20,0.1
140456220,5,4,4.0,9,0.4444444444444444
140464167,2,17,2.0,19,0.10526315789473684
140522922,1,18,1.0,19,0.05263157894736842
140537660,9,1,1.0,10,0.1
140541923,3,7,3.0,10,0.3
140552519,3,6,3.0,9,0.3333333333333333
140560425,1,18,1.0,19,0.05263157894736842
140560487,1,19,1.0,20,0.05
140566482,1,9,1.0,10,0.1
140570436,1,8,1.0,9,0.1111111111111111
140582133,1,19,1.0,20,0.05
140584124,1,17,1.0,18,0.05555555555555555
140612611,2,7,2.0,9,0.2222222222222222
140616091,3,16,3.0,19,0.15789473684210525
140624344,1,9,1.0,10,0.1
140630216,24,5,5.0,29,0.1724137931034483
140634519,1,9,1.0,10,0.1
140641911,4,5,4.0,9,0.4444444444444444
140671491,3,6,3.0,9,0.3333333333333333
140685288,1,8,1.0,9,0.1111111111111111
140687706,2,7,2.0,9,0.2222222222222222
140774684,3,7,3.0,10,0.3
140775284,1,7,1.0,8,0.125
140782460,5,3,3.0,8,0.375
140783249,1,9,1.0,10,0.1
140819347,1,8,1.0,9,0.1111111111111111
140819757,2,27,2.0,29,0.06896551724137931
140824723,3,6,3.0,9,0.3333333333333333
140825399,7,21,7.0,28,0.25
140825942,1,9,1.0,10,0.1
140828446,4,6,4.0,10,0.4
140828745,3,7,3.0,10,0.3
140829309,6,3,3.0,9,0.3333333333333333
140830890,1,8,1.0,9,0.1111111111111111
140834330,1,17,1.0,18,0.05555555555555555
140834926,3,7,3.0,10,0.3
140840211,1,15,1.0,16,0.0625
140851249,6,4,4.0,10,0.4
140859357,1,9,1.0,10,0.1
140859849,2,16,2.0,18,0.1111111111111111
140860277,2,8,2.0,10,0.2
140868669,3,6,3.0,9,0.3333333333333333
140878385,7,3,3.0,10,0.3
140890862,1,9,1.0,10,0.1
140891530,2,7,2.0,9,0.2222222222222222
140905290,1,9,1.0,10,0.1
140908742,1,9,1.0,10,0.1
140910478,1,9,1.0,10,0.1
140927055,7,3,3.0,10,0.3
140970595,11,18,11.0,29,0.3793103448275862
140971053,5,5,5.0,10,0.5
141012514,1,8,1.0,9,0.1111111111111111
141018304,2,18,2.0,20,0.1
141037648,4,5,4.0,9,0.4444444444444444
141060016,1,18,1.0,19,0.05263157894736842
141065395,1,18,1.0,19,0.05263157894736842
141068501,1,9,1.0,10,0.1
141085701,7,1,1.0,8,0.125
141115583,6,3,3.0,9,0.3333333333333333
141123781,1,19,1.0,20,0.05
141123871,1,19,1.0,20,0.05
141124740,4,5,4.0,9,0.4444444444444444
141138644,1,28,1.0,29,0.034482758620689655
141147885,9,1,1.0,10,0.1
141155559,4,6,4.0,10,0.4
141165546,1,18,1.0,19,0.05263157894736842
141168298,1,18,1.0,19,0.05263157894736842
141168732,1,9,1.0,10,0.1
141176261,1,9,1.0,10,0.1
141185890,1,18,1.0,19,0.05263157894736842
141211298,1,19,1.0,20,0.05
141216343,4,6,4.0,10,0.4
141216875,1,9,1.0,10,0.1
141247951,1,18,1.0,19,0.05263157894736842
141265906,27,2,2.0,29,0.06896551724137931
141282745,1,7,1.0,8,0.125
141308494,1,8,1.0,9,0.1111111111111111
141314308,1,9,1.0,10,0.1
141321214,15,14,14.0,29,0.4827586206896552
141356296,1,8,1.0,9,0.1111111111111111
141357300,2,8,2.0,10,0.2
141358168,1,8,1.0,9,0.1111111111111111
141358850,1,9,1.0,10,0.1
141361598,4,5,4.0,9,0.4444444444444444
141371829,3,7,3.0,10,0.3
141374565,2,7,2.0,9,0.2222222222222222
141395220,1,9,1.0,10,0.1
141412893,1,19,1.0,20,0.05
141417357,16,2,2.0,18,0.1111111111111111
141431820,4,4,4.0,8,0.5
141432917,1,9,1.0,10,0.1
141434468,2,7,2.0,9,0.2222222222222222
141434556,2,8,2.0,10,0.2
141438240,6,13,6.0,19,0.3157894736842105
141455628,3,7,3.0,10,0.3
141457127,12,6,6.0,18,0.3333333333333333
141468556,8,1,1.0,9,0.1111111111111111
141478900,2,17,2.0,19,0.10526315789473684
141501887,1,9,1.0,10,0.1
141506947,4,6,4.0,10,0.4
141507066,1,25,1.0,26,0.038461538461538464
141510547,4,15,4.0,19,0.21052631578947367
141519093,9,10,9.0,19,0.47368421052631576
141526518,4,25,4.0,29,0.13793103448275862
141576857,1,9,1.0,10,0.1
141587232,9,21,9.0,30,0.3
141593838,7,3,3.0,10,0.3
141630689,2,7,2.0,9,0.2222222222222222
141642328,5,5,5.0,10,0.5
141651774,1,8,1.0,9,0.1111111111111111
141652140,1,8,1.0,9,0.1111111111111111
141655994,1,8,1.0,9,0.1111111111111111
141660444,1,8,1.0,9,0.1111111111111111
141669833,1,19,1.0,20,0.05
141701404,2,7,2.0,9,0.2222222222222222
141712092,3,7,3.0,10,0.3
141722185,1,9,1.0,10,0.1
141724800,8,1,1.0,9,0.1111111111111111
141728497,1,9,1.0,10,0.1
141728550,7,18,7.0,25,0.28
141736378,1,18,1.0,19,0.05263157894736842
141766310,1,9,1.0,10,0.1
141767346,1,8,1.0,9,0.1111111111111111
141767571,1,9,1.0,10,0.1
141797652,1,9,1.0,10,0.1
141827150,1,8,1.0,9,0.1111111111111111
141871805,2,18,2.0,20,0.1
141905284,1,9,1.0,10,0.1
141920556,1,18,1.0,19,0.05263157894736842
141961529,1,19,1.0,20,0.05
141970856,1,8,1.0,9,0.1111111111111111
141977427,7,2,2.0,9,0.2222222222222222
141977650,8,2,2.0,10,0.2
141981573,8,1,1.0,9,0.1111111111111111
141982942,1,9,1.0,10,0.1
141990022,3,7,3.0,10,0.3
141990416,1,19,1.0,20,0.05
142012585,3,7,3.0,10,0.3
142028034,3,5,3.0,8,0.375
142031029,3,7,3.0,10,0.3
142056115,2,17,2.0,19,0.10526315789473684
142059264,2,8,2.0,10,0.2
142074348,1,9,1.0,10,0.1
142080391,1,19,1.0,20,0.05
142086020,3,7,3.0,10,0.3
142093971,2,8,2.0,10,0.2
142094165,1,9,1.0,10,0.1
142127978,22,7,7.0,29,0.2413793103448276
142141377,1,8,1.0,9,0.1111111111111111
142162959,3,6,3.0,9,0.3333333333333333
142170751,1,9,1.0,10,0.1
142194577,9,1,1.0,10,0.1
142274586,1,19,1.0,20,0.05
142279465,3,6,3.0,9,0.3333333333333333
142344481,22,7,7.0,29,0.2413793103448276
142344853,8,1,1.0,9,0.1111111111111111
142351865,2,8,2.0,10,0.2
142390327,2,18,2.0,20,0.1
142424374,3,17,3.0,20,0.15
142429528,5,5,5.0,10,0.5
142454386,4,6,4.0,10,0.4
142529163,1,18,1.0,19,0.05263157894736842
142535324,6,3,3.0,9,0.3333333333333333
142536801,6,23,6.0,29,0.20689655172413793
142541394,4,6,4.0,10,0.4
142542357,3,7,3.0,10,0.3
142548822,1,19,1.0,20,0.05
142567772,5,4,4.0,9,0.4444444444444444
142584987,1,9,1.0,10,0.1
142589583,8,2,2.0,10,0.2
142592256,4,5,4.0,9,0.4444444444444444
142616249,9,1,1.0,10,0.1
142668029,1,7,1.0,8,0.125
142672127,1,9,1.0,10,0.1
142673239,2,8,2.0,10,0.2
142678547,2,8,2.0,10,0.2
142681964,2,8,2.0,10,0.2
142701434,6,4,4.0,10,0.4
142707144,5,4,4.0,9,0.4444444444444444
142707737,2,17,2.0,19,0.10526315789473684
142720456,2,8,2.0,10,0.2
142736191,1,18,1.0,19,0.05263157894736842
142761232,1,8,1.0,9,0.1111111111111111
142761802,2,7,2.0,9,0.2222222222222222
142770350,1,8,1.0,9,0.1111111111111111
142771286,1,9,1.0,10,0.1
142781780,1,9,1.0,10,0.1
142793744,1,9,1.0,10,0.1
142811036,1,9,1.0,10,0.1
142819760,1,17,1.0,18,0.05555555555555555
142843646,1,8,1.0,9,0.1111111111111111
142899345,16,12,12.0,28,0.42857142857142855
142900166,5,5,5.0,10,0.5
142910680,2,8,2.0,10,0.2
142912633,4,6,4.0,10,0.4
142920982,1,17,1.0,18,0.05555555555555555
142924569,2,7,2.0,9,0.2222222222222222
142933629,1,9,1.0,10,0.1
142942442,6,4,4.0,10,0.4
142950231,7,13,7.0,20,0.35
142962061,1,9,1.0,10,0.1
142970007,10,20,10.0,30,0.3333333333333333
142986264,1,9,1.0,10,0.1
142986727,2,17,2.0,19,0.10526315789473684
143001106,1,9,1.0,10,0.1
143032105,1,8,1.0,9,0.1111111111111111
143046679,4,23,4.0,27,0.14814814814814814
143048626,1,18,1.0,19,0.05263157894736842
143082226,1,8,1.0,9,0.1111111111111111
143100294,1,9,1.0,10,0.1
143112045,1,8,1.0,9,0.1111111111111111
143119922,7,3,3.0,10,0.3
143132769,1,9,1.0,10,0.1
143133648,3,7,3.0,10,0.3
143143696,5,5,5.0,10,0.5
143161585,1,9,1.0,10,0.1
143177490,4,5,4.0,9,0.4444444444444444
143177773,1,9,1.0,10,0.1
143184033,3,7,3.0,10,0.3
143184156,5,5,5.0,10,0.5
143198680,1,19,1.0,20,0.05
143228104,7,2,2.0,9,0.2222222222222222
143270364,2,26,2.0,28,0.07142857142857142
143300695,2,8,2.0,10,0.2
143300946,1,16,1.0,17,0.058823529411764705
143305978,1,19,1.0,20,0.05
143307538,5,5,5.0,10,0.5
143324392,1,9,1.0,10,0.1
143326041,4,6,4.0,10,0.4
143331497,9,1,1.0,10,0.1
143332124,1,9,1.0,10,0.1
143332289,1,9,1.0,10,0.1
143333959,2,8,2.0,10,0.2
143336420,1,9,1.0,10,0.1
143339152,1,9,1.0,10,0.1
143340104,1,9,1.0,10,0.1
143340457,1,9,1.0,10,0.1
143341037,2,17,2.0,19,0.10526315789473684
143342720,4,5,4.0,9,0.4444444444444444
143343305,1,9,1.0,10,0.1
143349374,8,1,1.0,9,0.1111111111111111
143350523,1,7,1.0,8,0.125
143355127,7,3,3.0,10,0.3
143356285,1,8,1.0,9,0.1111111111111111
143358970,1,9,1.0,10,0.1
143364825,2,6,2.0,8,0.25
143366521,1,9,1.0,10,0.1
143403078,3,6,3.0,9,0.3333333333333333
143404174,5,4,4.0,9,0.4444444444444444
143412609,2,7,2.0,9,0.2222222222222222
143421930,1,9,1.0,10,0.1
143422516,4,4,4.0,8,0.5
143432185,2,7,2.0,9,0.2222222222222222
143443870,8,9,8.0,17,0.47058823529411764
143444994,1,15,1.0,16,0.0625
143446701,1,18,1.0,19,0.05263157894736842
143461321,1,8,1.0,9,0.1111111111111111
143467955,2,8,2.0,10,0.2
143480091,3,16,3.0,19,0.15789473684210525
143481573,1,18,1.0,19,0.05263157894736842
143484745,3,6,3.0,9,0.3333333333333333
143490194,1,9,1.0,10,0.1
143502941,1,9,1.0,10,0.1
143508274,9,1,1.0,10,0.1
143508894,8,2,2.0,10,0.2
143515803,2,17,2.0,19,0.10526315789473684
143517948,1,9,1.0,10,0.1
143518286,9,1,1.0,10,0.1
143542225,4,6,4.0,10,0.4
143588561,3,7,3.0,10,0.3
143610272,1,8,1.0,9,0.1111111111111111
143636190,2,8,2.0,10,0.2
143638917,2,8,2.0,10,0.2
143647061,1,9,1.0,10,0.1
143656593,1,9,1.0,10,0.1
143662436,1,8,1.0,9,0.1111111111111111
143690936,4,6,4.0,10,0.4
143691378,14,13,13.0,27,0.48148148148148145
143691809,5,4,4.0,9,0.4444444444444444
143692112,5,21,5.0,26,0.19230769230769232
143705511,1,19,1.0,20,0.05
143741829,1,9,1.0,10,0.1
143745933,1,9,1.0,10,0.1
143746630,1,8,1.0,9,0.1111111111111111
143753052,1,15,1.0,16,0.0625
143767994,1,9,1.0,10,0.1
143773358,2,7,2.0,9,0.2222222222222222
143777559,1,9,1.0,10,0.1
143778879,9,1,1.0,10,0.1
143850828,3,7,3.0,10,0.3
143852974,7,2,2.0,9,0.2222222222222222
143916135,1,19,1.0,20,0.05
143916904,3,7,3.0,10,0.3
143922602,2,17,2.0,19,0.10526315789473684
143927519,1,19,1.0,20,0.05
143935453,6,2,2.0,8,0.25
143937557,1,19,1.0,20,0.05
143946436,2,8,2.0,10,0.2
143946991,1,9,1.0,10,0.1
143971542,5,5,5.0,10,0.5
143997692,1,9,1.0,10,0.1
144007578,3,7,3.0,10,0.3
144008334,8,22,8.0,30,0.26666666666666666
144009345,2,8,2.0,10,0.2
144034174,2,6,2.0,8,0.25
144045230,2,7,2.0,9,0.2222222222222222
144079917,2,7,2.0,9,0.2222222222222222
144085680,8,12,8.0,20,0.4
144091174,1,9,1.0,10,0.1
144135536,1,9,1.0,10,0.1
144172688,1,19,1.0,20,0.05
144183809,1,9,1.0,10,0.1
144210726,7,2,2.0,9,0.2222222222222222
144216494,1,9,1.0,10,0.1
144229454,1,9,1.0,10,0.1
144235502,2,8,2.0,10,0.2
144242734,25,1,1.0,26,0.038461538461538464
144245067,2,8,2.0,10,0.2
144265377,1,19,1.0,20,0.05
144304462,6,4,4.0,10,0.4
144312599,1,19,1.0,20,0.05
144319356,5,4,4.0,9,0.4444444444444444
144319696,8,1,1.0,9,0.1111111111111111
144414854,1,18,1.0,19,0.05263157894736842
144427645,1,8,1.0,9,0.1111111111111111
144437116,2,8,2.0,10,0.2
144467672,1,9,1.0,10,0.1
144506984,9,1,1.0,10,0.1
144512835,1,9,1.0,10,0.1
144548364,2,7,2.0,9,0.2222222222222222
144550970,7,2,2.0,9,0.2222222222222222
144562792,2,8,2.0,10,0.2
144564784,1,8,1.0,9,0.1111111111111111
144568840,11,16,11.0,27,0.4074074074074074
144592228,3,6,3.0,9,0.3333333333333333
144603529,4,6,4.0,10,0.4
144620876,1,7,1.0,8,0.125
144651074,1,9,1.0,10,0.1
144654067,4,6,4.0,10,0.4
144655013,1,9,1.0,10,0.1
144655096,1,9,1.0,10,0.1
144656842,4,6,4.0,10,0.4
144694187,1,17,1.0,18,0.05555555555555555
144701872,6,4,4.0,10,0.4
144702624,8,2,2.0,10,0.2
144707579,1,8,1.0,9,0.1111111111111111
144710019,2,7,2.0,9,0.2222222222222222
144711376,1,17,1.0,18,0.05555555555555555
144716329,1,9,1.0,10,0.1
144716711,2,8,2.0,10,0.2
144760078,2,18,2.0,20,0.1
144783677,1,9,1.0,10,0.1
144797260,1,8,1.0,9,0.1111111111111111
144827771,4,6,4.0,10,0.4
144828630,2,16,2.0,18,0.1111111111111111
144847200,1,7,1.0,8,0.125
144848544,3,6,3.0,9,0.3333333333333333
144857974,3,7,3.0,10,0.3
144861347,2,8,2.0,10,0.2
144865604,6,4,4.0,10,0.4
144866388,1,9,1.0,10,0.1
144867052,1,26,1.0,27,0.037037037037037035
144910980,1,17,1.0,18,0.05555555555555555
144912435,2,17,2.0,19,0.10526315789473684
144932140,4,6,4.0,10,0.4
144932558,2,8,2.0,10,0.2
144937395,5,5,5.0,10,0.5
144939961,1,8,1.0,9,0.1111111111111111
144963624,23,5,5.0,28,0.17857142857142858
144970077,1,19,1.0,20,0.05
144975214,3,6,3.0,9,0.3333333333333333
145002864,6,3,3.0,9,0.3333333333333333
145004364,2,8,2.0,10,0.2
145005183,2,8,2.0,10,0.2
145006537,3,7,3.0,10,0.3
145012919,1,7,1.0,8,0.125
145022147,2,8,2.0,10,0.2
145036942,2,7,2.0,9,0.2222222222222222
145044079,1,9,1.0,10,0.1
145045349,8,2,2.0,10,0.2
145070641,5,5,5.0,10,0.5
145081606,1,19,1.0,20,0.05
145109644,1,8,1.0,9,0.1111111111111111
145111048,8,2,2.0,10,0.2
145143262,2,7,2.0,9,0.2222222222222222
145148484,1,16,1.0,17,0.058823529411764705
145188572,9,19,9.0,28,0.32142857142857145
145190696,5,24,5.0,29,0.1724137931034483
145212736,1,9,1.0,10,0.1
145238815,2,7,2.0,9,0.2222222222222222
145239659,4,5,4.0,9,0.4444444444444444
145249177,1,19,1.0,20,0.05
145253113,3,7,3.0,10,0.3
145260725,1,8,1.0,9,0.1111111111111111
145262733,4,6,4.0,10,0.4
145282507,1,8,1.0,9,0.1111111111111111
145283579,2,6,2.0,8,0.25
145295716,5,15,5.0,20,0.25
145299741,2,17,2.0,19,0.10526315789473684
145314661,7,2,2.0,9,0.2222222222222222
145319380,4,5,4.0,9,0.4444444444444444
145350845,1,7,1.0,8,0.125
145352826,2,8,2.0,10,0.2
145354064,3,16,3.0,19,0.15789473684210525
145356413,8,2,2.0,10,0.2
145361017,3,25,3.0,28,0.10714285714285714
145390321,2,8,2.0,10,0.2
145395194,5,4,4.0,9,0.4444444444444444
145395373,4,4,4.0,8,0.5
145404196,2,8,2.0,10,0.2
145404529,3,7,3.0,10,0.3
145405529,3,6,3.0,9,0.3333333333333333
145423039,5,5,5.0,10,0.5
145435902,4,5,4.0,9,0.4444444444444444
145441172,8,1,1.0,9,0.1111111111111111
145466319,2,8,2.0,10,0.2
145469889,1,8,1.0,9,0.1111111111111111
145481969,7,3,3.0,10,0.3
145482214,1,9,1.0,10,0.1
145492206,3,7,3.0,10,0.3
145498557,9,20,9.0,29,0.3103448275862069
145504147,15,15,15.0,30,0.5
145504817,4,6,4.0,10,0.4
145505431,3,7,3.0,10,0.3
145512653,1,9,1.0,10,0.1
145516480,1,27,1.0,28,0.03571428571428571
145525571,1,9,1.0,10,0.1
145540341,1,9,1.0,10,0.1
145548531,1,19,1.0,20,0.05
145568953,3,7,3.0,10,0.3
145581286,7,3,3.0,10,0.3
145600320,8,11,8.0,19,0.42105263157894735
145625312,2,7,2.0,9,0.2222222222222222
145667400,2,8,2.0,10,0.2
145701175,1,8,1.0,9,0.1111111111111111
145708422,1,7,1.0,8,0.125
145716069,4,6,4.0,10,0.4
145730301,2,7,2.0,9,0.2222222222222222
145750559,1,18,1.0,19,0.05263157894736842
145774257,3,5,3.0,8,0.375
145776613,1,19,1.0,20,0.05
145794916,1,9,1.0,10,0.1
145798516,1,17,1.0,18,0.05555555555555555
145820232,2,8,2.0,10,0.2
145862131,3,7,3.0,10,0.3
145873829,1,9,1.0,10,0.1
145890779,3,6,3.0,9,0.3333333333333333
145915720,1,9,1.0,10,0.1
145920594,1,7,1.0,8,0.125
145938778,2,16,2.0,18,0.1111111111111111
146013063,1,8,1.0,9,0.1111111111111111
146013739,6,3,3.0,9,0.3333333333333333
146037135,1,9,1.0,10,0.1
146049604,1,8,1.0,9,0.1111111111111111
146069453,1,19,1.0,20,0.05
146071691,1,9,1.0,10,0.1
146076730,2,7,2.0,9,0.2222222222222222
146081378,1,8,1.0,9,0.1111111111111111
146104787,4,15,4.0,19,0.21052631578947367
146145212,1,18,1.0,19,0.05263157894736842
146151347,5,15,5.0,20,0.25
146166683,3,6,3.0,9,0.3333333333333333
146166776,1,9,1.0,10,0.1
146170876,1,9,1.0,10,0.1
146172311,2,6,2.0,8,0.25
146174759,1,19,1.0,20,0.05
146208009,1,7,1.0,8,0.125
146213256,1,18,1.0,19,0.05263157894736842
146216192,9,1,1.0,10,0.1
146239463,1,18,1.0,19,0.05263157894736842
146248381,1,9,1.0,10,0.1
146250209,1,9,1.0,10,0.1
146251115,4,6,4.0,10,0.4
146252244,2,7,2.0,9,0.2222222222222222
146260991,2,28,2.0,30,0.06666666666666667
146261800,1,7,1.0,8,0.125
146262674,3,7,3.0,10,0.3
146270943,16,3,3.0,19,0.15789473684210525
146375901,20,9,9.0,29,0.3103448275862069
146375906,3,15,3.0,18,0.16666666666666666
146379768,1,9,1.0,10,0.1
146385447,1,9,1.0,10,0.1
146393124,1,8,1.0,9,0.1111111111111111
146401499,8,2,2.0,10,0.2
146409018,1,19,1.0,20,0.05
146413268,1,8,1.0,9,0.1111111111111111
146415330,1,8,1.0,9,0.1111111111111111
146418388,1,8,1.0,9,0.1111111111111111
146442065,1,9,1.0,10,0.1
146459414,1,9,1.0,10,0.1
146464599,2,6,2.0,8,0.25
146488756,8,2,2.0,10,0.2
146530384,2,8,2.0,10,0.2
146542050,3,7,3.0,10,0.3
146559571,1,9,1.0,10,0.1
146559965,1,9,1.0,10,0.1
146575433,1,9,1.0,10,0.1
146590858,2,6,2.0,8,0.25
146591437,1,9,1.0,10,0.1
146594522,8,2,2.0,10,0.2
146615325,28,1,1.0,29,0.034482758620689655
146621488,1,28,1.0,29,0.034482758620689655
146627132,5,5,5.0,10,0.5
146627159,1,9,1.0,10,0.1
146631981,1,9,1.0,10,0.1
146638430,1,19,1.0,20,0.05
146648756,1,8,1.0,9,0.1111111111111111
146651025,24,4,4.0,28,0.14285714285714285
146651293,12,17,12.0,29,0.41379310344827586
146660514,1,9,1.0,10,0.1
146666092,4,26,4.0,30,0.13333333333333333
146666936,1,9,1.0,10,0.1
146672622,2,8,2.0,10,0.2
146673631,1,8,1.0,9,0.1111111111111111
146673983,1,9,1.0,10,0.1
146680320,1,9,1.0,10,0.1
146720564,2,8,2.0,10,0.2
146734181,1,8,1.0,9,0.1111111111111111
146786075,3,6,3.0,9,0.3333333333333333
146789613,5,4,4.0,9,0.4444444444444444
146791823,1,9,1.0,10,0.1
146797390,1,9,1.0,10,0.1
146800286,3,7,3.0,10,0.3
146801042,2,8,2.0,10,0.2
146801541,8,1,1.0,9,0.1111111111111111
146802323,4,6,4.0,10,0.4
146803996,1,8,1.0,9,0.1111111111111111
146811729,2,8,2.0,10,0.2
146822746,1,9,1.0,10,0.1
146824329,1,9,1.0,10,0.1
146830813,1,8,1.0,9,0.1111111111111111
146834895,2,8,2.0,10,0.2
146837808,14,14,14.0,28,0.5
146861988,3,6,3.0,9,0.3333333333333333
146901917,1,19,1.0,20,0.05
146938283,1,9,1.0,10,0.1
146944296,1,9,1.0,10,0.1
146944700,3,7,3.0,10,0.3
146945364,3,7,3.0,10,0.3
146945535,5,5,5.0,10,0.5
147011164,3,6,3.0,9,0.3333333333333333
147017992,2,18,2.0,20,0.1
147034462,2,8,2.0,10,0.2
147037884,7,2,2.0,9,0.2222222222222222
147038511,1,8,1.0,9,0.1111111111111111
147050045,2,8,2.0,10,0.2
147070382,2,16,2.0,18,0.1111111111111111
147074608,1,29,1.0,30,0.03333333333333333
147086853,6,14,6.0,20,0.3
147130660,7,20,7.0,27,0.25925925925925924
147131029,8,1,1.0,9,0.1111111111111111
147131597,1,9,1.0,10,0.1
147184455,1,9,1.0,10,0.1
147214547,4,6,4.0,10,0.4
147217238,4,6,4.0,10,0.4
147221968,1,9,1.0,10,0.1
147247403,2,7,2.0,9,0.2222222222222222
147261909,1,8,1.0,9,0.1111111111111111
147269858,1,9,1.0,10,0.1
147293730,2,6,2.0,8,0.25
147297368,2,8,2.0,10,0.2
147305358,1,8,1.0,9,0.1111111111111111
147317189,1,8,1.0,9,0.1111111111111111
147338960,1,9,1.0,10,0.1
147342111,13,17,13.0,30,0.43333333333333335
147373105,7,2,2.0,9,0.2222222222222222
147396493,2,18,2.0,20,0.1
147419891,6,4,4.0,10,0.4
147420976,1,9,1.0,10,0.1
147421223,5,25,5.0,30,0.16666666666666666
147421519,1,9,1.0,10,0.1
147424276,1,27,1.0,28,0.03571428571428571
147427267,2,27,2.0,29,0.06896551724137931
147446875,4,6,4.0,10,0.4
147447659,1,9,1.0,10,0.1
147463808,2,8,2.0,10,0.2
147465075,7,3,3.0,10,0.3
147465596,2,8,2.0,10,0.2
147465846,3,7,3.0,10,0.3
147476719,1,9,1.0,10,0.1
147479241,1,9,1.0,10,0.1
147481184,1,9,1.0,10,0.1
147481615,4,6,4.0,10,0.4
147495209,7,3,3.0,10,0.3
147510704,3,17,3.0,20,0.15
147523859,4,6,4.0,10,0.4
147529306,7,3,3.0,10,0.3
147530267,14,15,14.0,29,0.4827586206896552
147530691,4,5,4.0,9,0.4444444444444444
147534888,6,3,3.0,9,0.3333333333333333
147558715,2,8,2.0,10,0.2
147562537,8,2,2.0,10,0.2
147562712,1,9,1.0,10,0.1
147585408,1,7,1.0,8,0.125
147586382,1,8,1.0,9,0.1111111111111111
147602790,6,24,6.0,30,0.2
147604583,3,6,3.0,9,0.3333333333333333
147605339,1,9,1.0,10,0.1
147606496,3,5,3.0,8,0.375
147622406,2,7,2.0,9,0.2222222222222222
147622684,3,7,3.0,10,0.3
147658477,2,8,2.0,10,0.2
147661866,2,8,2.0,10,0.2
147718499,1,8,1.0,9,0.1111111111111111
147722334,9,1,1.0,10,0.1
147726580,1,9,1.0,10,0.1
147741411,1,9,1.0,10,0.1
147766968,3,7,3.0,10,0.3
147767208,1,8,1.0,9,0.1111111111111111
147768220,1,7,1.0,8,0.125
147768414,1,8,1.0,9,0.1111111111111111
147784530,1,17,1.0,18,0.05555555555555555
147801442,2,8,2.0,10,0.2
147801703,4,6,4.0,10,0.4
147808273,26,2,2.0,28,0.07142857142857142
147813246,4,5,4.0,9,0.4444444444444444
147814388,4,16,4.0,20,0.2
147815634,1,18,1.0,19,0.05263157894736842
147823454,1,9,1.0,10,0.1
147823844,5,4,4.0,9,0.4444444444444444
147824243,3,5,3.0,8,0.375
147898577,1,9,1.0,10,0.1
147898816,6,3,3.0,9,0.3333333333333333
147907076,1,8,1.0,9,0.1111111111111111
147910519,1,18,1.0,19,0.05263157894736842
147918765,1,19,1.0,20,0.05
147946318,1,9,1.0,10,0.1
147952489,3,7,3.0,10,0.3
147955016,1,8,1.0,9,0.1111111111111111
147968814,1,8,1.0,9,0.1111111111111111
147975598,3,6,3.0,9,0.3333333333333333
147977714,4,16,4.0,20,0.2
147997265,3,7,3.0,10,0.3
147999220,3,7,3.0,10,0.3
148010907,4,6,4.0,10,0.4
148011336,6,3,3.0,9,0.3333333333333333
148041766,2,27,2.0,29,0.06896551724137931
148052211,1,8,1.0,9,0.1111111111111111
148056942,5,3,3.0,8,0.375
148075764,1,9,1.0,10,0.1
148086026,4,6,4.0,10,0.4
148086049,1,18,1.0,19,0.05263157894736842
148095201,2,16,2.0,18,0.1111111111111111
148111288,2,7,2.0,9,0.2222222222222222
148119606,6,4,4.0,10,0.4
148188463,2,8,2.0,10,0.2
148201153,1,8,1.0,9,0.1111111111111111
148207103,1,8,1.0,9,0.1111111111111111
148241211,1,18,1.0,19,0.05263157894736842
148265099,6,3,3.0,9,0.3333333333333333
148269534,1,17,1.0,18,0.05555555555555555
148308468,1,7,1.0,8,0.125
148388636,1,9,1.0,10,0.1
148413620,1,9,1.0,10,0.1
148431573,3,7,3.0,10,0.3
148489815,1,9,1.0,10,0.1
148504684,1,8,1.0,9,0.1111111111111111
148506738,2,8,2.0,10,0.2
148516446,3,7,3.0,10,0.3
148516539,1,9,1.0,10,0.1
148542280,14,14,14.0,28,0.5
148582966,7,3,3.0,10,0.3
148584718,1,9,1.0,10,0.1
148588088,1,8,1.0,9,0.1111111111111111
148607286,6,3,3.0,9,0.3333333333333333
148607422,3,15,3.0,18,0.16666666666666666
148611727,1,17,1.0,18,0.05555555555555555
148614918,2,17,2.0,19,0.10526315789473684
148618191,1,28,1.0,29,0.034482758620689655
148620908,6,4,4.0,10,0.4
148627053,10,17,10.0,27,0.37037037037037035
148627408,1,8,1.0,9,0.1111111111111111
148629630,3,24,3.0,27,0.1111111111111111
148631830,2,7,2.0,9,0.2222222222222222
148632166,3,25,3.0,28,0.10714285714285714
148633269,22,6,6.0,28,0.21428571428571427
148633426,3,6,3.0,9,0.3333333333333333
148647293,2,16,2.0,18,0.1111111111111111
148670961,3,7,3.0,10,0.3
148691633,3,23,3.0,26,0.11538461538461539
148696937,4,5,4.0,9,0.4444444444444444
148702459,1,8,1.0,9,0.1111111111111111
148726673,1,19,1.0,20,0.05
148727829,1,18,1.0,19,0.05263157894736842
148732346,1,17,1.0,18,0.05555555555555555
148738374,1,8,1.0,9,0.1111111111111111
148745019,1,7,1.0,8,0.125
148753091,2,18,2.0,20,0.1
148753401,7,2,2.0,9,0.2222222222222222
148758608,1,9,1.0,10,0.1
148759799,4,23,4.0,27,0.14814814814814814
148797006,1,8,1.0,9,0.1111111111111111
148799709,2,8,2.0,10,0.2
148836717,1,9,1.0,10,0.1
148837908,2,18,2.0,20,0.1
148839833,1,8,1.0,9,0.1111111111111111
148847297,1,9,1.0,10,0.1
148849968,1,9,1.0,10,0.1
148851294,1,9,1.0,10,0.1
148872678,1,9,1.0,10,0.1
148873856,1,9,1.0,10,0.1
148880316,2,8,2.0,10,0.2
148882152,7,3,3.0,10,0.3
148882545,1,9,1.0,10,0.1
148882677,5,5,5.0,10,0.5
148893052,3,7,3.0,10,0.3
148908052,3,7,3.0,10,0.3
148937789,8,2,2.0,10,0.2
148947123,2,8,2.0,10,0.2
148958097,6,3,3.0,9,0.3333333333333333
148963210,7,3,3.0,10,0.3
148965590,22,6,6.0,28,0.21428571428571427
148967645,20,6,6.0,26,0.23076923076923078
148967858,6,4,4.0,10,0.4
148968133,3,7,3.0,10,0.3
148969009,1,8,1.0,9,0.1111111111111111
148970889,2,7,2.0,9,0.2222222222222222
148973329,1,9,1.0,10,0.1
148973592,1,8,1.0,9,0.1111111111111111
148976239,4,6,4.0,10,0.4
148978758,5,4,4.0,9,0.4444444444444444
148996632,1,9,1.0,10,0.1
149003845,3,6,3.0,9,0.3333333333333333
149004605,3,6,3.0,9,0.3333333333333333
149013149,9,1,1.0,10,0.1
149014659,1,8,1.0,9,0.1111111111111111
149024421,2,17,2.0,19,0.10526315789473684
149040613,1,9,1.0,10,0.1
149045477,8,1,1.0,9,0.1111111111111111
149066365,9,1,1.0,10,0.1
149066459,6,4,4.0,10,0.4
149097607,1,18,1.0,19,0.05263157894736842
149142767,1,9,1.0,10,0.1
149162867,4,6,4.0,10,0.4
149168106,8,2,2.0,10,0.2
149168953,2,18,2.0,20,0.1
149176682,1,9,1.0,10,0.1
149184482,1,9,1.0,10,0.1
149221469,2,17,2.0,19,0.10526315789473684
149234049,2,8,2.0,10,0.2
149256184,6,3,3.0,9,0.3333333333333333
149258330,2,8,2.0,10,0.2
149275016,3,6,3.0,9,0.3333333333333333
149275763,4,6,4.0,10,0.4
149307784,1,17,1.0,18,0.05555555555555555
149316322,1,19,1.0,20,0.05
149337486,2,17,2.0,19,0.10526315789473684
149340026,5,5,5.0,10,0.5
149348435,2,8,2.0,10,0.2
149351857,16,3,3.0,19,0.15789473684210525
149377746,7,2,2.0,9,0.2222222222222222
149379125,4,6,4.0,10,0.4
149380019,17,11,11.0,28,0.39285714285714285
149380141,3,7,3.0,10,0.3
149384427,7,3,3.0,10,0.3
149388731,1,9,1.0,10,0.1
149389042,2,8,2.0,10,0.2
149396024,1,28,1.0,29,0.034482758620689655
149396522,1,8,1.0,9,0.1111111111111111
149396991,2,8,2.0,10,0.2
149398876,6,3,3.0,9,0.3333333333333333
149411162,6,4,4.0,10,0.4
149411773,1,7,1.0,8,0.125
149412405,3,7,3.0,10,0.3
149413534,1,9,1.0,10,0.1
149414345,2,7,2.0,9,0.2222222222222222
149416423,9,1,1.0,10,0.1
149425851,8,1,1.0,9,0.1111111111111111
149428901,3,17,3.0,20,0.15
149429968,4,25,4.0,29,0.13793103448275862
149439790,8,19,8.0,27,0.2962962962962963
149440602,2,8,2.0,10,0.2
149440804,3,7,3.0,10,0.3
149442617,6,20,6.0,26,0.23076923076923078
149467672,1,9,1.0,10,0.1
149477475,3,7,3.0,10,0.3
149485517,3,7,3.0,10,0.3
149495224,2,7,2.0,9,0.2222222222222222
149509130,1,9,1.0,10,0.1
149516897,1,9,1.0,10,0.1
149517810,17,10,10.0,27,0.37037037037037035
149529477,1,9,1.0,10,0.1
149532056,1,8,1.0,9,0.1111111111111111
149536650,2,8,2.0,10,0.2
149555049,1,17,1.0,18,0.05555555555555555
149588628,3,17,3.0,20,0.15
149614243,1,18,1.0,19,0.05263157894736842
149623107,8,1,1.0,9,0.1111111111111111
149623365,1,19,1.0,20,0.05
149623826,1,8,1.0,9,0.1111111111111111
149668228,8,1,1.0,9,0.1111111111111111
149669929,2,8,2.0,10,0.2
149674670,6,4,4.0,10,0.4
149677895,4,5,4.0,9,0.4444444444444444
149704379,4,6,4.0,10,0.4
149754081,2,8,2.0,10,0.2
149860556,26,3,3.0,29,0.10344827586206896
149862057,7,3,3.0,10,0.3
149863253,4,6,4.0,10,0.4
149935801,1,8,1.0,9,0.1111111111111111
149936172,9,1,1.0,10,0.1
149936769,9,1,1.0,10,0.1
150004841,2,8,2.0,10,0.2
150073388,1,8,1.0,9,0.1111111111111111
150086246,4,6,4.0,10,0.4
150102811,1,25,1.0,26,0.038461538461538464
150103825,6,4,4.0,10,0.4
150104360,5,5,5.0,10,0.5
150105795,2,8,2.0,10,0.2
150106982,1,8,1.0,9,0.1111111111111111
150114139,6,4,4.0,10,0.4
150118920,1,9,1.0,10,0.1
150120077,1,9,1.0,10,0.1
150121057,6,4,4.0,10,0.4
150146859,2,15,2.0,17,0.11764705882352941
150148705,1,9,1.0,10,0.1
150158598,1,9,1.0,10,0.1
150168927,1,9,1.0,10,0.1
150244519,2,8,2.0,10,0.2
150245715,1,9,1.0,10,0.1
150253609,2,7,2.0,9,0.2222222222222222
150274414,20,7,7.0,27,0.25925925925925924
150294662,5,5,5.0,10,0.5
150298382,3,7,3.0,10,0.3
150298998,2,26,2.0,28,0.07142857142857142
150299414,5,3,3.0,8,0.375
150300106,3,7,3.0,10,0.3
150300389,1,7,1.0,8,0.125
150301188,1,9,1.0,10,0.1
150309171,7,22,7.0,29,0.2413793103448276
150310307,1,9,1.0,10,0.1
150331823,2,6,2.0,8,0.25
150332542,1,7,1.0,8,0.125
150334744,1,9,1.0,10,0.1
150339344,1,7,1.0,8,0.125
150340972,2,7,2.0,9,0.2222222222222222
150341723,5,3,3.0,8,0.375
150346450,4,6,4.0,10,0.4
150346709,1,9,1.0,10,0.1
150346804,7,2,2.0,9,0.2222222222222222
150367644,1,8,1.0,9,0.1111111111111111
150387613,1,9,1.0,10,0.1
150406984,4,15,4.0,19,0.21052631578947367
150450297,1,17,1.0,18,0.05555555555555555
150455013,1,17,1.0,18,0.05555555555555555
150460485,4,5,4.0,9,0.4444444444444444
150461077,2,17,2.0,19,0.10526315789473684
150499760,7,23,7.0,30,0.23333333333333334
150500379,1,8,1.0,9,0.1111111111111111
150500999,4,6,4.0,10,0.4
150503763,3,5,3.0,8,0.375
150505600,2,8,2.0,10,0.2
150505959,1,9,1.0,10,0.1
150508054,1,9,1.0,10,0.1
150509424,11,19,11.0,30,0.36666666666666664
150521591,2,8,2.0,10,0.2
150528003,1,9,1.0,10,0.1
150596444,1,8,1.0,9,0.1111111111111111
150630874,6,3,3.0,9,0.3333333333333333
150636112,1,17,1.0,18,0.05555555555555555
150662695,9,1,1.0,10,0.1
150662953,21,7,7.0,28,0.25
150679125,1,8,1.0,9,0.1111111111111111
150685694,2,8,2.0,10,0.2
150696873,2,8,2.0,10,0.2
150696935,4,4,4.0,8,0.5
150707340,5,5,5.0,10,0.5
150717943,1,8,1.0,9,0.1111111111111111
150791366,1,9,1.0,10,0.1
150862649,1,19,1.0,20,0.05
150867997,7,3,3.0,10,0.3
150892048,3,6,3.0,9,0.3333333333333333
150892342,1,8,1.0,9,0.1111111111111111
150893282,1,9,1.0,10,0.1
150912068,15,5,5.0,20,0.25
150924968,2,6,2.0,8,0.25
150925013,1,18,1.0,19,0.05263157894736842
150938823,1,9,1.0,10,0.1
150957801,6,4,4.0,10,0.4
150969236,4,4,4.0,8,0.5
150977448,2,6,2.0,8,0.25
150979357,2,7,2.0,9,0.2222222222222222
150986040,1,9,1.0,10,0.1
150999319,1,9,1.0,10,0.1
151006486,5,5,5.0,10,0.5
151020568,1,9,1.0,10,0.1
151025215,1,18,1.0,19,0.05263157894736842
151034146,2,8,2.0,10,0.2
151036760,1,8,1.0,9,0.1111111111111111
151074946,2,8,2.0,10,0.2
151101664,6,4,4.0,10,0.4
151131375,1,9,1.0,10,0.1
151177817,1,9,1.0,10,0.1
151192811,6,4,4.0,10,0.4
151197096,1,9,1.0,10,0.1
151205763,1,17,1.0,18,0.05555555555555555
151207431,7,3,3.0,10,0.3
151208451,2,6,2.0,8,0.25
151212784,14,15,14.0,29,0.4827586206896552
151224591,4,6,4.0,10,0.4
151228339,6,4,4.0,10,0.4
151229626,4,5,4.0,9,0.4444444444444444
151230041,4,6,4.0,10,0.4
151230617,2,7,2.0,9,0.2222222222222222
151232302,5,5,5.0,10,0.5
151312536,1,9,1.0,10,0.1
151370964,3,7,3.0,10,0.3
151379974,1,9,1.0,10,0.1
151380408,5,5,5.0,10,0.5
151403363,8,21,8.0,29,0.27586206896551724
151404217,4,6,4.0,10,0.4
151412789,2,7,2.0,9,0.2222222222222222
151430769,9,17,9.0,26,0.34615384615384615
151445125,2,8,2.0,10,0.2
151445372,14,15,14.0,29,0.4827586206896552
151445504,5,26,5.0,31,0.16129032258064516
151445924,4,6,4.0,10,0.4
151451792,1,9,1.0,10,0.1
151453348,3,26,3.0,29,0.10344827586206896
151462496,1,9,1.0,10,0.1
151474715,7,2,2.0,9,0.2222222222222222
151475741,1,9,1.0,10,0.1
151476541,3,6,3.0,9,0.3333333333333333
151495155,8,2,2.0,10,0.2
151496724,7,2,2.0,9,0.2222222222222222
151497468,11,9,9.0,20,0.45
151497732,5,5,5.0,10,0.5
151505211,3,7,3.0,10,0.3
151520597,7,13,7.0,20,0.35
151531793,3,7,3.0,10,0.3
151535391,3,6,3.0,9,0.3333333333333333
151535541,1,8,1.0,9,0.1111111111111111
151536961,3,6,3.0,9,0.3333333333333333
151537047,9,19,9.0,28,0.32142857142857145
151560274,1,9,1.0,10,0.1
151568971,3,7,3.0,10,0.3
151568995,1,8,1.0,9,0.1111111111111111
151569281,8,1,1.0,9,0.1111111111111111
151590075,1,9,1.0,10,0.1
151596682,1,8,1.0,9,0.1111111111111111
151604009,4,6,4.0,10,0.4
151608485,1,8,1.0,9,0.1111111111111111
151618577,3,6,3.0,9,0.3333333333333333
151650068,2,8,2.0,10,0.2
151650849,1,9,1.0,10,0.1
151656908,3,7,3.0,10,0.3
151698663,1,8,1.0,9,0.1111111111111111
151734654,1,9,1.0,10,0.1
151735711,3,16,3.0,19,0.15789473684210525
151737793,1,9,1.0,10,0.1
151740273,1,16,1.0,17,0.058823529411764705
151741519,2,8,2.0,10,0.2
151743359,1,8,1.0,9,0.1111111111111111
151746055,7,3,3.0,10,0.3
151748667,1,19,1.0,20,0.05
151749552,1,9,1.0,10,0.1
151753200,2,8,2.0,10,0.2
151759996,3,6,3.0,9,0.3333333333333333
151762153,1,7,1.0,8,0.125
151769700,1,7,1.0,8,0.125
151818137,2,8,2.0,10,0.2
151840388,1,9,1.0,10,0.1
151844858,1,9,1.0,10,0.1
151856129,1,8,1.0,9,0.1111111111111111
151858031,2,8,2.0,10,0.2
151861965,1,9,1.0,10,0.1
151863075,1,9,1.0,10,0.1
151871219,22,6,6.0,28,0.21428571428571427
151901877,1,18,1.0,19,0.05263157894736842
151910361,1,9,1.0,10,0.1
152003298,3,7,3.0,10,0.3
152027157,1,17,1.0,18,0.05555555555555555
152032564,16,11,11.0,27,0.4074074074074074
152051050,1,8,1.0,9,0.1111111111111111
152056134,2,18,2.0,20,0.1
152062249,1,9,1.0,10,0.1
152066662,1,19,1.0,20,0.05
152070659,4,6,4.0,10,0.4
152111102,1,7,1.0,8,0.125
152121751,2,8,2.0,10,0.2
152123161,2,8,2.0,10,0.2
152127143,1,18,1.0,19,0.05263157894736842
152132691,4,6,4.0,10,0.4
152133060,9,21,9.0,30,0.3
152133291,4,6,4.0,10,0.4
152134926,7,21,7.0,28,0.25
152137877,1,9,1.0,10,0.1
152140068,1,9,1.0,10,0.1
152141717,12,17,12.0,29,0.41379310344827586
152144988,1,9,1.0,10,0.1
152186395,1,9,1.0,10,0.1
152187065,2,7,2.0,9,0.2222222222222222
152188937,4,6,4.0,10,0.4
152227227,1,8,1.0,9,0.1111111111111111
152229737,3,7,3.0,10,0.3
152239567,7,23,7.0,30,0.23333333333333334
152239906,1,19,1.0,20,0.05
152241701,6,4,4.0,10,0.4
152252380,1,9,1.0,10,0.1
152280750,3,7,3.0,10,0.3
152309193,1,8,1.0,9,0.1111111111111111
152313979,6,4,4.0,10,0.4
152317699,6,3,3.0,9,0.3333333333333333
152318813,2,17,2.0,19,0.10526315789473684
152319935,1,8,1.0,9,0.1111111111111111
152320580,1,8,1.0,9,0.1111111111111111
152321287,4,6,4.0,10,0.4
152337397,28,2,2.0,30,0.06666666666666667
152369584,1,9,1.0,10,0.1
152380321,3,7,3.0,10,0.3
152386203,1,8,1.0,9,0.1111111111111111
152386907,1,9,1.0,10,0.1
152396710,2,7,2.0,9,0.2222222222222222
152436867,3,7,3.0,10,0.3
152438460,2,7,2.0,9,0.2222222222222222
152439296,2,6,2.0,8,0.25
152467317,1,8,1.0,9,0.1111111111111111
152487551,5,5,5.0,10,0.5
152541867,1,7,1.0,8,0.125
152542785,3,6,3.0,9,0.3333333333333333
152576109,7,3,3.0,10,0.3
152590567,1,9,1.0,10,0.1
152607620,5,13,5.0,18,0.2777777777777778
152610060,1,19,1.0,20,0.05
152610557,1,9,1.0,10,0.1
152615893,4,6,4.0,10,0.4
152623183,2,6,2.0,8,0.25
152623675,7,3,3.0,10,0.3
152629180,3,6,3.0,9,0.3333333333333333
152631065,1,9,1.0,10,0.1
152632231,1,19,1.0,20,0.05
152632491,4,5,4.0,9,0.4444444444444444
152645001,3,7,3.0,10,0.3
152715693,1,19,1.0,20,0.05
152718010,1,18,1.0,19,0.05263157894736842
152727428,5,5,5.0,10,0.5
152727462,1,8,1.0,9,0.1111111111111111
152727730,2,7,2.0,9,0.2222222222222222
152763907,5,15,5.0,20,0.25
152798250,1,9,1.0,10,0.1
152819580,2,7,2.0,9,0.2222222222222222
152823477,1,9,1.0,10,0.1
152842967,9,1,1.0,10,0.1
152848342,2,6,2.0,8,0.25
152870182,9,1,1.0,10,0.1
152879485,4,4,4.0,8,0.5
152879826,6,3,3.0,9,0.3333333333333333
152880043,3,6,3.0,9,0.3333333333333333
152880324,2,8,2.0,10,0.2
152880678,3,16,3.0,19,0.15789473684210525
152889058,1,8,1.0,9,0.1111111111111111
152927672,1,8,1.0,9,0.1111111111111111
152951683,4,5,4.0,9,0.4444444444444444
152953230,2,18,2.0,20,0.1
152972886,1,8,1.0,9,0.1111111111111111
153009416,5,5,5.0,10,0.5
153012650,8,2,2.0,10,0.2
153013224,3,7,3.0,10,0.3
153023848,1,8,1.0,9,0.1111111111111111
153035516,2,8,2.0,10,0.2
153042517,5,4,4.0,9,0.4444444444444444
153045609,1,9,1.0,10,0.1
153064108,2,27,2.0,29,0.06896551724137931
153069952,1,18,1.0,19,0.05263157894736842
153071772,2,17,2.0,19,0.10526315789473684
153071874,5,5,5.0,10,0.5
153072379,6,3,3.0,9,0.3333333333333333
153181593,1,8,1.0,9,0.1111111111111111
153201890,1,9,1.0,10,0.1
153210602,2,6,2.0,8,0.25
153216385,1,9,1.0,10,0.1
153231601,1,19,1.0,20,0.05
153236216,1,8,1.0,9,0.1111111111111111
153239477,3,7,3.0,10,0.3
153240540,1,19,1.0,20,0.05
153240838,1,9,1.0,10,0.1
153308480,2,7,2.0,9,0.2222222222222222
153314124,3,16,3.0,19,0.15789473684210525
153326617,2,8,2.0,10,0.2
153327259,3,24,3.0,27,0.1111111111111111
153340261,6,24,6.0,30,0.2
153341447,2,8,2.0,10,0.2
153342596,2,8,2.0,10,0.2
153344342,4,6,4.0,10,0.4
153347997,3,6,3.0,9,0.3333333333333333
153348013,4,5,4.0,9,0.4444444444444444
153348063,8,1,1.0,9,0.1111111111111111
153367353,1,19,1.0,20,0.05
153374658,1,7,1.0,8,0.125
153405509,2,8,2.0,10,0.2
153447756,1,9,1.0,10,0.1
153448727,1,8,1.0,9,0.1111111111111111
153468469,4,6,4.0,10,0.4
153468726,1,9,1.0,10,0.1
153474616,1,9,1.0,10,0.1
153486693,2,17,2.0,19,0.10526315789473684
153487568,1,8,1.0,9,0.1111111111111111
153488493,1,17,1.0,18,0.05555555555555555
153500661,7,3,3.0,10,0.3
153508912,1,9,1.0,10,0.1
153531041,6,4,4.0,10,0.4
153545200,1,8,1.0,9,0.1111111111111111
153546700,9,1,1.0,10,0.1
153547131,26,2,2.0,28,0.07142857142857142
153548343,7,1,1.0,8,0.125
153556719,1,9,1.0,10,0.1
153599401,7,11,7.0,18,0.3888888888888889
153611201,9,1,1.0,10,0.1
153614170,6,4,4.0,10,0.4
153661051,4,5,4.0,9,0.4444444444444444
153690295,2,7,2.0,9,0.2222222222222222
153695079,1,8,1.0,9,0.1111111111111111
153696937,1,8,1.0,9,0.1111111111111111
153697161,1,9,1.0,10,0.1
153700407,1,8,1.0,9,0.1111111111111111
153727993,5,15,5.0,20,0.25
153746762,1,8,1.0,9,0.1111111111111111
153755225,1,9,1.0,10,0.1
153756529,1,9,1.0,10,0.1
153766882,2,8,2.0,10,0.2
153768090,1,9,1.0,10,0.1
153772202,1,9,1.0,10,0.1
153772684,2,7,2.0,9,0.2222222222222222
153782274,5,5,5.0,10,0.5
153789777,2,18,2.0,20,0.1
153800988,1,18,1.0,19,0.05263157894736842
153807978,1,9,1.0,10,0.1
153835553,1,9,1.0,10,0.1
153850378,2,18,2.0,20,0.1
153911908,1,9,1.0,10,0.1
153914376,2,8,2.0,10,0.2
153933072,2,7,2.0,9,0.2222222222222222
153934492,1,7,1.0,8,0.125
153935613,1,9,1.0,10,0.1
153937630,8,2,2.0,10,0.2
153939171,8,2,2.0,10,0.2
153955092,7,13,7.0,20,0.35
153967633,3,6,3.0,9,0.3333333333333333
153974541,2,8,2.0,10,0.2
153977345,2,8,2.0,10,0.2
153992372,2,8,2.0,10,0.2
154009284,1,9,1.0,10,0.1
154010103,1,9,1.0,10,0.1
154012899,4,24,4.0,28,0.14285714285714285
154017119,2,8,2.0,10,0.2
154028164,3,7,3.0,10,0.3
154052036,1,8,1.0,9,0.1111111111111111
154053636,1,9,1.0,10,0.1
154054678,2,8,2.0,10,0.2
154055404,4,6,4.0,10,0.4
154060683,4,14,4.0,18,0.2222222222222222
154067355,2,7,2.0,9,0.2222222222222222
154073519,4,5,4.0,9,0.4444444444444444
154078383,1,18,1.0,19,0.05263157894736842
154088497,1,18,1.0,19,0.05263157894736842
154098880,12,13,12.0,25,0.48
154114494,1,8,1.0,9,0.1111111111111111
154122910,3,6,3.0,9,0.3333333333333333
154153555,2,18,2.0,20,0.1
154174352,1,8,1.0,9,0.1111111111111111
154251656,2,17,2.0,19,0.10526315789473684
154257176,6,4,4.0,10,0.4
154257743,6,3,3.0,9,0.3333333333333333
154260481,1,17,1.0,18,0.05555555555555555
154261363,2,8,2.0,10,0.2
154279271,14,6,6.0,20,0.3
154279680,7,1,1.0,8,0.125
154313665,1,16,1.0,17,0.058823529411764705
154353685,1,8,1.0,9,0.1111111111111111
154362516,1,8,1.0,9,0.1111111111111111
154396914,1,19,1.0,20,0.05
154477046,8,1,1.0,9,0.1111111111111111
154491565,1,9,1.0,10,0.1
154508805,1,8,1.0,9,0.1111111111111111
154523620,6,2,2.0,8,0.25
154524210,1,18,1.0,19,0.05263157894736842
154547408,1,8,1.0,9,0.1111111111111111
154588396,1,9,1.0,10,0.1
154594434,6,4,4.0,10,0.4
154597718,1,27,1.0,28,0.03571428571428571
154599010,1,7,1.0,8,0.125
154605197,2,6,2.0,8,0.25
154606832,7,22,7.0,29,0.2413793103448276
154607001,6,4,4.0,10,0.4
154608016,3,5,3.0,8,0.375
154622633,4,16,4.0,20,0.2
154628814,1,8,1.0,9,0.1111111111111111
154638890,1,8,1.0,9,0.1111111111111111
154701471,1,28,1.0,29,0.034482758620689655
154711810,1,9,1.0,10,0.1
154739767,2,8,2.0,10,0.2
154761199,1,8,1.0,9,0.1111111111111111
154777551,1,9,1.0,10,0.1
154780611,1,8,1.0,9,0.1111111111111111
154781333,1,9,1.0,10,0.1
154811451,1,9,1.0,10,0.1
154848289,7,2,2.0,9,0.2222222222222222
154852725,1,9,1.0,10,0.1
154861234,3,7,3.0,10,0.3
154862042,1,8,1.0,9,0.1111111111111111
154862072,2,8,2.0,10,0.2
154903860,1,9,1.0,10,0.1
154987928,3,7,3.0,10,0.3
155002966,1,9,1.0,10,0.1
155023303,1,19,1.0,20,0.05
155039126,2,8,2.0,10,0.2
155043447,3,7,3.0,10,0.3
155075628,26,2,2.0,28,0.07142857142857142
155077242,1,9,1.0,10,0.1
155080546,1,9,1.0,10,0.1
155094675,2,7,2.0,9,0.2222222222222222
155158616,1,9,1.0,10,0.1
155161416,1,8,1.0,9,0.1111111111111111
155205782,2,8,2.0,10,0.2
155210731,1,9,1.0,10,0.1
155218494,1,9,1.0,10,0.1
155226945,6,3,3.0,9,0.3333333333333333
155236692,1,18,1.0,19,0.05263157894736842
155254038,3,6,3.0,9,0.3333333333333333
155254527,1,9,1.0,10,0.1
155259869,1,8,1.0,9,0.1111111111111111
155263203,1,9,1.0,10,0.1
155264325,3,6,3.0,9,0.3333333333333333
155268553,4,5,4.0,9,0.4444444444444444
155269333,3,6,3.0,9,0.3333333333333333
155282997,2,8,2.0,10,0.2
155286651,5,5,5.0,10,0.5
155289566,2,8,2.0,10,0.2
155325194,2,8,2.0,10,0.2
155332995,1,8,1.0,9,0.1111111111111111
155341565,1,9,1.0,10,0.1
155357489,2,8,2.0,10,0.2
155358381,2,26,2.0,28,0.07142857142857142
155359777,2,8,2.0,10,0.2
155361049,2,8,2.0,10,0.2
155361979,3,7,3.0,10,0.3
155363233,2,17,2.0,19,0.10526315789473684
155363404,1,9,1.0,10,0.1
155363976,2,8,2.0,10,0.2
155388342,9,1,1.0,10,0.1
155414395,1,8,1.0,9,0.1111111111111111
155416680,1,18,1.0,19,0.05263157894736842
155454409,2,27,2.0,29,0.06896551724137931
155471052,2,8,2.0,10,0.2
155472390,2,8,2.0,10,0.2
155473974,1,7,1.0,8,0.125
155486288,3,6,3.0,9,0.3333333333333333
155497663,1,8,1.0,9,0.1111111111111111
155499394,2,7,2.0,9,0.2222222222222222
155507999,1,18,1.0,19,0.05263157894736842
155529129,2,7,2.0,9,0.2222222222222222
155540902,3,6,3.0,9,0.3333333333333333
155543997,2,16,2.0,18,0.1111111111111111
155562828,1,9,1.0,10,0.1
155564451,1,8,1.0,9,0.1111111111111111
155575274,27,1,1.0,28,0.03571428571428571
155580694,1,8,1.0,9,0.1111111111111111
155589535,2,17,2.0,19,0.10526315789473684
155601923,5,13,5.0,18,0.2777777777777778
155603112,1,9,1.0,10,0.1
155606889,1,9,1.0,10,0.1
155627282,1,19,1.0,20,0.05
155631667,10,10,10.0,20,0.5
155654132,1,18,1.0,19,0.05263157894736842
155656159,6,4,4.0,10,0.4
155669040,2,8,2.0,10,0.2
155673047,6,21,6.0,27,0.2222222222222222
155678515,2,8,2.0,10,0.2
155686399,3,5,3.0,8,0.375
155687273,2,8,2.0,10,0.2
155693542,3,6,3.0,9,0.3333333333333333
155694678,9,1,1.0,10,0.1
155695976,6,4,4.0,10,0.4
155698957,3,7,3.0,10,0.3
155711178,3,6,3.0,9,0.3333333333333333
155717283,5,4,4.0,9,0.4444444444444444
155717628,4,15,4.0,19,0.21052631578947367
155725002,6,4,4.0,10,0.4
155725407,6,4,4.0,10,0.4
155758562,3,17,3.0,20,0.15
155800139,1,8,1.0,9,0.1111111111111111
155826880,2,8,2.0,10,0.2
155830972,1,9,1.0,10,0.1
155835421,2,7,2.0,9,0.2222222222222222
155835604,7,2,2.0,9,0.2222222222222222
155836198,3,6,3.0,9,0.3333333333333333
155836787,7,2,2.0,9,0.2222222222222222
155890339,1,8,1.0,9,0.1111111111111111
155911839,1,8,1.0,9,0.1111111111111111
155938980,1,8,1.0,9,0.1111111111111111
155943921,1,9,1.0,10,0.1
155954688,1,18,1.0,19,0.05263157894736842
155956503,17,11,11.0,28,0.39285714285714285
155960688,2,8,2.0,10,0.2
155963210,4,6,4.0,10,0.4
155977272,2,18,2.0,20,0.1
155978287,1,18,1.0,19,0.05263157894736842
155984555,1,8,1.0,9,0.1111111111111111
155985383,1,9,1.0,10,0.1
155989630,1,15,1.0,16,0.0625
155991076,6,4,4.0,10,0.4
155991165,5,4,4.0,9,0.4444444444444444
155992735,9,11,9.0,20,0.45
155995706,5,5,5.0,10,0.5
155999721,2,8,2.0,10,0.2
156001657,4,4,4.0,8,0.5
156004017,1,9,1.0,10,0.1
156016133,27,1,1.0,28,0.03571428571428571
156082710,1,19,1.0,20,0.05
156128170,6,2,2.0,8,0.25
156142939,2,8,2.0,10,0.2
156144388,2,7,2.0,9,0.2222222222222222
156164135,2,8,2.0,10,0.2
156179824,9,1,1.0,10,0.1
156180203,5,4,4.0,9,0.4444444444444444
156181059,16,13,13.0,29,0.4482758620689655
156181216,3,7,3.0,10,0.3
156182753,1,8,1.0,9,0.1111111111111111
156203691,8,22,8.0,30,0.26666666666666666
156203862,7,2,2.0,9,0.2222222222222222
156204967,5,5,5.0,10,0.5
156205529,2,17,2.0,19,0.10526315789473684
156205656,1,9,1.0,10,0.1
156221469,1,9,1.0,10,0.1
156222871,3,6,3.0,9,0.3333333333333333
156223280,8,2,2.0,10,0.2
156237125,5,5,5.0,10,0.5
156237928,4,6,4.0,10,0.4
156238417,27,3,3.0,30,0.1
156238807,2,8,2.0,10,0.2
156238902,4,6,4.0,10,0.4
156239071,1,9,1.0,10,0.1
156254341,3,7,3.0,10,0.3
156341525,1,9,1.0,10,0.1
156372084,3,6,3.0,9,0.3333333333333333
156393670,3,15,3.0,18,0.16666666666666666
156400054,1,8,1.0,9,0.1111111111111111
156427101,1,9,1.0,10,0.1
156461692,6,21,6.0,27,0.2222222222222222
156533235,4,5,4.0,9,0.4444444444444444
156542265,2,6,2.0,8,0.25
156546583,2,7,2.0,9,0.2222222222222222
156563498,2,8,2.0,10,0.2
156577607,1,9,1.0,10,0.1
156591071,1,17,1.0,18,0.05555555555555555
156593238,1,15,1.0,16,0.0625
156609338,1,18,1.0,19,0.05263157894736842
156610473,1,9,1.0,10,0.1
156613182,1,9,1.0,10,0.1
156616608,2,8,2.0,10,0.2
156618475,2,8,2.0,10,0.2
156620623,2,8,2.0,10,0.2
156621304,4,5,4.0,9,0.4444444444444444
156642527,2,15,2.0,17,0.11764705882352941
156684941,4,6,4.0,10,0.4
156685123,2,7,2.0,9,0.2222222222222222
156686030,2,8,2.0,10,0.2
156686797,7,3,3.0,10,0.3
156741463,6,3,3.0,9,0.3333333333333333
156770679,1,9,1.0,10,0.1
156774829,3,6,3.0,9,0.3333333333333333
156788130,1,8,1.0,9,0.1111111111111111
156793282,2,8,2.0,10,0.2
156846037,1,9,1.0,10,0.1
156862831,5,5,5.0,10,0.5
156918974,1,9,1.0,10,0.1
156931120,2,7,2.0,9,0.2222222222222222
156958238,1,8,1.0,9,0.1111111111111111
157005431,3,7,3.0,10,0.3
157061334,2,18,2.0,20,0.1
157089494,1,9,1.0,10,0.1
157089558,3,5,3.0,8,0.375
157089703,3,26,3.0,29,0.10344827586206896
157133596,2,15,2.0,17,0.11764705882352941
157159402,5,4,4.0,9,0.4444444444444444
157180339,2,7,2.0,9,0.2222222222222222
157183526,1,9,1.0,10,0.1
157185737,4,5,4.0,9,0.4444444444444444
157185900,2,7,2.0,9,0.2222222222222222
157194038,2,17,2.0,19,0.10526315789473684
157275085,2,16,2.0,18,0.1111111111111111
157283544,1,7,1.0,8,0.125
157311901,2,8,2.0,10,0.2
157314024,4,6,4.0,10,0.4
157335660,2,8,2.0,10,0.2
157360592,6,4,4.0,10,0.4
157361068,7,3,3.0,10,0.3
157382120,1,17,1.0,18,0.05555555555555555
157383606,7,2,2.0,9,0.2222222222222222
157401421,1,9,1.0,10,0.1
157403640,4,6,4.0,10,0.4
157412388,1,27,1.0,28,0.03571428571428571
157422449,4,5,4.0,9,0.4444444444444444
157422910,1,9,1.0,10,0.1
157424575,4,5,4.0,9,0.4444444444444444
157437080,2,8,2.0,10,0.2
157446074,5,14,5.0,19,0.2631578947368421
157479240,8,2,2.0,10,0.2
157500666,15,13,13.0,28,0.4642857142857143
157501798,1,7,1.0,8,0.125
157502402,5,5,5.0,10,0.5
157504909,1,8,1.0,9,0.1111111111111111
157513552,4,6,4.0,10,0.4
157514854,7,3,3.0,10,0.3
157515096,7,2,2.0,9,0.2222222222222222
157516577,2,7,2.0,9,0.2222222222222222
157519030,9,1,1.0,10,0.1
157519342,5,24,5.0,29,0.1724137931034483
157525135,1,9,1.0,10,0.1
157525856,7,2,2.0,9,0.2222222222222222
157585218,6,4,4.0,10,0.4
157594766,3,7,3.0,10,0.3
157623882,9,1,1.0,10,0.1
157626443,2,24,2.0,26,0.07692307692307693
157645870,5,5,5.0,10,0.5
157662323,1,9,1.0,10,0.1
157667599,3,6,3.0,9,0.3333333333333333
157698928,5,3,3.0,8,0.375
157706238,2,8,2.0,10,0.2
157738887,6,4,4.0,10,0.4
157742220,3,16,3.0,19,0.15789473684210525
157764196,1,7,1.0,8,0.125
157769052,1,18,1.0,19,0.05263157894736842
157771560,1,9,1.0,10,0.1
157793179,1,9,1.0,10,0.1
157823401,1,16,1.0,17,0.058823529411764705
157831748,1,9,1.0,10,0.1
157834740,4,23,4.0,27,0.14814814814814814
157925417,1,19,1.0,20,0.05
157935709,1,8,1.0,9,0.1111111111111111
157935987,1,9,1.0,10,0.1
157985537,1,9,1.0,10,0.1
157999763,1,9,1.0,10,0.1
158015625,1,8,1.0,9,0.1111111111111111
158016714,3,5,3.0,8,0.375
158018845,2,18,2.0,20,0.1
158031195,7,2,2.0,9,0.2222222222222222
158114502,8,2,2.0,10,0.2
158180446,4,6,4.0,10,0.4
158191702,1,9,1.0,10,0.1
158224396,1,8,1.0,9,0.1111111111111111
158251631,1,19,1.0,20,0.05
158282075,7,3,3.0,10,0.3
158283863,1,8,1.0,9,0.1111111111111111
158292014,5,5,5.0,10,0.5
158292638,2,7,2.0,9,0.2222222222222222
158293084,3,7,3.0,10,0.3
158316205,2,7,2.0,9,0.2222222222222222
158358777,1,7,1.0,8,0.125
158369047,3,7,3.0,10,0.3
158372330,1,19,1.0,20,0.05
158381153,4,5,4.0,9,0.4444444444444444
158400932,1,9,1.0,10,0.1
158412651,1,8,1.0,9,0.1111111111111111
158459307,1,19,1.0,20,0.05
158499181,2,7,2.0,9,0.2222222222222222
158548033,1,19,1.0,20,0.05
158549580,4,22,4.0,26,0.15384615384615385
158614704,1,9,1.0,10,0.1
158624884,5,5,5.0,10,0.5
158646905,11,9,9.0,20,0.45
158647928,2,8,2.0,10,0.2
158707520,6,2,2.0,8,0.25
158709156,2,8,2.0,10,0.2
158710644,3,15,3.0,18,0.16666666666666666
158712543,1,18,1.0,19,0.05263157894736842
158742723,1,8,1.0,9,0.1111111111111111
158752258,1,9,1.0,10,0.1
158767576,4,5,4.0,9,0.4444444444444444
158779790,1,9,1.0,10,0.1
158786387,12,15,12.0,27,0.4444444444444444
158792944,2,8,2.0,10,0.2
158794274,4,6,4.0,10,0.4
158796230,3,16,3.0,19,0.15789473684210525
158798251,1,7,1.0,8,0.125
158809301,1,9,1.0,10,0.1
158809667,1,8,1.0,9,0.1111111111111111
158854889,4,15,4.0,19,0.21052631578947367
158858955,1,8,1.0,9,0.1111111111111111
158860384,3,7,3.0,10,0.3
158870039,4,6,4.0,10,0.4
158871428,1,8,1.0,9,0.1111111111111111
158897412,2,8,2.0,10,0.2
158909296,1,8,1.0,9,0.1111111111111111
158924724,2,8,2.0,10,0.2
158940040,1,8,1.0,9,0.1111111111111111
158940342,1,17,1.0,18,0.05555555555555555
158941212,1,26,1.0,27,0.037037037037037035
158957888,1,8,1.0,9,0.1111111111111111
158961865,2,8,2.0,10,0.2
158963646,1,18,1.0,19,0.05263157894736842
158966132,5,5,5.0,10,0.5
158984283,3,17,3.0,20,0.15
159000592,1,16,1.0,17,0.058823529411764705
159017096,1,8,1.0,9,0.1111111111111111
159032947,5,4,4.0,9,0.4444444444444444
159035110,2,8,2.0,10,0.2
159055408,3,6,3.0,9,0.3333333333333333
159057390,4,4,4.0,8,0.5
159058726,3,6,3.0,9,0.3333333333333333
159061075,2,6,2.0,8,0.25
159065389,8,2,2.0,10,0.2
159079965,2,8,2.0,10,0.2
159099432,2,7,2.0,9,0.2222222222222222
159101948,5,5,5.0,10,0.5
159107051,4,16,4.0,20,0.2
159117564,1,9,1.0,10,0.1
159118543,1,8,1.0,9,0.1111111111111111
159133609,4,5,4.0,9,0.4444444444444444
159141048,3,16,3.0,19,0.15789473684210525
159143783,3,6,3.0,9,0.3333333333333333
159144534,1,9,1.0,10,0.1
159146041,4,16,4.0,20,0.2
159148953,1,18,1.0,19,0.05263157894736842
159158510,4,4,4.0,8,0.5
159202709,1,8,1.0,9,0.1111111111111111
159262840,1,8,1.0,9,0.1111111111111111
159280646,8,2,2.0,10,0.2
159284634,1,9,1.0,10,0.1
159294050,6,2,2.0,8,0.25
159294367,8,2,2.0,10,0.2
159294848,9,1,1.0,10,0.1
159307491,1,19,1.0,20,0.05
159309652,1,9,1.0,10,0.1
159312076,5,5,5.0,10,0.5
159341876,1,9,1.0,10,0.1
159391935,4,6,4.0,10,0.4
159403139,2,8,2.0,10,0.2
159411672,2,8,2.0,10,0.2
159412673,1,9,1.0,10,0.1
159413696,7,3,3.0,10,0.3
159452916,1,8,1.0,9,0.1111111111111111
159455004,3,7,3.0,10,0.3
159473580,6,4,4.0,10,0.4
159491425,1,9,1.0,10,0.1
159491555,1,9,1.0,10,0.1
159493918,9,1,1.0,10,0.1
159494215,5,5,5.0,10,0.5
159494379,2,6,2.0,8,0.25
159516107,5,4,4.0,9,0.4444444444444444
159580249,1,9,1.0,10,0.1
159603455,2,8,2.0,10,0.2
159605360,1,9,1.0,10,0.1
159629300,2,6,2.0,8,0.25
159676138,3,17,3.0,20,0.15
159691062,1,9,1.0,10,0.1
159693566,5,5,5.0,10,0.5
159697642,1,8,1.0,9,0.1111111111111111
159705594,1,17,1.0,18,0.05555555555555555
159731687,1,8,1.0,9,0.1111111111111111
159754706,1,7,1.0,8,0.125
159786493,1,7,1.0,8,0.125
159786893,4,6,4.0,10,0.4
159789505,2,8,2.0,10,0.2
159798299,6,2,2.0,8,0.25
159803534,1,18,1.0,19,0.05263157894736842
159809659,1,18,1.0,19,0.05263157894736842
159826643,7,2,2.0,9,0.2222222222222222
159837172,1,7,1.0,8,0.125
159875164,1,8,1.0,9,0.1111111111111111
159887256,1,9,1.0,10,0.1
159903935,1,8,1.0,9,0.1111111111111111
159915651,2,8,2.0,10,0.2
159915943,7,13,7.0,20,0.35
159938024,8,2,2.0,10,0.2
159968119,9,1,1.0,10,0.1
159968375,5,5,5.0,10,0.5
159968726,7,3,3.0,10,0.3
159987508,2,8,2.0,10,0.2
160018107,3,7,3.0,10,0.3
160033006,5,14,5.0,19,0.2631578947368421
160084293,23,4,4.0,27,0.14814814814814814
160085136,7,3,3.0,10,0.3
160163494,1,8,1.0,9,0.1111111111111111
160167081,1,9,1.0,10,0.1
160171639,2,8,2.0,10,0.2
160195179,5,5,5.0,10,0.5
160198073,1,25,1.0,26,0.038461538461538464
160199839,3,7,3.0,10,0.3
160231668,24,5,5.0,29,0.1724137931034483
160232472,10,16,10.0,26,0.38461538461538464
160237793,1,18,1.0,19,0.05263157894736842
160245794,1,9,1.0,10,0.1
160291056,6,22,6.0,28,0.21428571428571427
160355222,1,18,1.0,19,0.05263157894736842
160355280,9,1,1.0,10,0.1
160356606,9,1,1.0,10,0.1
160356676,1,8,1.0,9,0.1111111111111111
160359787,10,10,10.0,20,0.5
160368931,3,6,3.0,9,0.3333333333333333
160373643,2,17,2.0,19,0.10526315789473684
160395515,3,15,3.0,18,0.16666666666666666
160398981,1,9,1.0,10,0.1
160424245,1,9,1.0,10,0.1
160426503,2,15,2.0,17,0.11764705882352941
160438222,1,9,1.0,10,0.1
160449661,1,9,1.0,10,0.1
160456004,2,7,2.0,9,0.2222222222222222
160466245,2,8,2.0,10,0.2
160476774,1,8,1.0,9,0.1111111111111111
160482296,1,16,1.0,17,0.058823529411764705
160487719,1,18,1.0,19,0.05263157894736842
160489801,4,25,4.0,29,0.13793103448275862
160490727,2,8,2.0,10,0.2
160499104,1,29,1.0,30,0.03333333333333333
160499903,2,8,2.0,10,0.2
160533434,24,5,5.0,29,0.1724137931034483
160533526,2,8,2.0,10,0.2
160546826,4,5,4.0,9,0.4444444444444444
160547744,2,8,2.0,10,0.2
160548114,2,7,2.0,9,0.2222222222222222
160548279,1,9,1.0,10,0.1
160548794,4,5,4.0,9,0.4444444444444444
160549799,1,9,1.0,10,0.1
160551044,4,6,4.0,10,0.4
160562789,1,8,1.0,9,0.1111111111111111
160565150,1,9,1.0,10,0.1
160569346,1,9,1.0,10,0.1
160592853,1,9,1.0,10,0.1
160599754,4,6,4.0,10,0.4
160600325,7,3,3.0,10,0.3
160622441,4,6,4.0,10,0.4
160624545,2,6,2.0,8,0.25
160628831,1,15,1.0,16,0.0625
160634996,5,5,5.0,10,0.5
160635243,2,8,2.0,10,0.2
160649049,5,5,5.0,10,0.5
160658260,2,8,2.0,10,0.2
160666238,1,8,1.0,9,0.1111111111111111
160671176,1,8,1.0,9,0.1111111111111111
160672233,1,9,1.0,10,0.1
160674010,1,9,1.0,10,0.1
160727543,2,8,2.0,10,0.2
160730041,1,18,1.0,19,0.05263157894736842
160731434,7,2,2.0,9,0.2222222222222222
160732855,8,1,1.0,9,0.1111111111111111
160733726,2,7,2.0,9,0.2222222222222222
160742894,1,9,1.0,10,0.1
160744136,1,9,1.0,10,0.1
160796455,9,1,1.0,10,0.1
160796629,1,9,1.0,10,0.1
160809934,7,2,2.0,9,0.2222222222222222
160815862,2,26,2.0,28,0.07142857142857142
160836321,5,5,5.0,10,0.5
160842057,1,9,1.0,10,0.1
160842894,5,5,5.0,10,0.5
160844499,7,2,2.0,9,0.2222222222222222
160903640,4,16,4.0,20,0.2
160925459,1,8,1.0,9,0.1111111111111111
160927056,1,9,1.0,10,0.1
160928406,3,7,3.0,10,0.3
160931314,3,6,3.0,9,0.3333333333333333
160934593,1,19,1.0,20,0.05
160934832,5,15,5.0,20,0.25
160935118,3,7,3.0,10,0.3
160943487,14,13,13.0,27,0.48148148148148145
160945092,22,8,8.0,30,0.26666666666666666
160962414,1,8,1.0,9,0.1111111111111111
160967782,9,1,1.0,10,0.1
160982590,1,17,1.0,18,0.05555555555555555
160984651,1,8,1.0,9,0.1111111111111111
161023070,9,1,1.0,10,0.1
161023806,2,14,2.0,16,0.125
161027639,5,4,4.0,9,0.4444444444444444
161031087,1,8,1.0,9,0.1111111111111111
161031426,3,23,3.0,26,0.11538461538461539
161032526,3,7,3.0,10,0.3
161033206,2,27,2.0,29,0.06896551724137931
161033207,4,4,4.0,8,0.5
161033472,3,6,3.0,9,0.3333333333333333
161033879,3,7,3.0,10,0.3
161034515,4,6,4.0,10,0.4
161036039,5,5,5.0,10,0.5
161044396,1,7,1.0,8,0.125
161052792,2,8,2.0,10,0.2
161057265,1,19,1.0,20,0.05
161071194,3,6,3.0,9,0.3333333333333333
161101008,8,2,2.0,10,0.2
161123473,2,8,2.0,10,0.2
161132936,2,15,2.0,17,0.11764705882352941
161135071,2,8,2.0,10,0.2
161140296,1,9,1.0,10,0.1
161159140,2,18,2.0,20,0.1
161179026,2,6,2.0,8,0.25
161182757,3,7,3.0,10,0.3
161185953,1,18,1.0,19,0.05263157894736842
161190066,3,6,3.0,9,0.3333333333333333
161202279,7,3,3.0,10,0.3
161205258,4,5,4.0,9,0.4444444444444444
161208643,18,11,11.0,29,0.3793103448275862
161219316,1,9,1.0,10,0.1
161228076,9,1,1.0,10,0.1
161235163,7,22,7.0,29,0.2413793103448276
161235702,2,8,2.0,10,0.2
161252963,3,6,3.0,9,0.3333333333333333
161267737,6,2,2.0,8,0.25
161268333,20,10,10.0,30,0.3333333333333333
161269832,1,9,1.0,10,0.1
161294937,2,17,2.0,19,0.10526315789473684
161304691,7,1,1.0,8,0.125
161304851,6,4,4.0,10,0.4
161306750,1,19,1.0,20,0.05
161328424,1,9,1.0,10,0.1
161328444,1,9,1.0,10,0.1
161328992,1,8,1.0,9,0.1111111111111111
161368957,1,7,1.0,8,0.125
161369928,2,18,2.0,20,0.1
161392281,2,17,2.0,19,0.10526315789473684
161392941,5,15,5.0,20,0.25
161399210,2,15,2.0,17,0.11764705882352941
161419665,1,7,1.0,8,0.125
161466322,1,9,1.0,10,0.1
161475392,9,1,1.0,10,0.1
161489219,1,9,1.0,10,0.1
161559726,8,2,2.0,10,0.2
161561004,1,9,1.0,10,0.1
161561316,1,9,1.0,10,0.1
161655679,1,9,1.0,10,0.1
161658787,8,1,1.0,9,0.1111111111111111
161661787,1,17,1.0,18,0.05555555555555555
161709522,6,13,6.0,19,0.3157894736842105
161874599,3,7,3.0,10,0.3
161892959,1,9,1.0,10,0.1
161907547,3,7,3.0,10,0.3
161936308,2,6,2.0,8,0.25
161942959,4,6,4.0,10,0.4
161954147,2,8,2.0,10,0.2
161965132,1,9,1.0,10,0.1
161967687,1,8,1.0,9,0.1111111111111111
161973129,1,8,1.0,9,0.1111111111111111
161982594,1,19,1.0,20,0.05
161991492,7,3,3.0,10,0.3
162022565,1,8,1.0,9,0.1111111111111111
162023488,7,2,2.0,9,0.2222222222222222
162046380,2,17,2.0,19,0.10526315789473684
162062659,3,7,3.0,10,0.3
162099313,1,9,1.0,10,0.1
162161756,9,1,1.0,10,0.1
162165257,1,17,1.0,18,0.05555555555555555
162178341,1,9,1.0,10,0.1
162221445,3,7,3.0,10,0.3
162260489,3,6,3.0,9,0.3333333333333333
162296397,3,7,3.0,10,0.3
162313603,1,18,1.0,19,0.05263157894736842
162327165,1,7,1.0,8,0.125
162334396,2,16,2.0,18,0.1111111111111111
162367937,2,8,2.0,10,0.2
162373020,8,2,2.0,10,0.2
162383810,1,17,1.0,18,0.05555555555555555
162391533,2,8,2.0,10,0.2
162393274,1,9,1.0,10,0.1
162396064,2,8,2.0,10,0.2
162450479,1,8,1.0,9,0.1111111111111111
162450694,1,9,1.0,10,0.1
162498850,5,5,5.0,10,0.5
162501070,3,16,3.0,19,0.15789473684210525
162504476,1,9,1.0,10,0.1
162514907,1,9,1.0,10,0.1
162522336,2,17,2.0,19,0.10526315789473684
162532780,7,20,7.0,27,0.25925925925925924
162550388,6,3,3.0,9,0.3333333333333333
162563051,1,25,1.0,26,0.038461538461538464
162567352,1,18,1.0,19,0.05263157894736842
162575334,1,8,1.0,9,0.1111111111111111
162591458,3,16,3.0,19,0.15789473684210525
162604005,4,6,4.0,10,0.4
162671642,2,8,2.0,10,0.2
162684480,1,9,1.0,10,0.1
162713963,5,5,5.0,10,0.5
162755413,3,17,3.0,20,0.15
162755724,4,6,4.0,10,0.4
162758092,6,3,3.0,9,0.3333333333333333
162760817,8,2,2.0,10,0.2
162779120,5,5,5.0,10,0.5
162821999,1,9,1.0,10,0.1
162853834,1,9,1.0,10,0.1
162858781,1,9,1.0,10,0.1
162880444,1,9,1.0,10,0.1
162890391,1,9,1.0,10,0.1
162898623,2,8,2.0,10,0.2
162900388,1,9,1.0,10,0.1
162915178,1,9,1.0,10,0.1
162920531,4,6,4.0,10,0.4
162922050,4,24,4.0,28,0.14285714285714285
162923883,1,9,1.0,10,0.1
162932593,6,4,4.0,10,0.4
162935290,9,1,1.0,10,0.1
162992830,7,22,7.0,29,0.2413793103448276
163036421,2,8,2.0,10,0.2
163064512,1,17,1.0,18,0.05555555555555555
163073543,6,14,6.0,20,0.3
163103503,1,9,1.0,10,0.1
163132423,1,18,1.0,19,0.05263157894736842
163132632,2,8,2.0,10,0.2
163137599,2,17,2.0,19,0.10526315789473684
163163601,6,12,6.0,18,0.3333333333333333
163165553,9,1,1.0,10,0.1
163167888,6,4,4.0,10,0.4
163168881,1,9,1.0,10,0.1
163172706,4,6,4.0,10,0.4
163191268,1,8,1.0,9,0.1111111111111111
163192302,1,8,1.0,9,0.1111111111111111
163268078,1,8,1.0,9,0.1111111111111111
163274622,1,9,1.0,10,0.1
163308113,1,9,1.0,10,0.1
163341899,2,18,2.0,20,0.1
163350292,1,18,1.0,19,0.05263157894736842
163350879,3,7,3.0,10,0.3
163411017,3,16,3.0,19,0.15789473684210525
163422456,4,6,4.0,10,0.4
163442321,8,1,1.0,9,0.1111111111111111
163444909,2,8,2.0,10,0.2
163481026,1,9,1.0,10,0.1
163482080,1,8,1.0,9,0.1111111111111111
163487795,15,15,15.0,30,0.5
163488197,3,7,3.0,10,0.3
163534601,2,6,2.0,8,0.25
163546777,3,7,3.0,10,0.3
163549723,8,12,8.0,20,0.4
163574524,1,18,1.0,19,0.05263157894736842
163616448,1,9,1.0,10,0.1
163616635,1,8,1.0,9,0.1111111111111111
163620255,4,5,4.0,9,0.4444444444444444
163622313,3,7,3.0,10,0.3
163642032,1,9,1.0,10,0.1
163668837,1,9,1.0,10,0.1
163698166,8,2,2.0,10,0.2
163708351,1,9,1.0,10,0.1
163729795,1,9,1.0,10,0.1
163796281,1,9,1.0,10,0.1
163827235,2,8,2.0,10,0.2
163830576,3,7,3.0,10,0.3
163898077,8,2,2.0,10,0.2
163905351,1,9,1.0,10,0.1
163919835,1,9,1.0,10,0.1
163927166,2,8,2.0,10,0.2
163948264,1,17,1.0,18,0.05555555555555555
163951322,7,2,2.0,9,0.2222222222222222
163966514,2,8,2.0,10,0.2
163973127,1,9,1.0,10,0.1
163975796,2,8,2.0,10,0.2
163982223,7,3,3.0,10,0.3
163997556,3,6,3.0,9,0.3333333333333333
164009010,2,8,2.0,10,0.2
164040722,2,7,2.0,9,0.2222222222222222
164049982,1,9,1.0,10,0.1
164052965,3,7,3.0,10,0.3
164071062,1,18,1.0,19,0.05263157894736842
164080612,1,9,1.0,10,0.1
164093819,5,5,5.0,10,0.5
164108853,2,7,2.0,9,0.2222222222222222
164109915,2,17,2.0,19,0.10526315789473684
164115876,2,8,2.0,10,0.2
164116334,1,19,1.0,20,0.05
164127612,2,7,2.0,9,0.2222222222222222
164162770,2,7,2.0,9,0.2222222222222222
164171595,1,9,1.0,10,0.1
164192494,1,9,1.0,10,0.1
164194142,7,2,2.0,9,0.2222222222222222
164236973,2,8,2.0,10,0.2
164274577,7,23,7.0,30,0.23333333333333334
164277795,2,8,2.0,10,0.2
164280207,1,19,1.0,20,0.05
164286771,2,7,2.0,9,0.2222222222222222
164296281,4,6,4.0,10,0.4
164345866,1,9,1.0,10,0.1
164347057,6,4,4.0,10,0.4
164347157,9,1,1.0,10,0.1
164347829,8,2,2.0,10,0.2
164354972,1,9,1.0,10,0.1
164365054,1,8,1.0,9,0.1111111111111111
164380679,1,8,1.0,9,0.1111111111111111
164381096,2,8,2.0,10,0.2
164386362,2,18,2.0,20,0.1
164430623,3,7,3.0,10,0.3
164447158,4,6,4.0,10,0.4
164448092,2,6,2.0,8,0.25
164448116,3,6,3.0,9,0.3333333333333333
164448428,3,7,3.0,10,0.3
164449323,3,7,3.0,10,0.3
164450362,1,7,1.0,8,0.125
164451552,1,9,1.0,10,0.1
164452747,1,9,1.0,10,0.1
164457460,5,5,5.0,10,0.5
164464006,2,8,2.0,10,0.2
164465334,1,8,1.0,9,0.1111111111111111
164465507,1,9,1.0,10,0.1
164466112,1,7,1.0,8,0.125
164484834,1,8,1.0,9,0.1111111111111111
164486287,3,24,3.0,27,0.1111111111111111
164490880,1,9,1.0,10,0.1
164496648,2,8,2.0,10,0.2
164517226,28,2,2.0,30,0.06666666666666667
164518903,6,2,2.0,8,0.25
164520513,6,4,4.0,10,0.4
164557546,4,16,4.0,20,0.2
164618177,5,13,5.0,18,0.2777777777777778
164618395,1,9,1.0,10,0.1
164620340,4,6,4.0,10,0.4
164646732,3,7,3.0,10,0.3
164690178,1,8,1.0,9,0.1111111111111111
164692401,1,8,1.0,9,0.1111111111111111
164695538,6,4,4.0,10,0.4
164698804,3,6,3.0,9,0.3333333333333333
164723096,1,9,1.0,10,0.1
164738994,2,16,2.0,18,0.1111111111111111
164746014,2,7,2.0,9,0.2222222222222222
164748451,1,9,1.0,10,0.1
164754937,3,7,3.0,10,0.3
164792506,7,2,2.0,9,0.2222222222222222
164793423,2,8,2.0,10,0.2
164794799,4,6,4.0,10,0.4
164795955,5,12,5.0,17,0.29411764705882354
164797922,4,6,4.0,10,0.4
164813103,5,23,5.0,28,0.17857142857142858
164814312,4,6,4.0,10,0.4
164821495,9,1,1.0,10,0.1
164829255,1,9,1.0,10,0.1
164871189,3,6,3.0,9,0.3333333333333333
164893265,1,8,1.0,9,0.1111111111111111
164913892,8,1,1.0,9,0.1111111111111111
164914862,3,7,3.0,10,0.3
164953842,1,17,1.0,18,0.05555555555555555
164976295,1,27,1.0,28,0.03571428571428571
165021730,4,6,4.0,10,0.4
165083308,1,18,1.0,19,0.05263157894736842
165090433,1,18,1.0,19,0.05263157894736842
165095578,1,9,1.0,10,0.1
165115398,1,18,1.0,19,0.05263157894736842
165119359,3,17,3.0,20,0.15
165122484,2,6,2.0,8,0.25
165127364,1,18,1.0,19,0.05263157894736842
165169789,6,4,4.0,10,0.4
165179531,2,8,2.0,10,0.2
165206280,2,8,2.0,10,0.2
165210195,1,9,1.0,10,0.1
165215461,2,7,2.0,9,0.2222222222222222
165217753,5,5,5.0,10,0.5
165232763,7,2,2.0,9,0.2222222222222222
165233460,14,13,13.0,27,0.48148148148148145
165234832,1,8,1.0,9,0.1111111111111111
165274030,1,9,1.0,10,0.1
165290449,1,8,1.0,9,0.1111111111111111
165291727,5,5,5.0,10,0.5
165314017,7,2,2.0,9,0.2222222222222222
165332115,1,9,1.0,10,0.1
165340351,1,9,1.0,10,0.1
165349762,2,8,2.0,10,0.2
165355638,1,19,1.0,20,0.05
165365330,1,9,1.0,10,0.1
165382505,1,9,1.0,10,0.1
165392035,2,8,2.0,10,0.2
165450452,2,8,2.0,10,0.2
165451768,5,4,4.0,9,0.4444444444444444
165466265,1,17,1.0,18,0.05555555555555555
165482120,2,7,2.0,9,0.2222222222222222
165503369,2,8,2.0,10,0.2
165510109,1,9,1.0,10,0.1
165522411,1,9,1.0,10,0.1
165526084,1,19,1.0,20,0.05
165528970,1,9,1.0,10,0.1
165553837,6,3,3.0,9,0.3333333333333333
165555811,3,17,3.0,20,0.15
165558017,2,8,2.0,10,0.2
165571275,2,17,2.0,19,0.10526315789473684
165581647,2,8,2.0,10,0.2
165590268,1,9,1.0,10,0.1
165612336,4,6,4.0,10,0.4
165622508,1,17,1.0,18,0.05555555555555555
165657164,1,9,1.0,10,0.1
165679828,1,19,1.0,20,0.05
165695294,1,8,1.0,9,0.1111111111111111
165696641,3,7,3.0,10,0.3
165698263,1,9,1.0,10,0.1
165699538,4,6,4.0,10,0.4
165719905,2,8,2.0,10,0.2
165765114,10,19,10.0,29,0.3448275862068966
165792189,2,8,2.0,10,0.2
165792355,1,7,1.0,8,0.125
165799634,1,19,1.0,20,0.05
165800188,3,7,3.0,10,0.3
165848159,1,8,1.0,9,0.1111111111111111
165872591,4,6,4.0,10,0.4
165873275,8,20,8.0,28,0.2857142857142857
165880007,2,8,2.0,10,0.2
165882029,1,9,1.0,10,0.1
165922311,3,6,3.0,9,0.3333333333333333
165924687,1,16,1.0,17,0.058823529411764705
165932424,1,29,1.0,30,0.03333333333333333
165953228,2,7,2.0,9,0.2222222222222222
165979488,4,5,4.0,9,0.4444444444444444
165982480,5,5,5.0,10,0.5
165989313,2,7,2.0,9,0.2222222222222222
165989772,8,9,8.0,17,0.47058823529411764
165999477,2,8,2.0,10,0.2
166004018,2,7,2.0,9,0.2222222222222222
166008859,8,2,2.0,10,0.2
166016455,1,8,1.0,9,0.1111111111111111
166024014,6,3,3.0,9,0.3333333333333333
166037645,1,9,1.0,10,0.1
166058602,2,8,2.0,10,0.2
166062090,2,16,2.0,18,0.1111111111111111
166073819,7,10,7.0,17,0.4117647058823529
166075409,7,3,3.0,10,0.3
166082094,2,6,2.0,8,0.25
166082732,1,9,1.0,10,0.1
166090508,1,9,1.0,10,0.1
166092543,8,8,8.0,16,0.5
166093395,3,7,3.0,10,0.3
166099110,2,8,2.0,10,0.2
166108767,5,5,5.0,10,0.5
166121433,1,8,1.0,9,0.1111111111111111
166121572,2,8,2.0,10,0.2
166122158,1,9,1.0,10,0.1
166123006,3,7,3.0,10,0.3
166123546,3,7,3.0,10,0.3
166128115,3,7,3.0,10,0.3
166179839,1,9,1.0,10,0.1
166197749,1,18,1.0,19,0.05263157894736842
166208262,1,17,1.0,18,0.05555555555555555
166227997,2,7,2.0,9,0.2222222222222222
166228593,5,4,4.0,9,0.4444444444444444
166229271,3,7,3.0,10,0.3
166230861,3,27,3.0,30,0.1
166231531,2,8,2.0,10,0.2
166232079,1,9,1.0,10,0.1
166252557,1,9,1.0,10,0.1
166260032,9,1,1.0,10,0.1
166260168,6,4,4.0,10,0.4
166261468,6,4,4.0,10,0.4
166263065,5,4,4.0,9,0.4444444444444444
166274756,1,17,1.0,18,0.05555555555555555
166291579,6,4,4.0,10,0.4
166292573,2,8,2.0,10,0.2
166294546,5,3,3.0,8,0.375
166295188,9,1,1.0,10,0.1
166296154,2,8,2.0,10,0.2
166304114,2,6,2.0,8,0.25
166305271,2,7,2.0,9,0.2222222222222222
166316501,4,5,4.0,9,0.4444444444444444
166320051,3,7,3.0,10,0.3
166327675,4,5,4.0,9,0.4444444444444444
166328471,4,5,4.0,9,0.4444444444444444
166342865,3,7,3.0,10,0.3
166360697,1,8,1.0,9,0.1111111111111111
166378390,6,4,4.0,10,0.4
166398422,3,7,3.0,10,0.3
166401753,1,9,1.0,10,0.1
166413500,1,9,1.0,10,0.1
166424696,2,8,2.0,10,0.2
166428550,3,6,3.0,9,0.3333333333333333
166451606,3,6,3.0,9,0.3333333333333333
166463626,1,9,1.0,10,0.1
166467437,1,8,1.0,9,0.1111111111111111
166468470,2,8,2.0,10,0.2
166479409,1,18,1.0,19,0.05263157894736842
166482445,1,9,1.0,10,0.1
166504999,1,9,1.0,10,0.1
166517792,1,9,1.0,10,0.1
166532604,2,8,2.0,10,0.2
166551455,9,1,1.0,10,0.1
166557601,1,8,1.0,9,0.1111111111111111
166569797,3,17,3.0,20,0.15
166574298,1,9,1.0,10,0.1
166625308,3,15,3.0,18,0.16666666666666666
166644224,2,8,2.0,10,0.2
166644299,2,8,2.0,10,0.2
166647147,8,1,1.0,9,0.1111111111111111
166647472,1,8,1.0,9,0.1111111111111111
166652658,1,9,1.0,10,0.1
166655603,1,19,1.0,20,0.05
166670345,3,7,3.0,10,0.3
166684133,6,4,4.0,10,0.4
166684285,3,6,3.0,9,0.3333333333333333
166684740,3,6,3.0,9,0.3333333333333333
166685099,4,6,4.0,10,0.4
166686278,1,9,1.0,10,0.1
166691557,1,9,1.0,10,0.1
166695604,3,15,3.0,18,0.16666666666666666
166700625,2,18,2.0,20,0.1
166701704,4,6,4.0,10,0.4
166771282,2,8,2.0,10,0.2
166771475,1,9,1.0,10,0.1
166789101,2,7,2.0,9,0.2222222222222222
166792478,1,9,1.0,10,0.1
166792951,3,6,3.0,9,0.3333333333333333
166841617,1,9,1.0,10,0.1
166845049,1,9,1.0,10,0.1
166851881,3,16,3.0,19,0.15789473684210525
166859659,5,4,4.0,9,0.4444444444444444
166867428,5,5,5.0,10,0.5
166872476,1,8,1.0,9,0.1111111111111111
166880533,2,8,2.0,10,0.2
166887215,3,6,3.0,9,0.3333333333333333
166887690,2,7,2.0,9,0.2222222222222222
166888846,5,5,5.0,10,0.5
166889822,2,6,2.0,8,0.25
166892131,2,7,2.0,9,0.2222222222222222
166892784,1,9,1.0,10,0.1
166899229,6,14,6.0,20,0.3
166901696,3,15,3.0,18,0.16666666666666666
166911999,4,5,4.0,9,0.4444444444444444
166920951,2,7,2.0,9,0.2222222222222222
166928816,2,8,2.0,10,0.2
166953137,2,7,2.0,9,0.2222222222222222
166979923,2,8,2.0,10,0.2
166988908,1,9,1.0,10,0.1
167009597,1,19,1.0,20,0.05
167012204,6,4,4.0,10,0.4
167021237,2,8,2.0,10,0.2
167053945,2,6,2.0,8,0.25
167054290,1,8,1.0,9,0.1111111111111111
167057053,1,7,1.0,8,0.125
167074295,1,9,1.0,10,0.1
167118149,8,2,2.0,10,0.2
167157362,3,7,3.0,10,0.3
167170012,2,8,2.0,10,0.2
167182530,2,8,2.0,10,0.2
167206548,5,13,5.0,18,0.2777777777777778
167236868,5,3,3.0,8,0.375
167242181,1,9,1.0,10,0.1
167276649,2,8,2.0,10,0.2
167277831,1,17,1.0,18,0.05555555555555555
167286778,1,9,1.0,10,0.1
167297942,2,17,2.0,19,0.10526315789473684
167299691,1,19,1.0,20,0.05
167300215,2,7,2.0,9,0.2222222222222222
167312385,1,27,1.0,28,0.03571428571428571
167317977,3,26,3.0,29,0.10344827586206896
167318391,5,5,5.0,10,0.5
167323446,1,9,1.0,10,0.1
167343997,8,2,2.0,10,0.2
167346751,4,5,4.0,9,0.4444444444444444
167347154,4,25,4.0,29,0.13793103448275862
167347545,3,7,3.0,10,0.3
167355626,1,8,1.0,9,0.1111111111111111
167358258,7,13,7.0,20,0.35
167364304,1,9,1.0,10,0.1
167400797,1,7,1.0,8,0.125
167430936,1,19,1.0,20,0.05
167453016,1,9,1.0,10,0.1
167487827,1,9,1.0,10,0.1
167494636,2,7,2.0,9,0.2222222222222222
167496871,4,6,4.0,10,0.4
167502627,3,7,3.0,10,0.3
167506721,8,2,2.0,10,0.2
167507589,4,6,4.0,10,0.4
167517069,1,16,1.0,17,0.058823529411764705
167521129,1,9,1.0,10,0.1
167528260,3,6,3.0,9,0.3333333333333333
167528549,3,7,3.0,10,0.3
167528861,7,3,3.0,10,0.3
167534152,8,2,2.0,10,0.2
167551573,13,15,13.0,28,0.4642857142857143
167552505,2,8,2.0,10,0.2
167553055,1,9,1.0,10,0.1
167553743,7,3,3.0,10,0.3
167563218,1,9,1.0,10,0.1
167565889,1,8,1.0,9,0.1111111111111111
167571373,2,8,2.0,10,0.2
167603959,2,17,2.0,19,0.10526315789473684
167621938,1,9,1.0,10,0.1
167629041,8,1,1.0,9,0.1111111111111111
167648703,5,5,5.0,10,0.5
167651346,1,18,1.0,19,0.05263157894736842
167667941,4,6,4.0,10,0.4
167672553,1,7,1.0,8,0.125
167679099,1,17,1.0,18,0.05555555555555555
167681937,4,5,4.0,9,0.4444444444444444
167682270,6,3,3.0,9,0.3333333333333333
167687612,2,18,2.0,20,0.1
167697617,3,6,3.0,9,0.3333333333333333
167718544,4,5,4.0,9,0.4444444444444444
167736866,3,7,3.0,10,0.3
167746455,1,8,1.0,9,0.1111111111111111
167746898,4,4,4.0,8,0.5
167757543,2,7,2.0,9,0.2222222222222222
167773072,1,9,1.0,10,0.1
167780912,2,8,2.0,10,0.2
167798550,1,9,1.0,10,0.1
167814206,6,4,4.0,10,0.4
167815130,2,8,2.0,10,0.2
167847741,6,3,3.0,9,0.3333333333333333
167847816,1,16,1.0,17,0.058823529411764705
167850999,1,9,1.0,10,0.1
167852748,1,17,1.0,18,0.05555555555555555
167864330,3,6,3.0,9,0.3333333333333333
167874062,6,4,4.0,10,0.4
167912543,1,8,1.0,9,0.1111111111111111
167922186,1,18,1.0,19,0.05263157894736842
167935964,1,19,1.0,20,0.05
167938857,4,6,4.0,10,0.4
167963350,6,2,2.0,8,0.25
167985747,1,7,1.0,8,0.125
168015044,2,7,2.0,9,0.2222222222222222
168028875,1,9,1.0,10,0.1
168063038,1,19,1.0,20,0.05
168089297,3,6,3.0,9,0.3333333333333333
168123637,1,19,1.0,20,0.05
168150397,1,7,1.0,8,0.125
168162633,1,28,1.0,29,0.034482758620689655
168167186,1,8,1.0,9,0.1111111111111111
168167646,2,7,2.0,9,0.2222222222222222
168177600,1,8,1.0,9,0.1111111111111111
168181964,2,8,2.0,10,0.2
168186582,1,8,1.0,9,0.1111111111111111
168188958,1,8,1.0,9,0.1111111111111111
168205210,1,8,1.0,9,0.1111111111111111
168207070,1,29,1.0,30,0.03333333333333333
168207158,2,8,2.0,10,0.2
168213745,8,2,2.0,10,0.2
168214178,1,8,1.0,9,0.1111111111111111
168216831,6,4,4.0,10,0.4
168217340,7,1,1.0,8,0.125
168219992,1,9,1.0,10,0.1
168226071,1,9,1.0,10,0.1
168226462,1,9,1.0,10,0.1
168251288,1,9,1.0,10,0.1
168256136,3,7,3.0,10,0.3
168289401,2,27,2.0,29,0.06896551724137931
168298016,1,19,1.0,20,0.05
168304058,5,15,5.0,20,0.25
168307891,1,17,1.0,18,0.05555555555555555
168321313,1,8,1.0,9,0.1111111111111111
168323076,1,8,1.0,9,0.1111111111111111
168371980,1,9,1.0,10,0.1
168380539,1,18,1.0,19,0.05263157894736842
168386326,1,19,1.0,20,0.05
168403843,4,25,4.0,29,0.13793103448275862
168405165,21,6,6.0,27,0.2222222222222222
168406028,9,1,1.0,10,0.1
168406543,1,18,1.0,19,0.05263157894736842
168413838,5,5,5.0,10,0.5
168438110,1,9,1.0,10,0.1
168440141,1,9,1.0,10,0.1
168446770,1,8,1.0,9,0.1111111111111111
168448575,3,6,3.0,9,0.3333333333333333
168456911,2,7,2.0,9,0.2222222222222222
168488280,1,9,1.0,10,0.1
168500982,5,4,4.0,9,0.4444444444444444
168501708,4,6,4.0,10,0.4
168503659,1,19,1.0,20,0.05
168512287,2,8,2.0,10,0.2
168518398,7,3,3.0,10,0.3
168522637,4,6,4.0,10,0.4
168525051,8,11,8.0,19,0.42105263157894735
168531086,19,9,9.0,28,0.32142857142857145
168532734,3,7,3.0,10,0.3
168541319,19,1,1.0,20,0.05
168541700,6,3,3.0,9,0.3333333333333333
168549602,3,7,3.0,10,0.3
168579633,5,4,4.0,9,0.4444444444444444
168585742,1,8,1.0,9,0.1111111111111111
168592319,2,8,2.0,10,0.2
168604498,1,9,1.0,10,0.1
168604672,1,9,1.0,10,0.1
168605357,2,8,2.0,10,0.2
168606456,1,9,1.0,10,0.1
168613190,4,6,4.0,10,0.4
168613401,3,7,3.0,10,0.3
168620161,1,9,1.0,10,0.1
168621822,7,3,3.0,10,0.3
168624650,3,6,3.0,9,0.3333333333333333
168625739,1,9,1.0,10,0.1
168626469,2,7,2.0,9,0.2222222222222222
168627726,3,6,3.0,9,0.3333333333333333
168631585,3,7,3.0,10,0.3
168632672,5,4,4.0,9,0.4444444444444444
168636846,1,9,1.0,10,0.1
168652051,1,18,1.0,19,0.05263157894736842
168665082,6,4,4.0,10,0.4
168666290,4,5,4.0,9,0.4444444444444444
168666764,2,7,2.0,9,0.2222222222222222
168668295,1,9,1.0,10,0.1
168674385,1,9,1.0,10,0.1
168679651,1,9,1.0,10,0.1
168697751,2,17,2.0,19,0.10526315789473684
168704605,4,16,4.0,20,0.2
168706690,3,6,3.0,9,0.3333333333333333
168709585,3,6,3.0,9,0.3333333333333333
168710427,1,8,1.0,9,0.1111111111111111
168712065,18,1,1.0,19,0.05263157894736842
168712183,18,2,2.0,20,0.1
168712456,4,14,4.0,18,0.2222222222222222
168714286,1,9,1.0,10,0.1
168714498,1,9,1.0,10,0.1
168715948,1,8,1.0,9,0.1111111111111111
168722373,1,8,1.0,9,0.1111111111111111
168732370,1,9,1.0,10,0.1
168744288,2,7,2.0,9,0.2222222222222222
168761817,1,9,1.0,10,0.1
168779317,1,7,1.0,8,0.125
168779792,6,22,6.0,28,0.21428571428571427
168784294,1,18,1.0,19,0.05263157894736842
168784453,1,7,1.0,8,0.125
168784812,1,9,1.0,10,0.1
168790271,8,2,2.0,10,0.2
168790337,1,7,1.0,8,0.125
168824682,1,7,1.0,8,0.125
168835589,4,5,4.0,9,0.4444444444444444
168852182,1,9,1.0,10,0.1
168855580,2,8,2.0,10,0.2
168857780,10,10,10.0,20,0.5
168861940,15,4,4.0,19,0.21052631578947367
168862385,1,9,1.0,10,0.1
168862937,3,7,3.0,10,0.3
168864429,7,3,3.0,10,0.3
168867285,3,7,3.0,10,0.3
168870782,3,25,3.0,28,0.10714285714285714
168902812,6,2,2.0,8,0.25
168926595,5,5,5.0,10,0.5
168927377,5,4,4.0,9,0.4444444444444444
168927940,5,4,4.0,9,0.4444444444444444
168931822,12,15,12.0,27,0.4444444444444444
168935039,2,8,2.0,10,0.2
168936338,1,8,1.0,9,0.1111111111111111
168937991,2,8,2.0,10,0.2
168962243,1,27,1.0,28,0.03571428571428571
168963336,1,8,1.0,9,0.1111111111111111
169005453,9,1,1.0,10,0.1
169009783,2,26,2.0,28,0.07142857142857142
169013826,1,9,1.0,10,0.1
169031493,2,8,2.0,10,0.2
169032610,1,8,1.0,9,0.1111111111111111
169033190,2,8,2.0,10,0.2
169034171,4,5,4.0,9,0.4444444444444444
169034190,2,8,2.0,10,0.2
169046363,2,7,2.0,9,0.2222222222222222
169050158,24,2,2.0,26,0.07692307692307693
169054131,6,2,2.0,8,0.25
169058071,1,9,1.0,10,0.1
169092724,2,8,2.0,10,0.2
169096961,1,9,1.0,10,0.1
169100952,1,7,1.0,8,0.125
169105935,2,7,2.0,9,0.2222222222222222
169107582,1,8,1.0,9,0.1111111111111111
169117776,1,8,1.0,9,0.1111111111111111
169137847,1,9,1.0,10,0.1
169140648,1,9,1.0,10,0.1
169143409,1,9,1.0,10,0.1
169159221,2,8,2.0,10,0.2
169173077,2,8,2.0,10,0.2
169180504,1,9,1.0,10,0.1
169181098,1,9,1.0,10,0.1
169181406,4,6,4.0,10,0.4
169202806,1,19,1.0,20,0.05
169207616,3,7,3.0,10,0.3
169207826,1,19,1.0,20,0.05
169209538,2,8,2.0,10,0.2
169210489,3,7,3.0,10,0.3
169211822,5,5,5.0,10,0.5
169212242,1,8,1.0,9,0.1111111111111111
169213212,4,16,4.0,20,0.2
169213881,1,8,1.0,9,0.1111111111111111
169220213,4,6,4.0,10,0.4
169221216,6,4,4.0,10,0.4
169224316,3,6,3.0,9,0.3333333333333333
169236422,1,9,1.0,10,0.1
169240165,9,1,1.0,10,0.1
169241053,2,8,2.0,10,0.2
169245099,1,9,1.0,10,0.1
169259811,1,8,1.0,9,0.1111111111111111
169264321,1,19,1.0,20,0.05
169266883,1,7,1.0,8,0.125
169267295,2,8,2.0,10,0.2
169267844,5,5,5.0,10,0.5
169268307,5,4,4.0,9,0.4444444444444444
169269597,2,7,2.0,9,0.2222222222222222
169272099,3,7,3.0,10,0.3
169276583,5,5,5.0,10,0.5
169279021,1,9,1.0,10,0.1
169279837,3,7,3.0,10,0.3
169280174,1,9,1.0,10,0.1
169280381,4,6,4.0,10,0.4
169295799,3,6,3.0,9,0.3333333333333333
169296380,5,4,4.0,9,0.4444444444444444
169296394,2,18,2.0,20,0.1
169296863,2,27,2.0,29,0.06896551724137931
169298336,2,7,2.0,9,0.2222222222222222
169324960,2,7,2.0,9,0.2222222222222222
169325016,1,9,1.0,10,0.1
169328384,1,9,1.0,10,0.1
169342186,1,9,1.0,10,0.1
169342897,1,9,1.0,10,0.1
169348440,2,8,2.0,10,0.2
169357507,1,8,1.0,9,0.1111111111111111
169364841,1,7,1.0,8,0.125
169370232,2,8,2.0,10,0.2
169391965,1,9,1.0,10,0.1
169397287,1,8,1.0,9,0.1111111111111111
169414226,1,9,1.0,10,0.1
169415502,2,8,2.0,10,0.2
169422929,1,8,1.0,9,0.1111111111111111
169457663,1,9,1.0,10,0.1
169468448,2,8,2.0,10,0.2
169472137,3,7,3.0,10,0.3
169473685,1,7,1.0,8,0.125
169481973,4,6,4.0,10,0.4
169538474,2,8,2.0,10,0.2
169538827,5,4,4.0,9,0.4444444444444444
169545601,1,8,1.0,9,0.1111111111111111
169551574,1,9,1.0,10,0.1
169552771,2,18,2.0,20,0.1
169554385,2,8,2.0,10,0.2
169563697,1,18,1.0,19,0.05263157894736842
169566210,7,2,2.0,9,0.2222222222222222
169576484,3,7,3.0,10,0.3
169579859,4,5,4.0,9,0.4444444444444444
169580699,5,5,5.0,10,0.5
169587732,2,8,2.0,10,0.2
169588327,3,7,3.0,10,0.3
169588739,4,6,4.0,10,0.4
169591085,1,8,1.0,9,0.1111111111111111
169636751,1,18,1.0,19,0.05263157894736842
169656411,2,8,2.0,10,0.2
169656596,3,6,3.0,9,0.3333333333333333
169671815,2,6,2.0,8,0.25
169744518,1,8,1.0,9,0.1111111111111111
169751457,2,8,2.0,10,0.2
169751828,2,8,2.0,10,0.2
169753005,4,6,4.0,10,0.4
169767239,1,9,1.0,10,0.1
169807323,4,6,4.0,10,0.4
169809737,3,6,3.0,9,0.3333333333333333
169810717,2,7,2.0,9,0.2222222222222222
169812886,1,8,1.0,9,0.1111111111111111
169824780,1,9,1.0,10,0.1
169841090,1,8,1.0,9,0.1111111111111111
169856806,2,6,2.0,8,0.25
169864487,1,7,1.0,8,0.125
169865227,2,28,2.0,30,0.06666666666666667
169868708,2,8,2.0,10,0.2
169881760,21,7,7.0,28,0.25
169889471,3,7,3.0,10,0.3
169896965,1,18,1.0,19,0.05263157894736842
169908909,1,9,1.0,10,0.1
169918169,3,16,3.0,19,0.15789473684210525
169935852,24,6,6.0,30,0.2
169944389,24,5,5.0,29,0.1724137931034483
169945180,2,8,2.0,10,0.2
169946626,1,8,1.0,9,0.1111111111111111
169952157,3,26,3.0,29,0.10344827586206896
169972370,1,9,1.0,10,0.1
169974098,8,2,2.0,10,0.2
169975416,1,9,1.0,10,0.1
169982885,2,8,2.0,10,0.2
169983484,7,12,7.0,19,0.3684210526315789
170002188,2,7,2.0,9,0.2222222222222222
170005411,3,6,3.0,9,0.3333333333333333
170050643,1,8,1.0,9,0.1111111111111111
170066297,1,9,1.0,10,0.1
170073585,18,7,7.0,25,0.28
170074942,9,1,1.0,10,0.1
170077760,4,5,4.0,9,0.4444444444444444
170102094,6,13,6.0,19,0.3157894736842105
170104504,4,5,4.0,9,0.4444444444444444
170109196,3,7,3.0,10,0.3
170120730,3,7,3.0,10,0.3
170120949,1,7,1.0,8,0.125
170125995,2,8,2.0,10,0.2
170147889,1,9,1.0,10,0.1
170155799,1,9,1.0,10,0.1
170163054,3,6,3.0,9,0.3333333333333333
170167704,17,12,12.0,29,0.41379310344827586
170176098,7,2,2.0,9,0.2222222222222222
170187945,3,6,3.0,9,0.3333333333333333
170200597,2,8,2.0,10,0.2
170207766,1,7,1.0,8,0.125
170213490,1,19,1.0,20,0.05
170225516,8,2,2.0,10,0.2
170231583,6,14,6.0,20,0.3
170232091,1,8,1.0,9,0.1111111111111111
170242573,2,7,2.0,9,0.2222222222222222
170249243,2,8,2.0,10,0.2
170260525,4,6,4.0,10,0.4
170263089,6,4,4.0,10,0.4
170264727,5,5,5.0,10,0.5
170285946,2,7,2.0,9,0.2222222222222222
170291632,7,3,3.0,10,0.3
170297172,1,19,1.0,20,0.05
170299366,2,25,2.0,27,0.07407407407407407
170300346,1,9,1.0,10,0.1
170301676,1,28,1.0,29,0.034482758620689655
170309274,2,6,2.0,8,0.25
170309510,2,8,2.0,10,0.2
170332401,1,8,1.0,9,0.1111111111111111
170338400,3,7,3.0,10,0.3
170339425,1,9,1.0,10,0.1
170363474,5,5,5.0,10,0.5
170384759,2,8,2.0,10,0.2
170385615,2,8,2.0,10,0.2
170396843,4,6,4.0,10,0.4
170396876,2,7,2.0,9,0.2222222222222222
170400991,2,6,2.0,8,0.25
170403308,2,8,2.0,10,0.2
170414637,3,7,3.0,10,0.3
170417484,3,26,3.0,29,0.10344827586206896
170425100,1,8,1.0,9,0.1111111111111111
170426740,1,19,1.0,20,0.05
170446478,2,8,2.0,10,0.2
170455000,1,19,1.0,20,0.05
170473556,1,8,1.0,9,0.1111111111111111
170483260,4,15,4.0,19,0.21052631578947367
170500312,2,27,2.0,29,0.06896551724137931
170500445,1,7,1.0,8,0.125
170505717,1,19,1.0,20,0.05
170519342,6,23,6.0,29,0.20689655172413793
170519629,1,8,1.0,9,0.1111111111111111
170521525,1,9,1.0,10,0.1
170526253,1,9,1.0,10,0.1
170550387,1,9,1.0,10,0.1
170552121,5,5,5.0,10,0.5
170557163,1,9,1.0,10,0.1
170581187,4,6,4.0,10,0.4
170601746,1,9,1.0,10,0.1
170610161,2,7,2.0,9,0.2222222222222222
170619215,3,6,3.0,9,0.3333333333333333
170619836,4,25,4.0,29,0.13793103448275862
170623807,2,8,2.0,10,0.2
170646553,1,9,1.0,10,0.1
170684194,1,9,1.0,10,0.1
170716186,1,8,1.0,9,0.1111111111111111
170722283,8,20,8.0,28,0.2857142857142857
170731738,2,28,2.0,30,0.06666666666666667
170740598,1,9,1.0,10,0.1
170746170,1,9,1.0,10,0.1
170786939,5,5,5.0,10,0.5
170788297,1,9,1.0,10,0.1
170799531,2,18,2.0,20,0.1
170799828,6,4,4.0,10,0.4
170808899,2,8,2.0,10,0.2
170826185,5,5,5.0,10,0.5
170834271,1,9,1.0,10,0.1
170838596,9,1,1.0,10,0.1
170841366,27,1,1.0,28,0.03571428571428571
170857974,2,16,2.0,18,0.1111111111111111
170866602,8,2,2.0,10,0.2
170886743,7,2,2.0,9,0.2222222222222222
170893540,1,7,1.0,8,0.125
170923704,8,21,8.0,29,0.27586206896551724
170925039,1,9,1.0,10,0.1
170930146,1,8,1.0,9,0.1111111111111111
170942326,1,9,1.0,10,0.1
170948229,2,8,2.0,10,0.2
170949354,8,2,2.0,10,0.2
170955851,3,16,3.0,19,0.15789473684210525
170972515,14,5,5.0,19,0.2631578947368421
170972711,1,8,1.0,9,0.1111111111111111
170973410,1,7,1.0,8,0.125
170994011,3,7,3.0,10,0.3
170995220,1,17,1.0,18,0.05555555555555555
171025297,1,7,1.0,8,0.125
171033623,1,18,1.0,19,0.05263157894736842
171036132,4,6,4.0,10,0.4
171037705,19,1,1.0,20,0.05
171055152,1,9,1.0,10,0.1
171078096,1,19,1.0,20,0.05
171110371,7,2,2.0,9,0.2222222222222222
171114508,1,8,1.0,9,0.1111111111111111
171121470,1,9,1.0,10,0.1
171128128,3,7,3.0,10,0.3
171130267,2,18,2.0,20,0.1
171145799,26,2,2.0,28,0.07142857142857142
171152429,2,7,2.0,9,0.2222222222222222
171172734,2,8,2.0,10,0.2
171235727,5,13,5.0,18,0.2777777777777778
171249865,1,9,1.0,10,0.1
171251397,5,5,5.0,10,0.5
171259221,2,7,2.0,9,0.2222222222222222
171260031,1,8,1.0,9,0.1111111111111111
171266439,1,9,1.0,10,0.1
171271825,2,7,2.0,9,0.2222222222222222
171287800,1,7,1.0,8,0.125
171293050,5,5,5.0,10,0.5
171293735,8,1,1.0,9,0.1111111111111111
171294630,2,8,2.0,10,0.2
171295346,3,5,3.0,8,0.375
171295477,5,5,5.0,10,0.5
171313625,1,9,1.0,10,0.1
171323637,8,2,2.0,10,0.2
171324158,8,2,2.0,10,0.2
171332543,4,6,4.0,10,0.4
171333904,6,4,4.0,10,0.4
171337006,3,7,3.0,10,0.3
171369002,2,7,2.0,9,0.2222222222222222
171369707,2,8,2.0,10,0.2
171370633,7,2,2.0,9,0.2222222222222222
171370935,5,4,4.0,9,0.4444444444444444
171373407,1,9,1.0,10,0.1
171374241,5,5,5.0,10,0.5
171374863,3,5,3.0,8,0.375
171375424,6,4,4.0,10,0.4
171375578,6,3,3.0,9,0.3333333333333333
171376168,3,6,3.0,9,0.3333333333333333
171376320,2,8,2.0,10,0.2
171376561,9,18,9.0,27,0.3333333333333333
171379389,21,6,6.0,27,0.2222222222222222
171385113,1,9,1.0,10,0.1
171385708,3,7,3.0,10,0.3
171391676,1,9,1.0,10,0.1
171392005,8,18,8.0,26,0.3076923076923077
171392833,1,8,1.0,9,0.1111111111111111
171392963,2,7,2.0,9,0.2222222222222222
171393050,3,7,3.0,10,0.3
171393592,3,5,3.0,8,0.375
171393669,2,8,2.0,10,0.2
171393789,1,19,1.0,20,0.05
171394709,3,6,3.0,9,0.3333333333333333
171395738,3,27,3.0,30,0.1
171397267,6,4,4.0,10,0.4
171442240,2,17,2.0,19,0.10526315789473684
171461907,7,3,3.0,10,0.3
171472565,7,23,7.0,30,0.23333333333333334
171480059,2,8,2.0,10,0.2
171485153,2,8,2.0,10,0.2
171501962,3,6,3.0,9,0.3333333333333333
171502983,1,8,1.0,9,0.1111111111111111
171513114,5,14,5.0,19,0.2631578947368421
171523601,1,9,1.0,10,0.1
171529485,3,7,3.0,10,0.3
171532843,1,9,1.0,10,0.1
171535701,1,8,1.0,9,0.1111111111111111
171535708,5,5,5.0,10,0.5
171541689,2,8,2.0,10,0.2
171543589,4,6,4.0,10,0.4
171549229,8,2,2.0,10,0.2
171549931,25,4,4.0,29,0.13793103448275862
171550184,4,6,4.0,10,0.4
171554121,1,8,1.0,9,0.1111111111111111
171567453,8,20,8.0,28,0.2857142857142857
171571447,6,4,4.0,10,0.4
171575737,1,8,1.0,9,0.1111111111111111
171579037,7,2,2.0,9,0.2222222222222222
171579599,1,9,1.0,10,0.1
171580966,6,4,4.0,10,0.4
171588059,1,9,1.0,10,0.1
171588638,1,9,1.0,10,0.1
171594534,1,7,1.0,8,0.125
171629532,1,18,1.0,19,0.05263157894736842
171650958,2,8,2.0,10,0.2
171713291,5,5,5.0,10,0.5
171714054,5,24,5.0,29,0.1724137931034483
171741781,2,7,2.0,9,0.2222222222222222
171744353,1,9,1.0,10,0.1
171750823,1,18,1.0,19,0.05263157894736842
171753315,1,17,1.0,18,0.05555555555555555
171755422,4,6,4.0,10,0.4
171770120,2,8,2.0,10,0.2
171775907,6,3,3.0,9,0.3333333333333333
171779251,3,7,3.0,10,0.3
171792386,2,8,2.0,10,0.2
171792686,2,7,2.0,9,0.2222222222222222
171793102,3,7,3.0,10,0.3
171793175,7,13,7.0,20,0.35
171816420,2,7,2.0,9,0.2222222222222222
171820163,8,1,1.0,9,0.1111111111111111
171820981,6,4,4.0,10,0.4
171822111,1,9,1.0,10,0.1
171822339,6,4,4.0,10,0.4
171828724,1,28,1.0,29,0.034482758620689655
171833841,1,18,1.0,19,0.05263157894736842
171841979,2,6,2.0,8,0.25
171842933,1,8,1.0,9,0.1111111111111111
171844681,1,18,1.0,19,0.05263157894736842
171863895,2,18,2.0,20,0.1
171892026,1,19,1.0,20,0.05
171898314,4,6,4.0,10,0.4
171922191,3,7,3.0,10,0.3
171926331,3,6,3.0,9,0.3333333333333333
171927493,2,7,2.0,9,0.2222222222222222
171927781,1,9,1.0,10,0.1
171932710,2,17,2.0,19,0.10526315789473684
171937804,1,9,1.0,10,0.1
171947400,5,4,4.0,9,0.4444444444444444
171949037,1,8,1.0,9,0.1111111111111111
171958249,1,7,1.0,8,0.125
171961381,1,8,1.0,9,0.1111111111111111
171967357,4,6,4.0,10,0.4
171967523,9,1,1.0,10,0.1
171968968,1,9,1.0,10,0.1
171970863,5,5,5.0,10,0.5
171972556,1,9,1.0,10,0.1
171973196,4,4,4.0,8,0.5
171973968,7,2,2.0,9,0.2222222222222222
171980070,1,9,1.0,10,0.1
171986686,1,8,1.0,9,0.1111111111111111
171990233,3,27,3.0,30,0.1
171999832,5,5,5.0,10,0.5
172017727,1,9,1.0,10,0.1
172027274,3,6,3.0,9,0.3333333333333333
172027574,1,8,1.0,9,0.1111111111111111
172038158,4,15,4.0,19,0.21052631578947367
172039959,1,7,1.0,8,0.125
172060486,1,18,1.0,19,0.05263157894736842
172069094,8,1,1.0,9,0.1111111111111111
172084371,1,18,1.0,19,0.05263157894736842
172087540,4,6,4.0,10,0.4
172090226,5,4,4.0,9,0.4444444444444444
172092343,3,6,3.0,9,0.3333333333333333
172116505,1,8,1.0,9,0.1111111111111111
172121881,4,6,4.0,10,0.4
172134143,4,4,4.0,8,0.5
172134505,22,5,5.0,27,0.18518518518518517
172154822,2,8,2.0,10,0.2
172164934,10,20,10.0,30,0.3333333333333333
172167935,7,3,3.0,10,0.3
172170933,3,7,3.0,10,0.3
172172714,4,5,4.0,9,0.4444444444444444
172173283,27,2,2.0,29,0.06896551724137931
172173936,7,2,2.0,9,0.2222222222222222
172179050,7,3,3.0,10,0.3
172223083,7,2,2.0,9,0.2222222222222222
172223734,1,9,1.0,10,0.1
172225936,2,8,2.0,10,0.2
172232401,5,5,5.0,10,0.5
172233441,1,8,1.0,9,0.1111111111111111
172234434,3,6,3.0,9,0.3333333333333333
172254444,3,5,3.0,8,0.375
172296364,7,1,1.0,8,0.125
172314230,4,6,4.0,10,0.4
172317760,1,9,1.0,10,0.1
172326532,1,18,1.0,19,0.05263157894736842
172332791,4,6,4.0,10,0.4
172333435,3,5,3.0,8,0.375
172344221,8,2,2.0,10,0.2
172358428,1,8,1.0,9,0.1111111111111111
172362781,1,9,1.0,10,0.1
172370336,2,27,2.0,29,0.06896551724137931
172377705,1,8,1.0,9,0.1111111111111111
172396274,5,4,4.0,9,0.4444444444444444
172413964,6,4,4.0,10,0.4
172419033,6,3,3.0,9,0.3333333333333333
172420140,1,18,1.0,19,0.05263157894736842
172428049,1,7,1.0,8,0.125
172438146,5,5,5.0,10,0.5
172438449,1,9,1.0,10,0.1
172438742,3,15,3.0,18,0.16666666666666666
172461995,1,9,1.0,10,0.1
172474741,3,7,3.0,10,0.3
172482680,1,19,1.0,20,0.05
172521626,4,6,4.0,10,0.4
172523152,1,9,1.0,10,0.1
172524283,8,1,1.0,9,0.1111111111111111
172547412,1,18,1.0,19,0.05263157894736842
172568583,9,1,1.0,10,0.1
172570569,8,1,1.0,9,0.1111111111111111
172571791,3,6,3.0,9,0.3333333333333333
172577964,2,8,2.0,10,0.2
172581543,1,9,1.0,10,0.1
172587014,4,14,4.0,18,0.2222222222222222
172590939,1,17,1.0,18,0.05555555555555555
172596207,3,17,3.0,20,0.15
172598305,1,8,1.0,9,0.1111111111111111
172608476,6,4,4.0,10,0.4
172636048,1,9,1.0,10,0.1
172640092,1,9,1.0,10,0.1
172667008,4,4,4.0,8,0.5
172667277,1,7,1.0,8,0.125
172669889,27,1,1.0,28,0.03571428571428571
172690355,1,8,1.0,9,0.1111111111111111
172690567,1,9,1.0,10,0.1
172691944,1,8,1.0,9,0.1111111111111111
172705690,2,8,2.0,10,0.2
172724436,1,8,1.0,9,0.1111111111111111
172725256,2,8,2.0,10,0.2
172758146,1,9,1.0,10,0.1
172759250,3,7,3.0,10,0.3
172766056,6,4,4.0,10,0.4
172770614,2,8,2.0,10,0.2
172771162,26,4,4.0,30,0.13333333333333333
172772156,9,1,1.0,10,0.1
172776066,1,8,1.0,9,0.1111111111111111
172786324,1,9,1.0,10,0.1
172794223,4,5,4.0,9,0.4444444444444444
172814597,1,19,1.0,20,0.05
172817231,1,9,1.0,10,0.1
172865168,7,21,7.0,28,0.25
172886732,7,2,2.0,9,0.2222222222222222
172893863,2,8,2.0,10,0.2
172901110,3,6,3.0,9,0.3333333333333333
172904609,4,5,4.0,9,0.4444444444444444
172904715,2,8,2.0,10,0.2
172934393,4,4,4.0,8,0.5
172934399,20,6,6.0,26,0.23076923076923078
172934416,3,7,3.0,10,0.3
172934435,6,4,4.0,10,0.4
172952555,2,28,2.0,30,0.06666666666666667
172956266,5,4,4.0,9,0.4444444444444444
172956593,4,6,4.0,10,0.4
172960871,19,9,9.0,28,0.32142857142857145
172964218,3,6,3.0,9,0.3333333333333333
172990711,1,19,1.0,20,0.05
172993091,8,2,2.0,10,0.2
172997871,4,6,4.0,10,0.4
173007117,2,7,2.0,9,0.2222222222222222
173013362,3,15,3.0,18,0.16666666666666666
173014996,4,6,4.0,10,0.4
173030206,8,12,8.0,20,0.4
173032199,11,8,8.0,19,0.42105263157894735
173033420,1,9,1.0,10,0.1
173036389,2,7,2.0,9,0.2222222222222222
173039820,1,8,1.0,9,0.1111111111111111
173045580,1,9,1.0,10,0.1
173053052,1,17,1.0,18,0.05555555555555555
173062240,5,5,5.0,10,0.5
173067699,5,5,5.0,10,0.5
173068266,1,8,1.0,9,0.1111111111111111
173094461,9,1,1.0,10,0.1
173094548,6,4,4.0,10,0.4
173095067,8,2,2.0,10,0.2
173095424,4,5,4.0,9,0.4444444444444444
173096133,2,7,2.0,9,0.2222222222222222
173096689,4,5,4.0,9,0.4444444444444444
173112812,2,24,2.0,26,0.07692307692307693
173120050,6,21,6.0,27,0.2222222222222222
173120688,1,9,1.0,10,0.1
173122686,3,16,3.0,19,0.15789473684210525
173128097,3,7,3.0,10,0.3
173138222,8,11,8.0,19,0.42105263157894735
173153444,2,16,2.0,18,0.1111111111111111
173168170,1,8,1.0,9,0.1111111111111111
173190778,2,8,2.0,10,0.2
173205320,2,7,2.0,9,0.2222222222222222
173215022,1,9,1.0,10,0.1
173249922,5,5,5.0,10,0.5
173250169,2,8,2.0,10,0.2
173258574,1,9,1.0,10,0.1
173273829,1,8,1.0,9,0.1111111111111111
173307859,1,9,1.0,10,0.1
173318406,7,3,3.0,10,0.3
173319247,8,1,1.0,9,0.1111111111111111
173319562,7,1,1.0,8,0.125
173324903,1,8,1.0,9,0.1111111111111111
173328073,6,4,4.0,10,0.4
173330489,3,6,3.0,9,0.3333333333333333
173344332,9,1,1.0,10,0.1
173375867,9,1,1.0,10,0.1
173380712,1,7,1.0,8,0.125
173403006,8,1,1.0,9,0.1111111111111111
173407650,1,8,1.0,9,0.1111111111111111
173426100,1,8,1.0,9,0.1111111111111111
173443787,1,8,1.0,9,0.1111111111111111
173457299,1,9,1.0,10,0.1
173466561,1,9,1.0,10,0.1
173489706,3,7,3.0,10,0.3
173523770,2,8,2.0,10,0.2
173531961,1,8,1.0,9,0.1111111111111111
173535705,4,6,4.0,10,0.4
173547643,1,7,1.0,8,0.125
173548190,2,8,2.0,10,0.2
173551104,6,14,6.0,20,0.3
173551977,15,4,4.0,19,0.21052631578947367
173593949,1,16,1.0,17,0.058823529411764705
173618497,19,11,11.0,30,0.36666666666666664
173628646,1,8,1.0,9,0.1111111111111111
173634134,3,26,3.0,29,0.10344827586206896
173639799,11,7,7.0,18,0.3888888888888889
173701769,1,8,1.0,9,0.1111111111111111
173703992,2,8,2.0,10,0.2
173705940,2,8,2.0,10,0.2
173714166,6,3,3.0,9,0.3333333333333333
173715185,3,6,3.0,9,0.3333333333333333
173722221,1,9,1.0,10,0.1
173780360,1,9,1.0,10,0.1
173788417,8,2,2.0,10,0.2
173801923,1,18,1.0,19,0.05263157894736842
173857185,1,9,1.0,10,0.1
173877161,2,7,2.0,9,0.2222222222222222
173935512,1,8,1.0,9,0.1111111111111111
173938552,4,15,4.0,19,0.21052631578947367
173938979,1,9,1.0,10,0.1
173939172,1,17,1.0,18,0.05555555555555555
173939934,2,8,2.0,10,0.2
173940110,5,5,5.0,10,0.5
173940692,1,8,1.0,9,0.1111111111111111
173940858,2,7,2.0,9,0.2222222222222222
173961402,1,9,1.0,10,0.1
173963007,8,2,2.0,10,0.2
174000004,3,7,3.0,10,0.3
174020384,1,18,1.0,19,0.05263157894736842
174024489,1,9,1.0,10,0.1
174030628,1,9,1.0,10,0.1
174042570,1,9,1.0,10,0.1
174046674,8,2,2.0,10,0.2
174051521,1,7,1.0,8,0.125
174058372,2,16,2.0,18,0.1111111111111111
174063602,3,7,3.0,10,0.3
174084154,6,4,4.0,10,0.4
174087089,1,7,1.0,8,0.125
174090583,2,7,2.0,9,0.2222222222222222
174102962,2,7,2.0,9,0.2222222222222222
174117167,14,14,14.0,28,0.5
174117544,3,7,3.0,10,0.3
174118713,5,4,4.0,9,0.4444444444444444
174134015,9,1,1.0,10,0.1
174139818,8,2,2.0,10,0.2
174140030,17,3,3.0,20,0.15
174167533,1,19,1.0,20,0.05
174175605,6,4,4.0,10,0.4
174211752,27,2,2.0,29,0.06896551724137931
174216700,3,7,3.0,10,0.3
174217419,1,9,1.0,10,0.1
174230885,2,17,2.0,19,0.10526315789473684
174231696,1,8,1.0,9,0.1111111111111111
174235172,4,4,4.0,8,0.5
174235906,7,3,3.0,10,0.3
174237382,7,3,3.0,10,0.3
174240809,8,1,1.0,9,0.1111111111111111
174260055,9,1,1.0,10,0.1
174277572,1,9,1.0,10,0.1
174289536,6,4,4.0,10,0.4
174304286,4,6,4.0,10,0.4
174307298,8,11,8.0,19,0.42105263157894735
174381070,1,9,1.0,10,0.1
174383570,1,16,1.0,17,0.058823529411764705
174384507,2,8,2.0,10,0.2
174393302,1,9,1.0,10,0.1
174412965,6,3,3.0,9,0.3333333333333333
174416488,4,6,4.0,10,0.4
174429329,1,19,1.0,20,0.05
174458752,1,8,1.0,9,0.1111111111111111
174475163,3,7,3.0,10,0.3
174480516,2,7,2.0,9,0.2222222222222222
174481521,1,9,1.0,10,0.1
174509985,1,9,1.0,10,0.1
174520404,1,8,1.0,9,0.1111111111111111
174551887,1,19,1.0,20,0.05
174581651,6,4,4.0,10,0.4
174582090,1,9,1.0,10,0.1
174584831,13,7,7.0,20,0.35
174609537,3,7,3.0,10,0.3
174612149,3,5,3.0,8,0.375
174622478,4,5,4.0,9,0.4444444444444444
174623586,3,6,3.0,9,0.3333333333333333
174623790,3,7,3.0,10,0.3
174626704,8,1,1.0,9,0.1111111111111111
174632071,8,1,1.0,9,0.1111111111111111
174632863,2,7,2.0,9,0.2222222222222222
174644809,1,9,1.0,10,0.1
174647723,8,17,8.0,25,0.32
174651485,2,8,2.0,10,0.2
174657117,1,9,1.0,10,0.1
174658157,9,1,1.0,10,0.1
174662921,1,9,1.0,10,0.1
174722358,1,9,1.0,10,0.1
174724920,8,2,2.0,10,0.2
174740249,1,8,1.0,9,0.1111111111111111
174740954,2,8,2.0,10,0.2
174743775,3,7,3.0,10,0.3
174749476,9,1,1.0,10,0.1
174760394,3,7,3.0,10,0.3
174762352,10,19,10.0,29,0.3448275862068966
174774841,3,15,3.0,18,0.16666666666666666
174786172,3,7,3.0,10,0.3
174794439,1,9,1.0,10,0.1
174821537,2,8,2.0,10,0.2
174841897,3,6,3.0,9,0.3333333333333333
174843610,3,7,3.0,10,0.3
174846352,4,6,4.0,10,0.4
174860882,9,1,1.0,10,0.1
174896790,6,3,3.0,9,0.3333333333333333
174926164,4,5,4.0,9,0.4444444444444444
174927571,8,2,2.0,10,0.2
174989709,1,8,1.0,9,0.1111111111111111
175011987,8,22,8.0,30,0.26666666666666666
175012134,1,8,1.0,9,0.1111111111111111
175022251,7,1,1.0,8,0.125
175043693,9,1,1.0,10,0.1
175072449,26,3,3.0,29,0.10344827586206896
175148334,9,1,1.0,10,0.1
175148516,8,2,2.0,10,0.2
175148847,4,6,4.0,10,0.4
175149572,1,8,1.0,9,0.1111111111111111
175150526,3,6,3.0,9,0.3333333333333333
175173744,4,6,4.0,10,0.4
175179668,5,5,5.0,10,0.5
175189234,11,16,11.0,27,0.4074074074074074
175196818,4,6,4.0,10,0.4
175202134,3,7,3.0,10,0.3
175207835,1,9,1.0,10,0.1
175215412,7,1,1.0,8,0.125
175216129,9,19,9.0,28,0.32142857142857145
175216336,2,8,2.0,10,0.2
175216342,6,4,4.0,10,0.4
175219143,1,8,1.0,9,0.1111111111111111
175219172,1,8,1.0,9,0.1111111111111111
175219470,2,7,2.0,9,0.2222222222222222
175256485,2,7,2.0,9,0.2222222222222222
175328956,7,1,1.0,8,0.125
175344156,5,22,5.0,27,0.18518518518518517
175370883,12,17,12.0,29,0.41379310344827586
175375977,2,7,2.0,9,0.2222222222222222
175376478,1,9,1.0,10,0.1
175402617,1,19,1.0,20,0.05
175422629,1,9,1.0,10,0.1
175427525,4,16,4.0,20,0.2
175455911,2,8,2.0,10,0.2
175457233,2,8,2.0,10,0.2
175459816,1,9,1.0,10,0.1
175462394,3,7,3.0,10,0.3
175477236,1,8,1.0,9,0.1111111111111111
175489170,3,5,3.0,8,0.375
175490420,4,6,4.0,10,0.4
175519290,5,5,5.0,10,0.5
175521018,1,9,1.0,10,0.1
175521703,1,8,1.0,9,0.1111111111111111
175522061,2,16,2.0,18,0.1111111111111111
175522784,7,22,7.0,29,0.2413793103448276
175526872,11,18,11.0,29,0.3793103448275862
175527333,1,8,1.0,9,0.1111111111111111
175534226,4,4,4.0,8,0.5
175545317,2,17,2.0,19,0.10526315789473684
175548816,1,8,1.0,9,0.1111111111111111
175549978,1,9,1.0,10,0.1
175553037,6,3,3.0,9,0.3333333333333333
175558925,7,12,7.0,19,0.3684210526315789
175581776,1,8,1.0,9,0.1111111111111111
175586977,1,8,1.0,9,0.1111111111111111
175595696,1,8,1.0,9,0.1111111111111111
175598453,2,7,2.0,9,0.2222222222222222
175611972,2,16,2.0,18,0.1111111111111111
175627380,2,8,2.0,10,0.2
175629377,4,5,4.0,9,0.4444444444444444
175630023,5,5,5.0,10,0.5
175630270,2,6,2.0,8,0.25
175632178,5,5,5.0,10,0.5
175636802,5,4,4.0,9,0.4444444444444444
175656270,1,9,1.0,10,0.1
175658618,1,19,1.0,20,0.05
175666841,3,6,3.0,9,0.3333333333333333
175669453,2,7,2.0,9,0.2222222222222222
175670739,2,8,2.0,10,0.2
175671257,1,17,1.0,18,0.05555555555555555
175677150,3,24,3.0,27,0.1111111111111111
175683640,2,8,2.0,10,0.2
175706207,1,8,1.0,9,0.1111111111111111
175715893,1,9,1.0,10,0.1
175717205,1,9,1.0,10,0.1
175717246,1,8,1.0,9,0.1111111111111111
175726484,2,17,2.0,19,0.10526315789473684
175733300,3,7,3.0,10,0.3
175734104,2,8,2.0,10,0.2
175739075,5,3,3.0,8,0.375
175747377,3,7,3.0,10,0.3
175769417,1,8,1.0,9,0.1111111111111111
175782143,7,22,7.0,29,0.2413793103448276
175785692,2,8,2.0,10,0.2
175793312,1,7,1.0,8,0.125
175793723,1,9,1.0,10,0.1
175795095,2,8,2.0,10,0.2
175797846,1,8,1.0,9,0.1111111111111111
175805101,4,5,4.0,9,0.4444444444444444
175808544,7,3,3.0,10,0.3
175809467,1,9,1.0,10,0.1
175810699,1,7,1.0,8,0.125
175823638,3,7,3.0,10,0.3
175824000,6,4,4.0,10,0.4
175824688,4,5,4.0,9,0.4444444444444444
175827465,3,6,3.0,9,0.3333333333333333
175830400,1,7,1.0,8,0.125
175835167,1,9,1.0,10,0.1
175856693,1,9,1.0,10,0.1
175870953,2,7,2.0,9,0.2222222222222222
175880589,8,1,1.0,9,0.1111111111111111
175906212,1,9,1.0,10,0.1
175910260,1,18,1.0,19,0.05263157894736842
175924472,5,4,4.0,9,0.4444444444444444
175924806,7,2,2.0,9,0.2222222222222222
175926856,2,7,2.0,9,0.2222222222222222
175927296,5,5,5.0,10,0.5
175927454,7,2,2.0,9,0.2222222222222222
175927867,3,7,3.0,10,0.3
175931132,1,9,1.0,10,0.1
175956401,1,7,1.0,8,0.125
175963146,5,5,5.0,10,0.5
176002977,7,3,3.0,10,0.3
176010311,1,9,1.0,10,0.1
176015659,3,6,3.0,9,0.3333333333333333
176017486,3,7,3.0,10,0.3
176018332,8,2,2.0,10,0.2
176028371,1,8,1.0,9,0.1111111111111111
176036576,1,9,1.0,10,0.1
176065475,1,17,1.0,18,0.05555555555555555
176067869,1,9,1.0,10,0.1
176083493,2,7,2.0,9,0.2222222222222222
176100633,4,16,4.0,20,0.2
176104618,2,17,2.0,19,0.10526315789473684
176133929,2,8,2.0,10,0.2
176152926,3,7,3.0,10,0.3
176160815,4,6,4.0,10,0.4
176163383,1,18,1.0,19,0.05263157894736842
176168059,4,6,4.0,10,0.4
176176801,8,2,2.0,10,0.2
176182245,1,18,1.0,19,0.05263157894736842
176212898,1,9,1.0,10,0.1
176215519,6,3,3.0,9,0.3333333333333333
176224122,2,8,2.0,10,0.2
176231790,1,8,1.0,9,0.1111111111111111
176244863,2,8,2.0,10,0.2
176263401,1,18,1.0,19,0.05263157894736842
176263948,2,8,2.0,10,0.2
176268934,3,7,3.0,10,0.3
176269641,2,7,2.0,9,0.2222222222222222
176271818,4,6,4.0,10,0.4
176285749,3,6,3.0,9,0.3333333333333333
176290882,1,8,1.0,9,0.1111111111111111
176292190,3,27,3.0,30,0.1
176302725,3,15,3.0,18,0.16666666666666666
176302994,3,5,3.0,8,0.375
176308947,2,7,2.0,9,0.2222222222222222
176317656,1,8,1.0,9,0.1111111111111111
176321858,2,8,2.0,10,0.2
176326759,1,8,1.0,9,0.1111111111111111
176355847,1,8,1.0,9,0.1111111111111111
176373803,2,8,2.0,10,0.2
176378359,1,8,1.0,9,0.1111111111111111
176408443,7,2,2.0,9,0.2222222222222222
176408856,3,7,3.0,10,0.3
176413527,4,4,4.0,8,0.5
176415742,13,17,13.0,30,0.43333333333333335
176417153,10,18,10.0,28,0.35714285714285715
176421143,2,8,2.0,10,0.2
176422123,3,7,3.0,10,0.3
176426736,1,9,1.0,10,0.1
176427837,1,8,1.0,9,0.1111111111111111
176462411,5,5,5.0,10,0.5
176482230,1,9,1.0,10,0.1
176489503,3,16,3.0,19,0.15789473684210525
176494567,8,12,8.0,20,0.4
176501110,1,19,1.0,20,0.05
176522558,2,6,2.0,8,0.25
176532354,1,18,1.0,19,0.05263157894736842
176593217,8,1,1.0,9,0.1111111111111111
176600645,17,12,12.0,29,0.41379310344827586
176630870,1,8,1.0,9,0.1111111111111111
176636737,1,8,1.0,9,0.1111111111111111
176650612,1,9,1.0,10,0.1
176676486,1,8,1.0,9,0.1111111111111111
176702808,5,4,4.0,9,0.4444444444444444
176702814,4,6,4.0,10,0.4
176714134,3,5,3.0,8,0.375
176732843,3,6,3.0,9,0.3333333333333333
176735687,3,25,3.0,28,0.10714285714285714
176736970,3,7,3.0,10,0.3
176737025,4,6,4.0,10,0.4
176753260,7,2,2.0,9,0.2222222222222222
176754126,19,7,7.0,26,0.2692307692307692
176762765,2,24,2.0,26,0.07692307692307693
176763808,1,9,1.0,10,0.1
176773181,2,8,2.0,10,0.2
176787974,1,9,1.0,10,0.1
176795027,6,4,4.0,10,0.4
176807312,4,15,4.0,19,0.21052631578947367
176816581,1,9,1.0,10,0.1
176857072,3,7,3.0,10,0.3
176870564,1,8,1.0,9,0.1111111111111111
176890133,1,9,1.0,10,0.1
176894633,6,4,4.0,10,0.4
176915862,3,17,3.0,20,0.15
176926820,6,4,4.0,10,0.4
176927397,2,7,2.0,9,0.2222222222222222
176930681,1,9,1.0,10,0.1
176966470,2,7,2.0,9,0.2222222222222222
176972242,1,7,1.0,8,0.125
176979696,2,8,2.0,10,0.2
176994145,1,8,1.0,9,0.1111111111111111
176994844,1,19,1.0,20,0.05
177000207,8,2,2.0,10,0.2
177000266,1,8,1.0,9,0.1111111111111111
177000712,1,9,1.0,10,0.1
177004271,7,3,3.0,10,0.3
177006768,1,9,1.0,10,0.1
177027157,4,6,4.0,10,0.4
177027682,2,8,2.0,10,0.2
177027849,2,7,2.0,9,0.2222222222222222
177031941,3,7,3.0,10,0.3
177041629,1,8,1.0,9,0.1111111111111111
177045434,1,9,1.0,10,0.1
177062012,4,6,4.0,10,0.4
177068291,2,8,2.0,10,0.2
177068655,11,18,11.0,29,0.3793103448275862
177075288,3,7,3.0,10,0.3
177083802,2,8,2.0,10,0.2
177084778,1,8,1.0,9,0.1111111111111111
177086595,6,2,2.0,8,0.25
177087418,1,9,1.0,10,0.1
177089889,1,8,1.0,9,0.1111111111111111
177091557,3,7,3.0,10,0.3
177092442,2,7,2.0,9,0.2222222222222222
177093227,5,4,4.0,9,0.4444444444444444
177094270,1,8,1.0,9,0.1111111111111111
177098206,6,2,2.0,8,0.25
177111464,25,4,4.0,29,0.13793103448275862
177112623,3,6,3.0,9,0.3333333333333333
177122257,8,1,1.0,9,0.1111111111111111
177122566,3,7,3.0,10,0.3
177125649,8,1,1.0,9,0.1111111111111111
177130614,3,21,3.0,24,0.125
177131989,2,6,2.0,8,0.25
177152247,2,7,2.0,9,0.2222222222222222
177152433,2,18,2.0,20,0.1
177154518,1,27,1.0,28,0.03571428571428571
177169705,2,8,2.0,10,0.2
177174319,7,2,2.0,9,0.2222222222222222
177197821,1,7,1.0,8,0.125
177206427,2,8,2.0,10,0.2
177224158,7,3,3.0,10,0.3
177224225,6,3,3.0,9,0.3333333333333333
177225275,8,2,2.0,10,0.2
177225337,8,2,2.0,10,0.2
177226068,9,1,1.0,10,0.1
177243521,6,3,3.0,9,0.3333333333333333
177245635,4,14,4.0,18,0.2222222222222222
177260753,3,7,3.0,10,0.3
177283241,1,9,1.0,10,0.1
177293257,2,17,2.0,19,0.10526315789473684
177304306,1,8,1.0,9,0.1111111111111111
177308948,3,7,3.0,10,0.3
177317696,6,4,4.0,10,0.4
177322042,2,7,2.0,9,0.2222222222222222
177325686,3,7,3.0,10,0.3
177326300,1,9,1.0,10,0.1
177327431,1,17,1.0,18,0.05555555555555555
177331197,6,2,2.0,8,0.25
177336414,5,4,4.0,9,0.4444444444444444
177336494,7,21,7.0,28,0.25
177337778,4,5,4.0,9,0.4444444444444444
177344688,8,11,8.0,19,0.42105263157894735
177356369,2,8,2.0,10,0.2
177360829,3,7,3.0,10,0.3
177369724,12,14,12.0,26,0.46153846153846156
177376823,2,8,2.0,10,0.2
177382480,5,25,5.0,30,0.16666666666666666
177390990,1,8,1.0,9,0.1111111111111111
177393138,1,17,1.0,18,0.05555555555555555
177407748,8,2,2.0,10,0.2
177417185,1,16,1.0,17,0.058823529411764705
177422380,1,9,1.0,10,0.1
177427399,2,8,2.0,10,0.2
177427799,1,8,1.0,9,0.1111111111111111
177447777,9,1,1.0,10,0.1
177448039,3,7,3.0,10,0.3
177448209,9,1,1.0,10,0.1
177456242,9,1,1.0,10,0.1
177459179,1,19,1.0,20,0.05
177473646,2,8,2.0,10,0.2
177488856,4,14,4.0,18,0.2222222222222222
177496079,3,6,3.0,9,0.3333333333333333
177499642,1,7,1.0,8,0.125
177501816,2,8,2.0,10,0.2
177502596,2,8,2.0,10,0.2
177508976,1,9,1.0,10,0.1
177518574,7,3,3.0,10,0.3
177518842,7,2,2.0,9,0.2222222222222222
177519158,2,8,2.0,10,0.2
177521440,1,9,1.0,10,0.1
177534701,2,8,2.0,10,0.2
177539526,2,24,2.0,26,0.07692307692307693
177543781,1,9,1.0,10,0.1
177564456,1,8,1.0,9,0.1111111111111111
177584595,3,7,3.0,10,0.3
177606403,1,9,1.0,10,0.1
177606930,6,4,4.0,10,0.4
177611928,1,9,1.0,10,0.1
177612557,2,7,2.0,9,0.2222222222222222
177641064,1,10,1.0,11,0.09090909090909091
177653761,1,18,1.0,19,0.05263157894736842
177673302,9,1,1.0,10,0.1
177673893,1,9,1.0,10,0.1
177708751,1,9,1.0,10,0.1
177709991,1,9,1.0,10,0.1
177717739,1,9,1.0,10,0.1
177718292,1,8,1.0,9,0.1111111111111111
177747228,9,1,1.0,10,0.1
177760843,3,25,3.0,28,0.10714285714285714
177768538,6,13,6.0,19,0.3157894736842105
177777681,20,9,9.0,29,0.3103448275862069
177780430,2,8,2.0,10,0.2
177799880,1,8,1.0,9,0.1111111111111111
177802979,2,8,2.0,10,0.2
177803822,1,9,1.0,10,0.1
177804443,6,4,4.0,10,0.4
177808727,5,24,5.0,29,0.1724137931034483
177810719,3,7,3.0,10,0.3
177818832,1,9,1.0,10,0.1
177819515,3,5,3.0,8,0.375
177819930,6,14,6.0,20,0.3
177820477,2,7,2.0,9,0.2222222222222222
177820548,6,4,4.0,10,0.4
177821778,2,8,2.0,10,0.2
177823690,2,7,2.0,9,0.2222222222222222
177827940,2,8,2.0,10,0.2
177830099,7,2,2.0,9,0.2222222222222222
177831050,1,8,1.0,9,0.1111111111111111
177837567,1,9,1.0,10,0.1
177839781,1,7,1.0,8,0.125
177858335,1,18,1.0,19,0.05263157894736842
177864079,1,9,1.0,10,0.1
177883362,1,17,1.0,18,0.05555555555555555
177902918,7,2,2.0,9,0.2222222222222222
177904975,4,15,4.0,19,0.21052631578947367
177906085,7,3,3.0,10,0.3
177919029,1,18,1.0,19,0.05263157894736842
177934135,1,8,1.0,9,0.1111111111111111
177946095,2,8,2.0,10,0.2
177948855,3,7,3.0,10,0.3
177965908,4,6,4.0,10,0.4
177968350,1,8,1.0,9,0.1111111111111111
177969795,8,20,8.0,28,0.2857142857142857
178000406,1,9,1.0,10,0.1
178007552,1,18,1.0,19,0.05263157894736842
178021011,1,9,1.0,10,0.1
178021616,8,2,2.0,10,0.2
178021958,2,7,2.0,9,0.2222222222222222
178022270,4,6,4.0,10,0.4
178043564,3,6,3.0,9,0.3333333333333333
178043884,7,2,2.0,9,0.2222222222222222
178047299,7,3,3.0,10,0.3
178047362,26,4,4.0,30,0.13333333333333333
178047507,4,5,4.0,9,0.4444444444444444
178047538,1,9,1.0,10,0.1
178051006,1,9,1.0,10,0.1
178074522,1,9,1.0,10,0.1
178110998,1,9,1.0,10,0.1
178111996,14,12,12.0,26,0.46153846153846156
178112956,3,6,3.0,9,0.3333333333333333
178118831,1,8,1.0,9,0.1111111111111111
178120484,1,7,1.0,8,0.125
178121547,4,6,4.0,10,0.4
178123828,9,1,1.0,10,0.1
178164107,1,9,1.0,10,0.1
178173418,2,8,2.0,10,0.2
178184596,4,6,4.0,10,0.4
178219512,1,9,1.0,10,0.1
178276493,2,8,2.0,10,0.2
178284459,1,8,1.0,9,0.1111111111111111
178284663,3,7,3.0,10,0.3
178285562,2,6,2.0,8,0.25
178304612,6,3,3.0,9,0.3333333333333333
178333504,9,1,1.0,10,0.1
178376143,1,16,1.0,17,0.058823529411764705
178382568,4,14,4.0,18,0.2222222222222222
178385789,1,9,1.0,10,0.1
178385984,1,9,1.0,10,0.1
178386692,8,2,2.0,10,0.2
178387413,1,9,1.0,10,0.1
178387726,1,9,1.0,10,0.1
178388616,4,5,4.0,9,0.4444444444444444
178388945,1,8,1.0,9,0.1111111111111111
178409557,7,3,3.0,10,0.3
178417981,3,7,3.0,10,0.3
178437904,1,8,1.0,9,0.1111111111111111
178523747,3,17,3.0,20,0.15
178527016,1,8,1.0,9,0.1111111111111111
178537683,1,17,1.0,18,0.05555555555555555
178543950,1,17,1.0,18,0.05555555555555555
178544486,1,9,1.0,10,0.1
178552982,2,8,2.0,10,0.2
178557432,3,16,3.0,19,0.15789473684210525
178561833,1,18,1.0,19,0.05263157894736842
178570647,3,6,3.0,9,0.3333333333333333
178572992,1,9,1.0,10,0.1
178616999,1,17,1.0,18,0.05555555555555555
178621635,1,19,1.0,20,0.05
178629202,7,3,3.0,10,0.3
178630682,2,8,2.0,10,0.2
178638342,2,7,2.0,9,0.2222222222222222
178656383,1,8,1.0,9,0.1111111111111111
178662994,12,7,7.0,19,0.3684210526315789
178663193,2,8,2.0,10,0.2
178663301,8,11,8.0,19,0.42105263157894735
178665697,2,8,2.0,10,0.2
178666241,2,8,2.0,10,0.2
178666725,2,7,2.0,9,0.2222222222222222
178666930,10,17,10.0,27,0.37037037037037035
178667001,1,8,1.0,9,0.1111111111111111
178667242,2,8,2.0,10,0.2
178667677,2,8,2.0,10,0.2
178668062,1,8,1.0,9,0.1111111111111111
178668834,4,6,4.0,10,0.4
178670106,3,6,3.0,9,0.3333333333333333
178670350,6,4,4.0,10,0.4
178675861,1,8,1.0,9,0.1111111111111111
178714618,1,9,1.0,10,0.1
178721791,4,5,4.0,9,0.4444444444444444
178765274,1,7,1.0,8,0.125
178768606,8,1,1.0,9,0.1111111111111111
178786969,7,1,1.0,8,0.125
178800845,2,18,2.0,20,0.1
178800865,1,7,1.0,8,0.125
178806595,1,17,1.0,18,0.05555555555555555
178818824,3,7,3.0,10,0.3
178819077,3,7,3.0,10,0.3
178821797,2,8,2.0,10,0.2
178868726,1,9,1.0,10,0.1
178869249,1,7,1.0,8,0.125
178901959,1,8,1.0,9,0.1111111111111111
178954008,10,19,10.0,29,0.3448275862068966
178973905,5,4,4.0,9,0.4444444444444444
178974035,16,10,10.0,26,0.38461538461538464
178998511,4,6,4.0,10,0.4
179039448,1,9,1.0,10,0.1
179048447,1,9,1.0,10,0.1
179051858,2,7,2.0,9,0.2222222222222222
179053261,1,8,1.0,9,0.1111111111111111
179068549,5,4,4.0,9,0.4444444444444444
179081950,1,8,1.0,9,0.1111111111111111
179088402,1,9,1.0,10,0.1
179089859,7,1,1.0,8,0.125
179100297,8,2,2.0,10,0.2
179115270,1,8,1.0,9,0.1111111111111111
179133581,6,4,4.0,10,0.4
179156160,1,9,1.0,10,0.1
179209265,4,5,4.0,9,0.4444444444444444
179212820,1,9,1.0,10,0.1
179213325,5,5,5.0,10,0.5
179217534,7,22,7.0,29,0.2413793103448276
179234397,4,6,4.0,10,0.4
179236240,1,8,1.0,9,0.1111111111111111
179239609,2,8,2.0,10,0.2
179240355,6,4,4.0,10,0.4
179240799,28,1,1.0,29,0.034482758620689655
179244283,6,3,3.0,9,0.3333333333333333
179244747,3,7,3.0,10,0.3
179251160,3,6,3.0,9,0.3333333333333333
179289202,1,8,1.0,9,0.1111111111111111
179290992,6,4,4.0,10,0.4
179292352,3,6,3.0,9,0.3333333333333333
179309030,2,7,2.0,9,0.2222222222222222
179338786,1,9,1.0,10,0.1
179341353,8,19,8.0,27,0.2962962962962963
179341683,4,6,4.0,10,0.4
179349337,2,6,2.0,8,0.25
179354435,1,9,1.0,10,0.1
179354690,6,3,3.0,9,0.3333333333333333
179356305,4,6,4.0,10,0.4
179356693,2,7,2.0,9,0.2222222222222222
179357075,1,9,1.0,10,0.1
179357499,4,6,4.0,10,0.4
179357668,3,7,3.0,10,0.3
179365138,1,9,1.0,10,0.1
179365258,9,1,1.0,10,0.1
179365855,1,18,1.0,19,0.05263157894736842
179370321,1,19,1.0,20,0.05
179371728,1,19,1.0,20,0.05
179388182,2,8,2.0,10,0.2
179403624,10,16,10.0,26,0.38461538461538464
179411488,12,6,6.0,18,0.3333333333333333
179421964,1,9,1.0,10,0.1
179423039,6,22,6.0,28,0.21428571428571427
179429567,1,9,1.0,10,0.1
179442733,5,5,5.0,10,0.5
179443083,2,8,2.0,10,0.2
179443461,1,8,1.0,9,0.1111111111111111
179447081,2,8,2.0,10,0.2
179451125,1,18,1.0,19,0.05263157894736842
179459375,5,5,5.0,10,0.5
179498566,1,9,1.0,10,0.1
179530066,2,7,2.0,9,0.2222222222222222
179532862,3,7,3.0,10,0.3
179533611,25,4,4.0,29,0.13793103448275862
179533780,1,9,1.0,10,0.1
179534669,7,3,3.0,10,0.3
179534806,4,24,4.0,28,0.14285714285714285
179542984,1,9,1.0,10,0.1
179543444,7,13,7.0,20,0.35
179617350,1,9,1.0,10,0.1
179623506,3,7,3.0,10,0.3
179624397,5,14,5.0,19,0.2631578947368421
179631530,1,9,1.0,10,0.1
179642155,2,8,2.0,10,0.2
179642670,4,26,4.0,30,0.13333333333333333
179642928,1,9,1.0,10,0.1
179644292,6,2,2.0,8,0.25
179650552,1,19,1.0,20,0.05
179654249,4,16,4.0,20,0.2
179665934,3,7,3.0,10,0.3
179666542,1,8,1.0,9,0.1111111111111111
179668350,2,6,2.0,8,0.25
179671242,2,8,2.0,10,0.2
179699259,1,8,1.0,9,0.1111111111111111
179700198,6,13,6.0,19,0.3157894736842105
179706428,5,4,4.0,9,0.4444444444444444
179708464,7,3,3.0,10,0.3
179709758,2,7,2.0,9,0.2222222222222222
179710507,2,8,2.0,10,0.2
179712228,3,7,3.0,10,0.3
179714632,9,1,1.0,10,0.1
179725592,1,18,1.0,19,0.05263157894736842
179751613,6,3,3.0,9,0.3333333333333333
179753166,1,9,1.0,10,0.1
179761372,1,9,1.0,10,0.1
179765123,1,9,1.0,10,0.1
179766244,3,6,3.0,9,0.3333333333333333
179766393,6,4,4.0,10,0.4
179767616,4,6,4.0,10,0.4
179770835,6,3,3.0,9,0.3333333333333333
179772987,1,8,1.0,9,0.1111111111111111
179776385,3,27,3.0,30,0.1
179792404,1,18,1.0,19,0.05263157894736842
179836520,6,4,4.0,10,0.4
179856434,2,7,2.0,9,0.2222222222222222
179862303,2,8,2.0,10,0.2
179882139,1,8,1.0,9,0.1111111111111111
179884407,2,8,2.0,10,0.2
179891499,1,9,1.0,10,0.1
179908210,2,8,2.0,10,0.2
179909873,4,6,4.0,10,0.4
179911260,1,9,1.0,10,0.1
179912144,1,9,1.0,10,0.1
179912857,1,7,1.0,8,0.125
179913237,4,6,4.0,10,0.4
179915495,1,17,1.0,18,0.05555555555555555
179926590,8,1,1.0,9,0.1111111111111111
179927424,17,11,11.0,28,0.39285714285714285
179929860,1,8,1.0,9,0.1111111111111111
179930541,2,18,2.0,20,0.1
179936565,3,5,3.0,8,0.375
179938273,1,9,1.0,10,0.1
179949469,1,7,1.0,8,0.125
179955151,1,17,1.0,18,0.05555555555555555
179956438,3,6,3.0,9,0.3333333333333333
179957173,7,20,7.0,27,0.25925925925925924
179958283,1,8,1.0,9,0.1111111111111111
179958608,3,6,3.0,9,0.3333333333333333
179960001,7,3,3.0,10,0.3
179961385,1,9,1.0,10,0.1
179963205,4,6,4.0,10,0.4
179963285,3,6,3.0,9,0.3333333333333333
179965078,1,9,1.0,10,0.1
179975215,1,8,1.0,9,0.1111111111111111
179976636,2,8,2.0,10,0.2
179979320,2,8,2.0,10,0.2
179981166,1,9,1.0,10,0.1
179995400,1,19,1.0,20,0.05
179996780,2,8,2.0,10,0.2
179999296,2,8,2.0,10,0.2
180000011,1,8,1.0,9,0.1111111111111111
180004452,1,9,1.0,10,0.1
180004807,4,5,4.0,9,0.4444444444444444
180026515,1,9,1.0,10,0.1
180046743,2,7,2.0,9,0.2222222222222222
180050466,1,9,1.0,10,0.1
180053681,1,9,1.0,10,0.1
180058810,3,7,3.0,10,0.3
180059000,5,5,5.0,10,0.5
180061943,3,22,3.0,25,0.12
180062427,4,24,4.0,28,0.14285714285714285
180064648,2,8,2.0,10,0.2
180064887,8,2,2.0,10,0.2
180079469,2,7,2.0,9,0.2222222222222222
180086604,17,12,12.0,29,0.41379310344827586
180094695,28,1,1.0,29,0.034482758620689655
180135937,1,7,1.0,8,0.125
180137546,1,9,1.0,10,0.1
180137626,3,6,3.0,9,0.3333333333333333
180139001,15,15,15.0,30,0.5
180142189,6,4,4.0,10,0.4
180142601,6,4,4.0,10,0.4
180157676,2,8,2.0,10,0.2
180179896,1,9,1.0,10,0.1
180184495,1,9,1.0,10,0.1
180213090,5,5,5.0,10,0.5
180213342,1,9,1.0,10,0.1
180219608,3,15,3.0,18,0.16666666666666666
180219623,8,1,1.0,9,0.1111111111111111
180219794,8,2,2.0,10,0.2
180231733,1,9,1.0,10,0.1
180235780,6,4,4.0,10,0.4
180239182,7,3,3.0,10,0.3
180242113,2,7,2.0,9,0.2222222222222222
180244760,1,9,1.0,10,0.1
180260461,5,5,5.0,10,0.5
180260676,4,6,4.0,10,0.4
180261249,7,3,3.0,10,0.3
180261559,4,5,4.0,9,0.4444444444444444
180261668,25,2,2.0,27,0.07407407407407407
180263398,1,9,1.0,10,0.1
180279243,9,10,9.0,19,0.47368421052631576
180280284,1,19,1.0,20,0.05
180282543,1,9,1.0,10,0.1
180284649,1,8,1.0,9,0.1111111111111111
180306451,1,9,1.0,10,0.1
180309157,2,8,2.0,10,0.2
180310288,1,19,1.0,20,0.05
180310408,2,7,2.0,9,0.2222222222222222
180311646,2,6,2.0,8,0.25
180313473,3,6,3.0,9,0.3333333333333333
180336119,1,9,1.0,10,0.1
180361098,1,9,1.0,10,0.1
180362415,6,3,3.0,9,0.3333333333333333
180371425,23,5,5.0,28,0.17857142857142858
180387839,1,9,1.0,10,0.1
180387924,1,8,1.0,9,0.1111111111111111
180394009,1,8,1.0,9,0.1111111111111111
180438807,1,9,1.0,10,0.1
180446327,7,6,6.0,13,0.46153846153846156
180446870,2,8,2.0,10,0.2
180448931,25,3,3.0,28,0.10714285714285714
180462380,2,7,2.0,9,0.2222222222222222
180463929,5,5,5.0,10,0.5
180464453,5,5,5.0,10,0.5
180493764,1,19,1.0,20,0.05
180507765,1,8,1.0,9,0.1111111111111111
180512955,1,19,1.0,20,0.05
180526461,3,6,3.0,9,0.3333333333333333
180537447,5,5,5.0,10,0.5
180562585,5,5,5.0,10,0.5
180563054,4,5,4.0,9,0.4444444444444444
180563715,4,6,4.0,10,0.4
180564377,8,22,8.0,30,0.26666666666666666
180564672,7,3,3.0,10,0.3
180572948,2,7,2.0,9,0.2222222222222222
180585897,1,8,1.0,9,0.1111111111111111
180586409,3,6,3.0,9,0.3333333333333333
180597239,1,8,1.0,9,0.1111111111111111
180623518,4,14,4.0,18,0.2222222222222222
180627319,7,21,7.0,28,0.25
180628573,4,6,4.0,10,0.4
180648441,7,1,1.0,8,0.125
180662315,6,4,4.0,10,0.4
180671448,1,9,1.0,10,0.1
180671861,5,4,4.0,9,0.4444444444444444
180676258,3,6,3.0,9,0.3333333333333333
180684898,2,17,2.0,19,0.10526315789473684
180700873,1,8,1.0,9,0.1111111111111111
180711429,1,9,1.0,10,0.1
180723102,6,4,4.0,10,0.4
180723389,4,6,4.0,10,0.4
180723668,2,8,2.0,10,0.2
180731619,1,8,1.0,9,0.1111111111111111
180744835,1,8,1.0,9,0.1111111111111111
180757766,6,3,3.0,9,0.3333333333333333
180758494,1,8,1.0,9,0.1111111111111111
180759260,8,2,2.0,10,0.2
180777231,1,9,1.0,10,0.1
180779145,1,9,1.0,10,0.1
180797555,1,8,1.0,9,0.1111111111111111
180842151,1,18,1.0,19,0.05263157894736842
180868459,1,8,1.0,9,0.1111111111111111
180874668,3,5,3.0,8,0.375
180888923,8,1,1.0,9,0.1111111111111111
180902693,1,7,1.0,8,0.125
180912119,8,1,1.0,9,0.1111111111111111
180935528,4,6,4.0,10,0.4
180935625,1,19,1.0,20,0.05
180935712,2,8,2.0,10,0.2
180942279,1,9,1.0,10,0.1
180951014,1,8,1.0,9,0.1111111111111111
180964273,6,3,3.0,9,0.3333333333333333
180966243,29,1,1.0,30,0.03333333333333333
180980254,6,4,4.0,10,0.4
180980550,9,1,1.0,10,0.1
180982203,7,3,3.0,10,0.3
180982586,4,4,4.0,8,0.5
180983347,8,1,1.0,9,0.1111111111111111
181010762,6,4,4.0,10,0.4
181011963,3,7,3.0,10,0.3
181012363,1,9,1.0,10,0.1
181013408,2,8,2.0,10,0.2
181013448,1,8,1.0,9,0.1111111111111111
181019980,25,3,3.0,28,0.10714285714285714
181031228,5,15,5.0,20,0.25
181039067,7,2,2.0,9,0.2222222222222222
181049889,3,6,3.0,9,0.3333333333333333
181050536,3,7,3.0,10,0.3
181076583,1,9,1.0,10,0.1
181082958,1,17,1.0,18,0.05555555555555555
181091322,6,14,6.0,20,0.3
181103656,6,4,4.0,10,0.4
181106035,1,19,1.0,20,0.05
181123252,1,8,1.0,9,0.1111111111111111
181131368,3,7,3.0,10,0.3
181131550,3,24,3.0,27,0.1111111111111111
181149419,2,8,2.0,10,0.2
181153609,1,8,1.0,9,0.1111111111111111
181155506,4,5,4.0,9,0.4444444444444444
181155693,3,25,3.0,28,0.10714285714285714
181156205,2,7,2.0,9,0.2222222222222222
181157337,2,7,2.0,9,0.2222222222222222
181157808,8,2,2.0,10,0.2
181158264,2,7,2.0,9,0.2222222222222222
181161379,6,4,4.0,10,0.4
181167991,8,2,2.0,10,0.2
181168799,6,4,4.0,10,0.4
181204960,1,9,1.0,10,0.1
181223615,9,1,1.0,10,0.1
181236153,1,9,1.0,10,0.1
181240154,3,16,3.0,19,0.15789473684210525
181246141,3,6,3.0,9,0.3333333333333333
181248174,5,5,5.0,10,0.5
181248622,3,6,3.0,9,0.3333333333333333
181251568,2,15,2.0,17,0.11764705882352941
181261877,1,9,1.0,10,0.1
181268666,4,6,4.0,10,0.4
181273013,1,9,1.0,10,0.1
181279925,1,9,1.0,10,0.1
181309370,2,8,2.0,10,0.2
181326941,4,6,4.0,10,0.4
181327217,3,7,3.0,10,0.3
181329127,3,7,3.0,10,0.3
181377885,1,9,1.0,10,0.1
181381168,1,18,1.0,19,0.05263157894736842
181393722,7,2,2.0,9,0.2222222222222222
181395833,6,4,4.0,10,0.4
181401099,1,8,1.0,9,0.1111111111111111
181403788,1,9,1.0,10,0.1
181405975,2,8,2.0,10,0.2
181408260,2,8,2.0,10,0.2
181413760,3,7,3.0,10,0.3
181474687,7,3,3.0,10,0.3
181478753,1,9,1.0,10,0.1
181482174,4,6,4.0,10,0.4
181482478,3,6,3.0,9,0.3333333333333333
181498320,4,14,4.0,18,0.2222222222222222
181509961,9,1,1.0,10,0.1
181511156,7,1,1.0,8,0.125
181511459,1,8,1.0,9,0.1111111111111111
181513532,2,7,2.0,9,0.2222222222222222
181513714,3,7,3.0,10,0.3
181515013,2,18,2.0,20,0.1
181520536,2,7,2.0,9,0.2222222222222222
181524799,1,9,1.0,10,0.1
181531529,3,17,3.0,20,0.15
181533992,5,22,5.0,27,0.18518518518518517
181535355,1,9,1.0,10,0.1
181536742,2,7,2.0,9,0.2222222222222222
181539904,4,5,4.0,9,0.4444444444444444
181556847,2,8,2.0,10,0.2
181557220,3,7,3.0,10,0.3
181568620,1,9,1.0,10,0.1
181572860,1,8,1.0,9,0.1111111111111111
181574121,3,7,3.0,10,0.3
181575574,1,9,1.0,10,0.1
181578334,2,7,2.0,9,0.2222222222222222
181600327,5,4,4.0,9,0.4444444444444444
181602749,2,7,2.0,9,0.2222222222222222
181608544,4,6,4.0,10,0.4
181610059,1,9,1.0,10,0.1
181622484,4,5,4.0,9,0.4444444444444444
181633843,2,8,2.0,10,0.2
181668297,1,9,1.0,10,0.1
181683500,3,7,3.0,10,0.3
181703970,3,7,3.0,10,0.3
181710628,1,9,1.0,10,0.1
181714470,2,8,2.0,10,0.2
181748445,1,19,1.0,20,0.05
181750256,5,4,4.0,9,0.4444444444444444
181760925,1,9,1.0,10,0.1
181766595,13,12,12.0,25,0.48
181771605,1,7,1.0,8,0.125
181797008,1,8,1.0,9,0.1111111111111111
181811074,7,3,3.0,10,0.3
181812196,9,1,1.0,10,0.1
181814968,2,8,2.0,10,0.2
181828827,1,9,1.0,10,0.1
181829036,1,9,1.0,10,0.1
181863998,1,9,1.0,10,0.1
181864890,1,7,1.0,8,0.125
181868197,1,8,1.0,9,0.1111111111111111
181883209,2,8,2.0,10,0.2
181885920,4,6,4.0,10,0.4
181895966,1,9,1.0,10,0.1
181923572,1,17,1.0,18,0.05555555555555555
181925348,1,18,1.0,19,0.05263157894736842
181929554,1,8,1.0,9,0.1111111111111111
181930663,4,6,4.0,10,0.4
181930776,8,2,2.0,10,0.2
181931549,4,4,4.0,8,0.5
181932338,1,8,1.0,9,0.1111111111111111
181933387,4,5,4.0,9,0.4444444444444444
181933425,7,3,3.0,10,0.3
181935614,4,6,4.0,10,0.4
181939490,5,4,4.0,9,0.4444444444444444
181942282,7,23,7.0,30,0.23333333333333334
181946583,3,6,3.0,9,0.3333333333333333
181965263,1,9,1.0,10,0.1
181983965,9,1,1.0,10,0.1
181984699,8,2,2.0,10,0.2
181988028,1,27,1.0,28,0.03571428571428571
181990077,1,9,1.0,10,0.1
181992183,2,8,2.0,10,0.2
182005311,1,27,1.0,28,0.03571428571428571
182011106,2,7,2.0,9,0.2222222222222222
182054280,1,16,1.0,17,0.058823529411764705
182061768,5,15,5.0,20,0.25
182065611,1,9,1.0,10,0.1
182078048,3,7,3.0,10,0.3
182104798,8,2,2.0,10,0.2
182105346,2,8,2.0,10,0.2
182105434,3,7,3.0,10,0.3
182105562,2,7,2.0,9,0.2222222222222222
182105726,4,6,4.0,10,0.4
182105912,3,7,3.0,10,0.3
182105952,6,4,4.0,10,0.4
182106254,9,1,1.0,10,0.1
182106489,7,1,1.0,8,0.125
182111090,3,7,3.0,10,0.3
182118404,1,8,1.0,9,0.1111111111111111
182129117,8,22,8.0,30,0.26666666666666666
182182483,25,3,3.0,28,0.10714285714285714
182189104,4,6,4.0,10,0.4
182195337,5,5,5.0,10,0.5
182198071,3,7,3.0,10,0.3
182198548,3,7,3.0,10,0.3
182200279,1,8,1.0,9,0.1111111111111111
182202482,2,7,2.0,9,0.2222222222222222
182210710,2,8,2.0,10,0.2
182211243,1,7,1.0,8,0.125
182214567,1,8,1.0,9,0.1111111111111111
182220663,1,9,1.0,10,0.1
182223236,8,21,8.0,29,0.27586206896551724
182224237,4,15,4.0,19,0.21052631578947367
182224464,2,8,2.0,10,0.2
182225856,2,8,2.0,10,0.2
182228867,16,3,3.0,19,0.15789473684210525
182237620,1,9,1.0,10,0.1
182242798,9,1,1.0,10,0.1
182256786,2,8,2.0,10,0.2
182258995,4,26,4.0,30,0.13333333333333333
182260847,2,7,2.0,9,0.2222222222222222
182261116,1,9,1.0,10,0.1
182263623,2,18,2.0,20,0.1
182276916,3,6,3.0,9,0.3333333333333333
182304256,1,8,1.0,9,0.1111111111111111
182316542,3,7,3.0,10,0.3
182317146,3,7,3.0,10,0.3
182319089,2,8,2.0,10,0.2
182324862,1,8,1.0,9,0.1111111111111111
182327043,2,8,2.0,10,0.2
182329568,2,7,2.0,9,0.2222222222222222
182334273,1,19,1.0,20,0.05
182347581,1,9,1.0,10,0.1
182349423,1,9,1.0,10,0.1
182350202,2,26,2.0,28,0.07142857142857142
182350783,2,8,2.0,10,0.2
182351093,1,9,1.0,10,0.1
182369451,1,7,1.0,8,0.125
182413268,8,1,1.0,9,0.1111111111111111
182413456,4,6,4.0,10,0.4
182425998,2,6,2.0,8,0.25
182460911,2,8,2.0,10,0.2
182466410,3,16,3.0,19,0.15789473684210525
182467674,7,3,3.0,10,0.3
182469290,3,26,3.0,29,0.10344827586206896
182469689,3,7,3.0,10,0.3
182469791,1,8,1.0,9,0.1111111111111111
182470333,1,9,1.0,10,0.1
182470454,4,24,4.0,28,0.14285714285714285
182517455,1,9,1.0,10,0.1
182527865,1,8,1.0,9,0.1111111111111111
182533228,1,9,1.0,10,0.1
182538728,9,1,1.0,10,0.1
182541580,2,8,2.0,10,0.2
182541761,1,9,1.0,10,0.1
182542478,4,6,4.0,10,0.4
182571345,1,19,1.0,20,0.05
182586533,14,16,14.0,30,0.4666666666666667
182591309,1,9,1.0,10,0.1
182592048,1,9,1.0,10,0.1
182597217,2,8,2.0,10,0.2
182597528,5,4,4.0,9,0.4444444444444444
182625977,2,16,2.0,18,0.1111111111111111
182643905,2,8,2.0,10,0.2
182683791,1,8,1.0,9,0.1111111111111111
182694847,1,18,1.0,19,0.05263157894736842
182720871,3,6,3.0,9,0.3333333333333333
182723780,1,8,1.0,9,0.1111111111111111
182727630,1,9,1.0,10,0.1
182729032,3,25,3.0,28,0.10714285714285714
182738349,2,8,2.0,10,0.2
182768278,6,4,4.0,10,0.4
182797391,2,7,2.0,9,0.2222222222222222
182821412,1,9,1.0,10,0.1
182821816,7,3,3.0,10,0.3
182827760,4,5,4.0,9,0.4444444444444444
182833637,11,16,11.0,27,0.4074074074074074
182866180,1,7,1.0,8,0.125
182888566,2,6,2.0,8,0.25
182890891,1,18,1.0,19,0.05263157894736842
182903688,1,8,1.0,9,0.1111111111111111
182904552,1,8,1.0,9,0.1111111111111111
182908036,2,8,2.0,10,0.2
182919493,3,6,3.0,9,0.3333333333333333
182920465,1,8,1.0,9,0.1111111111111111
182938077,7,3,3.0,10,0.3
182938203,6,4,4.0,10,0.4
182959070,2,27,2.0,29,0.06896551724137931
182976380,4,6,4.0,10,0.4
182976829,1,8,1.0,9,0.1111111111111111
182984932,3,6,3.0,9,0.3333333333333333
182986527,3,6,3.0,9,0.3333333333333333
182996027,1,18,1.0,19,0.05263157894736842
183001818,1,16,1.0,17,0.058823529411764705
183005052,1,9,1.0,10,0.1
183008785,4,23,4.0,27,0.14814814814814814
183014577,4,5,4.0,9,0.4444444444444444
183028164,2,6,2.0,8,0.25
183031898,8,2,2.0,10,0.2
183065397,5,5,5.0,10,0.5
183082864,5,3,3.0,8,0.375
183086102,3,7,3.0,10,0.3
183118546,23,5,5.0,28,0.17857142857142858
183118843,6,4,4.0,10,0.4
183129969,4,5,4.0,9,0.4444444444444444
183131315,7,3,3.0,10,0.3
183145643,1,9,1.0,10,0.1
183145991,9,1,1.0,10,0.1
183149143,1,18,1.0,19,0.05263157894736842
183193316,2,8,2.0,10,0.2
183223904,4,26,4.0,30,0.13333333333333333
183236581,2,8,2.0,10,0.2
183265987,8,1,1.0,9,0.1111111111111111
183273100,1,9,1.0,10,0.1
183275842,1,8,1.0,9,0.1111111111111111
183277602,3,6,3.0,9,0.3333333333333333
183291965,1,8,1.0,9,0.1111111111111111
183305103,1,9,1.0,10,0.1
183307874,1,7,1.0,8,0.125
183309212,9,1,1.0,10,0.1
183311318,3,7,3.0,10,0.3
183313677,1,7,1.0,8,0.125
183314348,1,8,1.0,9,0.1111111111111111
183314560,2,7,2.0,9,0.2222222222222222
183316222,3,7,3.0,10,0.3
183319163,2,7,2.0,9,0.2222222222222222
183319358,4,6,4.0,10,0.4
183320438,3,7,3.0,10,0.3
183326547,6,3,3.0,9,0.3333333333333333
183329296,4,13,4.0,17,0.23529411764705882
183330053,1,8,1.0,9,0.1111111111111111
183330989,1,16,1.0,17,0.058823529411764705
183337291,1,19,1.0,20,0.05
183338116,5,20,5.0,25,0.2
183338685,2,6,2.0,8,0.25
183338803,2,8,2.0,10,0.2
183339802,3,7,3.0,10,0.3
183340379,4,6,4.0,10,0.4
183341720,3,7,3.0,10,0.3
183359914,3,7,3.0,10,0.3
183376499,1,18,1.0,19,0.05263157894736842
183380993,3,7,3.0,10,0.3
183381360,2,8,2.0,10,0.2
183395342,12,15,12.0,27,0.4444444444444444
183396782,3,5,3.0,8,0.375
183399699,2,8,2.0,10,0.2
183400153,9,1,1.0,10,0.1
183400555,1,19,1.0,20,0.05
183403509,1,9,1.0,10,0.1
183406870,1,8,1.0,9,0.1111111111111111
183437480,1,8,1.0,9,0.1111111111111111
183478118,3,6,3.0,9,0.3333333333333333
183490044,1,9,1.0,10,0.1
183490065,2,8,2.0,10,0.2
183499469,1,8,1.0,9,0.1111111111111111
183500962,2,7,2.0,9,0.2222222222222222
183501675,1,9,1.0,10,0.1
183502269,1,29,1.0,30,0.03333333333333333
183504115,2,8,2.0,10,0.2
183513554,9,1,1.0,10,0.1
183519369,1,18,1.0,19,0.05263157894736842
183536628,6,22,6.0,28,0.21428571428571427
183538133,3,5,3.0,8,0.375
183553021,5,5,5.0,10,0.5
183553635,1,8,1.0,9,0.1111111111111111
183554838,2,7,2.0,9,0.2222222222222222
183556795,5,5,5.0,10,0.5
183558927,2,7,2.0,9,0.2222222222222222
183559497,7,3,3.0,10,0.3
183559597,4,6,4.0,10,0.4
183562296,7,1,1.0,8,0.125
183563560,6,3,3.0,9,0.3333333333333333
183563596,5,5,5.0,10,0.5
183569238,3,5,3.0,8,0.375
183574064,3,15,3.0,18,0.16666666666666666
183575556,26,2,2.0,28,0.07142857142857142
183576831,8,2,2.0,10,0.2
183577749,6,3,3.0,9,0.3333333333333333
183578736,4,6,4.0,10,0.4
183578861,2,8,2.0,10,0.2
183582029,3,6,3.0,9,0.3333333333333333
183583383,23,6,6.0,29,0.20689655172413793
183586599,2,7,2.0,9,0.2222222222222222
183588557,2,8,2.0,10,0.2
183608837,2,8,2.0,10,0.2
183629500,1,17,1.0,18,0.05555555555555555
183665781,9,1,1.0,10,0.1
183667533,1,9,1.0,10,0.1
183670366,1,9,1.0,10,0.1
183671642,2,6,2.0,8,0.25
183673471,9,1,1.0,10,0.1
183674596,2,7,2.0,9,0.2222222222222222
183677534,1,9,1.0,10,0.1
183679084,1,9,1.0,10,0.1
183681335,5,4,4.0,9,0.4444444444444444
183684647,1,8,1.0,9,0.1111111111111111
183717348,2,7,2.0,9,0.2222222222222222
183728022,1,9,1.0,10,0.1
183728343,1,19,1.0,20,0.05
183734837,2,8,2.0,10,0.2
183740153,6,4,4.0,10,0.4
183740527,3,6,3.0,9,0.3333333333333333
183741538,5,5,5.0,10,0.5
183742832,3,25,3.0,28,0.10714285714285714
183745089,3,7,3.0,10,0.3
183745583,8,2,2.0,10,0.2
183746269,1,9,1.0,10,0.1
183749856,1,9,1.0,10,0.1
183752579,1,16,1.0,17,0.058823529411764705
183760139,1,9,1.0,10,0.1
183760438,1,8,1.0,9,0.1111111111111111
183760766,2,27,2.0,29,0.06896551724137931
183760948,3,6,3.0,9,0.3333333333333333
183761071,1,9,1.0,10,0.1
183761687,2,8,2.0,10,0.2
183779353,4,6,4.0,10,0.4
183798587,1,9,1.0,10,0.1
183799076,1,9,1.0,10,0.1
183805513,6,3,3.0,9,0.3333333333333333
183807222,2,8,2.0,10,0.2
183820166,2,8,2.0,10,0.2
183821236,1,19,1.0,20,0.05
183825974,3,7,3.0,10,0.3
183826190,2,8,2.0,10,0.2
183836133,1,19,1.0,20,0.05
183837093,2,7,2.0,9,0.2222222222222222
183842926,1,26,1.0,27,0.037037037037037035
183844826,3,7,3.0,10,0.3
183845637,6,4,4.0,10,0.4
183845818,8,2,2.0,10,0.2
183848599,1,26,1.0,27,0.037037037037037035
183849530,2,8,2.0,10,0.2
183862473,2,8,2.0,10,0.2
183865445,1,8,1.0,9,0.1111111111111111
183873666,9,1,1.0,10,0.1
183878330,1,9,1.0,10,0.1
183884230,1,9,1.0,10,0.1
183889791,1,17,1.0,18,0.05555555555555555
183894753,1,9,1.0,10,0.1
183894791,5,5,5.0,10,0.5
183902129,9,1,1.0,10,0.1
183911536,3,7,3.0,10,0.3
183916828,1,8,1.0,9,0.1111111111111111
183928776,2,8,2.0,10,0.2
183929350,4,5,4.0,9,0.4444444444444444
183929590,1,8,1.0,9,0.1111111111111111
183934564,2,8,2.0,10,0.2
183938646,1,8,1.0,9,0.1111111111111111
183943954,1,19,1.0,20,0.05
183949276,7,3,3.0,10,0.3
183963994,3,17,3.0,20,0.15
183964987,1,9,1.0,10,0.1
183984175,8,2,2.0,10,0.2
183996635,1,9,1.0,10,0.1
184013718,25,5,5.0,30,0.16666666666666666
184019369,7,21,7.0,28,0.25
184032923,1,17,1.0,18,0.05555555555555555
184051768,1,19,1.0,20,0.05
184054307,4,5,4.0,9,0.4444444444444444
184078611,7,19,7.0,26,0.2692307692307692
184081889,1,8,1.0,9,0.1111111111111111
184096423,5,14,5.0,19,0.2631578947368421
184097751,1,8,1.0,9,0.1111111111111111
184123178,1,17,1.0,18,0.05555555555555555
184128150,1,9,1.0,10,0.1
184128721,1,8,1.0,9,0.1111111111111111
184138500,1,17,1.0,18,0.05555555555555555
184140706,5,5,5.0,10,0.5
184141159,1,9,1.0,10,0.1
184141483,5,5,5.0,10,0.5
184155556,1,9,1.0,10,0.1
184171851,1,19,1.0,20,0.05
184186140,3,16,3.0,19,0.15789473684210525
184207497,2,8,2.0,10,0.2
184251418,6,3,3.0,9,0.3333333333333333
184256669,1,9,1.0,10,0.1
184256891,1,18,1.0,19,0.05263157894736842
184262069,6,4,4.0,10,0.4
184282125,2,7,2.0,9,0.2222222222222222
184282771,8,1,1.0,9,0.1111111111111111
184284445,1,18,1.0,19,0.05263157894736842
184295501,6,4,4.0,10,0.4
184304262,2,17,2.0,19,0.10526315789473684
184312768,1,8,1.0,9,0.1111111111111111
184315921,4,6,4.0,10,0.4
184324183,1,7,1.0,8,0.125
184324559,2,7,2.0,9,0.2222222222222222
184363283,1,18,1.0,19,0.05263157894736842
184377886,5,5,5.0,10,0.5
184380247,3,7,3.0,10,0.3
184381283,2,6,2.0,8,0.25
184382995,4,6,4.0,10,0.4
184385688,4,5,4.0,9,0.4444444444444444
184409623,1,19,1.0,20,0.05
184413541,4,6,4.0,10,0.4
184415519,1,9,1.0,10,0.1
184416423,1,9,1.0,10,0.1
184417234,5,4,4.0,9,0.4444444444444444
184418919,9,1,1.0,10,0.1
184419362,8,1,1.0,9,0.1111111111111111
184458993,2,8,2.0,10,0.2
184485099,7,3,3.0,10,0.3
184490596,6,4,4.0,10,0.4
184490730,7,3,3.0,10,0.3
184515415,1,19,1.0,20,0.05
184545398,1,9,1.0,10,0.1
184579738,1,7,1.0,8,0.125
184639056,1,9,1.0,10,0.1
184639419,7,2,2.0,9,0.2222222222222222
184672874,5,15,5.0,20,0.25
184683509,7,3,3.0,10,0.3
184683934,2,8,2.0,10,0.2
184685144,3,6,3.0,9,0.3333333333333333
184732053,2,6,2.0,8,0.25
184732238,2,8,2.0,10,0.2
184734383,2,8,2.0,10,0.2
184736569,1,9,1.0,10,0.1
184778191,24,3,3.0,27,0.1111111111111111
184779940,6,3,3.0,9,0.3333333333333333
184784598,7,2,2.0,9,0.2222222222222222
184787740,8,2,2.0,10,0.2
184793629,4,6,4.0,10,0.4
184795002,9,1,1.0,10,0.1
184796810,3,6,3.0,9,0.3333333333333333
184801209,1,8,1.0,9,0.1111111111111111
184809442,6,4,4.0,10,0.4
184831419,1,18,1.0,19,0.05263157894736842
184838043,1,8,1.0,9,0.1111111111111111
184849194,7,3,3.0,10,0.3
184854527,2,16,2.0,18,0.1111111111111111
184859030,1,8,1.0,9,0.1111111111111111
184895188,3,7,3.0,10,0.3
184938074,2,7,2.0,9,0.2222222222222222
184981279,2,8,2.0,10,0.2
184986661,6,4,4.0,10,0.4
184989082,7,2,2.0,9,0.2222222222222222
184989534,8,1,1.0,9,0.1111111111111111
184990175,1,8,1.0,9,0.1111111111111111
185004834,2,7,2.0,9,0.2222222222222222
185039244,2,8,2.0,10,0.2
185063295,1,19,1.0,20,0.05
185072584,1,18,1.0,19,0.05263157894736842
185076570,1,8,1.0,9,0.1111111111111111
185082998,1,18,1.0,19,0.05263157894736842
185084611,3,6,3.0,9,0.3333333333333333
185116536,1,17,1.0,18,0.05555555555555555
185125491,4,5,4.0,9,0.4444444444444444
185126149,1,8,1.0,9,0.1111111111111111
185126342,3,6,3.0,9,0.3333333333333333
185128763,5,5,5.0,10,0.5
185143354,9,1,1.0,10,0.1
185147984,1,16,1.0,17,0.058823529411764705
185151168,2,8,2.0,10,0.2
185155798,2,8,2.0,10,0.2
185178050,27,2,2.0,29,0.06896551724137931
185180588,1,8,1.0,9,0.1111111111111111
185185858,2,7,2.0,9,0.2222222222222222
185207949,1,9,1.0,10,0.1
185216609,1,9,1.0,10,0.1
185234877,1,9,1.0,10,0.1
185268266,6,3,3.0,9,0.3333333333333333
185280526,1,9,1.0,10,0.1
185289029,7,1,1.0,8,0.125
185292445,8,1,1.0,9,0.1111111111111111
185296649,2,26,2.0,28,0.07142857142857142
185303289,2,8,2.0,10,0.2
185303974,2,8,2.0,10,0.2
185311135,6,3,3.0,9,0.3333333333333333
185336135,6,3,3.0,9,0.3333333333333333
185362415,1,19,1.0,20,0.05
185374003,1,28,1.0,29,0.034482758620689655
185379525,1,8,1.0,9,0.1111111111111111
185383638,1,18,1.0,19,0.05263157894736842
185393649,1,8,1.0,9,0.1111111111111111
185409375,1,18,1.0,19,0.05263157894736842
185427628,1,8,1.0,9,0.1111111111111111
185436261,8,1,1.0,9,0.1111111111111111
185436896,6,3,3.0,9,0.3333333333333333
185436964,2,6,2.0,8,0.25
185437052,3,7,3.0,10,0.3
185452482,2,7,2.0,9,0.2222222222222222
185467087,7,1,1.0,8,0.125
185469204,1,9,1.0,10,0.1
185492522,1,18,1.0,19,0.05263157894736842
185497515,3,7,3.0,10,0.3
185497965,4,4,4.0,8,0.5
185500645,6,4,4.0,10,0.4
185509987,1,9,1.0,10,0.1
185518920,1,9,1.0,10,0.1
185551605,1,9,1.0,10,0.1
185554416,1,18,1.0,19,0.05263157894736842
185563391,1,9,1.0,10,0.1
185563448,8,21,8.0,29,0.27586206896551724
185574084,6,4,4.0,10,0.4
185623194,2,8,2.0,10,0.2
185623665,2,7,2.0,9,0.2222222222222222
185624266,1,9,1.0,10,0.1
185624861,2,8,2.0,10,0.2
185625724,1,9,1.0,10,0.1
185631857,1,9,1.0,10,0.1
185658826,3,7,3.0,10,0.3
185666490,1,8,1.0,9,0.1111111111111111
185667638,2,6,2.0,8,0.25
185672971,1,9,1.0,10,0.1
185693030,3,5,3.0,8,0.375
185705181,1,9,1.0,10,0.1
185708826,1,9,1.0,10,0.1
185711906,1,9,1.0,10,0.1
185722805,1,9,1.0,10,0.1
185724295,2,7,2.0,9,0.2222222222222222
185734698,3,7,3.0,10,0.3
185737192,1,9,1.0,10,0.1
185741530,24,3,3.0,27,0.1111111111111111
185751386,3,17,3.0,20,0.15
185765756,3,25,3.0,28,0.10714285714285714
185774063,1,8,1.0,9,0.1111111111111111
185788575,7,3,3.0,10,0.3
185793430,2,8,2.0,10,0.2
185799715,1,8,1.0,9,0.1111111111111111
185806723,3,7,3.0,10,0.3
185820049,2,27,2.0,29,0.06896551724137931
185833300,2,7,2.0,9,0.2222222222222222
185836120,1,8,1.0,9,0.1111111111111111
185839000,2,8,2.0,10,0.2
185850374,3,7,3.0,10,0.3
185852625,3,7,3.0,10,0.3
185852807,5,5,5.0,10,0.5
185853121,1,9,1.0,10,0.1
185853649,1,9,1.0,10,0.1
185865822,8,2,2.0,10,0.2
185868690,1,8,1.0,9,0.1111111111111111
185869330,13,6,6.0,19,0.3157894736842105
185888002,1,8,1.0,9,0.1111111111111111
185904168,8,21,8.0,29,0.27586206896551724
185917798,2,8,2.0,10,0.2
185928838,1,8,1.0,9,0.1111111111111111
185929596,1,9,1.0,10,0.1
185939953,1,9,1.0,10,0.1
185943999,1,8,1.0,9,0.1111111111111111
185947895,1,18,1.0,19,0.05263157894736842
185957612,1,29,1.0,30,0.03333333333333333
185965912,2,24,2.0,26,0.07692307692307693
185978015,1,17,1.0,18,0.05555555555555555
186007314,1,9,1.0,10,0.1
186012021,4,6,4.0,10,0.4
186040312,1,8,1.0,9,0.1111111111111111
186120003,7,2,2.0,9,0.2222222222222222
186160244,1,9,1.0,10,0.1
186175042,2,8,2.0,10,0.2
186180748,3,7,3.0,10,0.3
186180886,1,9,1.0,10,0.1
186191402,4,25,4.0,29,0.13793103448275862
186195986,1,7,1.0,8,0.125
186197494,4,5,4.0,9,0.4444444444444444
186201600,3,6,3.0,9,0.3333333333333333
186205886,1,9,1.0,10,0.1
186226962,7,2,2.0,9,0.2222222222222222
186228746,2,7,2.0,9,0.2222222222222222
186231262,2,6,2.0,8,0.25
186231889,2,8,2.0,10,0.2
186232286,3,7,3.0,10,0.3
186234543,2,6,2.0,8,0.25
186234764,4,6,4.0,10,0.4
186235609,1,7,1.0,8,0.125
186235929,1,9,1.0,10,0.1
186236692,1,9,1.0,10,0.1
186240387,3,7,3.0,10,0.3
186241248,5,5,5.0,10,0.5
186244084,11,16,11.0,27,0.4074074074074074
186244370,5,5,5.0,10,0.5
186245326,11,15,11.0,26,0.4230769230769231
186246169,4,6,4.0,10,0.4
186246947,3,7,3.0,10,0.3
186273486,1,9,1.0,10,0.1
186276186,2,26,2.0,28,0.07142857142857142
186287112,6,4,4.0,10,0.4
186302049,6,4,4.0,10,0.4
186312117,1,8,1.0,9,0.1111111111111111
186312565,6,14,6.0,20,0.3
186314076,1,9,1.0,10,0.1
186314794,1,9,1.0,10,0.1
186315820,1,9,1.0,10,0.1
186315827,1,9,1.0,10,0.1
186316214,2,8,2.0,10,0.2
186322189,1,9,1.0,10,0.1
186324237,1,9,1.0,10,0.1
186335334,1,8,1.0,9,0.1111111111111111
186338799,3,7,3.0,10,0.3
186339172,1,9,1.0,10,0.1
186358957,2,8,2.0,10,0.2
186375140,3,7,3.0,10,0.3
186380699,2,16,2.0,18,0.1111111111111111
186380973,2,8,2.0,10,0.2
186382270,2,8,2.0,10,0.2
186383073,7,11,7.0,18,0.3888888888888889
186392661,1,18,1.0,19,0.05263157894736842
186400335,3,6,3.0,9,0.3333333333333333
186409308,1,9,1.0,10,0.1
186409595,2,7,2.0,9,0.2222222222222222
186411311,2,18,2.0,20,0.1
186447691,1,8,1.0,9,0.1111111111111111
186454810,1,18,1.0,19,0.05263157894736842
186501969,5,25,5.0,30,0.16666666666666666
186503186,1,8,1.0,9,0.1111111111111111
186526739,4,6,4.0,10,0.4
186555263,1,8,1.0,9,0.1111111111111111
186560599,1,19,1.0,20,0.05
186560969,8,1,1.0,9,0.1111111111111111
186561444,3,6,3.0,9,0.3333333333333333
186561685,2,7,2.0,9,0.2222222222222222
186562296,2,7,2.0,9,0.2222222222222222
186564041,1,19,1.0,20,0.05
186589622,1,7,1.0,8,0.125
186590335,1,9,1.0,10,0.1
186603774,1,9,1.0,10,0.1
186636301,6,4,4.0,10,0.4
186669321,9,1,1.0,10,0.1
186670003,1,9,1.0,10,0.1
186670263,2,8,2.0,10,0.2
186671046,2,8,2.0,10,0.2
186671393,1,26,1.0,27,0.037037037037037035
186672092,1,16,1.0,17,0.058823529411764705
186672683,1,9,1.0,10,0.1
186672947,8,1,1.0,9,0.1111111111111111
186675482,7,3,3.0,10,0.3
186680446,1,9,1.0,10,0.1
186680641,2,8,2.0,10,0.2
186681889,1,9,1.0,10,0.1
186682323,20,8,8.0,28,0.2857142857142857
186684320,9,1,1.0,10,0.1
186684488,7,2,2.0,9,0.2222222222222222
186684999,9,1,1.0,10,0.1
186685686,1,17,1.0,18,0.05555555555555555
186686498,6,4,4.0,10,0.4
186712844,6,3,3.0,9,0.3333333333333333
186714570,1,8,1.0,9,0.1111111111111111
186715262,3,6,3.0,9,0.3333333333333333
186715848,1,8,1.0,9,0.1111111111111111
186716133,2,8,2.0,10,0.2
186726440,3,6,3.0,9,0.3333333333333333
186727566,3,15,3.0,18,0.16666666666666666
186729789,8,1,1.0,9,0.1111111111111111
186730185,5,5,5.0,10,0.5
186734083,1,8,1.0,9,0.1111111111111111
186739884,1,9,1.0,10,0.1
186743975,1,8,1.0,9,0.1111111111111111
186747810,1,16,1.0,17,0.058823529411764705
186756903,3,6,3.0,9,0.3333333333333333
186758025,4,5,4.0,9,0.4444444444444444
186759252,3,17,3.0,20,0.15
186767364,2,7,2.0,9,0.2222222222222222
186789486,3,7,3.0,10,0.3
186789516,1,9,1.0,10,0.1
186798560,1,9,1.0,10,0.1
186800400,3,6,3.0,9,0.3333333333333333
186807344,1,9,1.0,10,0.1
186811118,1,9,1.0,10,0.1
186811160,2,28,2.0,30,0.06666666666666667
186815641,4,6,4.0,10,0.4
186816463,1,8,1.0,9,0.1111111111111111
186823190,8,2,2.0,10,0.2
186823758,2,8,2.0,10,0.2
186825100,2,8,2.0,10,0.2
186829738,1,8,1.0,9,0.1111111111111111
186833063,1,17,1.0,18,0.05555555555555555
186848415,3,6,3.0,9,0.3333333333333333
186849239,11,13,11.0,24,0.4583333333333333
186849727,1,9,1.0,10,0.1
186877674,1,8,1.0,9,0.1111111111111111
186880202,2,7,2.0,9,0.2222222222222222
186882707,2,8,2.0,10,0.2
186883105,9,1,1.0,10,0.1
186885114,2,6,2.0,8,0.25
186885964,6,4,4.0,10,0.4
186888464,4,6,4.0,10,0.4
186889914,5,5,5.0,10,0.5
186890250,2,8,2.0,10,0.2
186890359,3,16,3.0,19,0.15789473684210525
186890789,2,7,2.0,9,0.2222222222222222
186890992,8,20,8.0,28,0.2857142857142857
186891245,5,5,5.0,10,0.5
186891778,2,7,2.0,9,0.2222222222222222
186891944,4,5,4.0,9,0.4444444444444444
186892154,2,8,2.0,10,0.2
186892439,5,5,5.0,10,0.5
186901638,1,9,1.0,10,0.1
186907733,5,5,5.0,10,0.5
186908114,1,9,1.0,10,0.1
186908372,4,5,4.0,9,0.4444444444444444
186908440,4,6,4.0,10,0.4
186911717,2,8,2.0,10,0.2
186913649,4,24,4.0,28,0.14285714285714285
186914800,2,8,2.0,10,0.2
186930094,2,7,2.0,9,0.2222222222222222
186930532,2,8,2.0,10,0.2
186935806,3,5,3.0,8,0.375
186936336,2,6,2.0,8,0.25
186939390,6,22,6.0,28,0.21428571428571427
186948459,2,8,2.0,10,0.2
186948974,6,4,4.0,10,0.4
186950289,5,25,5.0,30,0.16666666666666666
186950793,4,16,4.0,20,0.2
186951522,2,8,2.0,10,0.2
186953225,7,2,2.0,9,0.2222222222222222
186953330,3,6,3.0,9,0.3333333333333333
186954070,4,4,4.0,8,0.5
186980981,1,8,1.0,9,0.1111111111111111
186992092,5,4,4.0,9,0.4444444444444444
187018977,1,9,1.0,10,0.1
187019406,5,5,5.0,10,0.5
187022566,2,8,2.0,10,0.2
187023185,1,9,1.0,10,0.1
187023518,3,7,3.0,10,0.3
187024268,1,8,1.0,9,0.1111111111111111
187039391,2,8,2.0,10,0.2
187056596,1,8,1.0,9,0.1111111111111111
187060013,9,1,1.0,10,0.1
187088956,1,9,1.0,10,0.1
187094223,4,6,4.0,10,0.4
187103471,2,16,2.0,18,0.1111111111111111
187106617,1,9,1.0,10,0.1
187107532,2,8,2.0,10,0.2
187108783,3,7,3.0,10,0.3
187109410,3,17,3.0,20,0.15
187110145,4,6,4.0,10,0.4
187111445,3,6,3.0,9,0.3333333333333333
187117919,1,8,1.0,9,0.1111111111111111
187121317,1,9,1.0,10,0.1
187121495,6,3,3.0,9,0.3333333333333333
187126004,2,8,2.0,10,0.2
187128965,1,8,1.0,9,0.1111111111111111
187129614,1,9,1.0,10,0.1
187130394,4,5,4.0,9,0.4444444444444444
187130467,5,4,4.0,9,0.4444444444444444
187130732,4,5,4.0,9,0.4444444444444444
187133088,2,8,2.0,10,0.2
187143827,4,5,4.0,9,0.4444444444444444
187170142,7,3,3.0,10,0.3
187171155,2,7,2.0,9,0.2222222222222222
187176138,2,6,2.0,8,0.25
187184240,7,3,3.0,10,0.3
187184880,9,1,1.0,10,0.1
187185323,6,4,4.0,10,0.4
187185451,4,5,4.0,9,0.4444444444444444
187189548,1,8,1.0,9,0.1111111111111111
187193673,1,8,1.0,9,0.1111111111111111
187199480,4,6,4.0,10,0.4
187207751,6,4,4.0,10,0.4
187213339,17,13,13.0,30,0.43333333333333335
187222719,1,9,1.0,10,0.1
187231018,2,8,2.0,10,0.2
187245169,1,7,1.0,8,0.125
187256651,4,6,4.0,10,0.4
187260644,1,19,1.0,20,0.05
187261762,4,6,4.0,10,0.4
187262597,3,25,3.0,28,0.10714285714285714
187264195,1,9,1.0,10,0.1
187271342,9,1,1.0,10,0.1
187306226,1,9,1.0,10,0.1
187317213,1,19,1.0,20,0.05
187319544,1,18,1.0,19,0.05263157894736842
187319783,1,8,1.0,9,0.1111111111111111
187327048,4,5,4.0,9,0.4444444444444444
187339323,6,2,2.0,8,0.25
187339409,4,6,4.0,10,0.4
187343512,1,9,1.0,10,0.1
187345506,1,9,1.0,10,0.1
187350654,1,9,1.0,10,0.1
187358906,1,8,1.0,9,0.1111111111111111
187363209,2,8,2.0,10,0.2
187366414,7,2,2.0,9,0.2222222222222222
187367163,1,9,1.0,10,0.1
187369282,1,8,1.0,9,0.1111111111111111
187372645,5,4,4.0,9,0.4444444444444444
187377164,3,7,3.0,10,0.3
187382261,1,8,1.0,9,0.1111111111111111
187382353,2,8,2.0,10,0.2
187384562,2,6,2.0,8,0.25
187395753,1,9,1.0,10,0.1
187415554,1,16,1.0,17,0.058823529411764705
187417836,1,9,1.0,10,0.1
187422060,1,9,1.0,10,0.1
187423015,1,18,1.0,19,0.05263157894736842
187424268,5,4,4.0,9,0.4444444444444444
187426325,1,8,1.0,9,0.1111111111111111
187428352,1,9,1.0,10,0.1
187434562,1,7,1.0,8,0.125
187466577,15,8,8.0,23,0.34782608695652173
187508102,2,8,2.0,10,0.2
187510400,1,28,1.0,29,0.034482758620689655
187511505,5,5,5.0,10,0.5
187511906,3,7,3.0,10,0.3
187523134,1,9,1.0,10,0.1
187544551,2,8,2.0,10,0.2
187549561,1,9,1.0,10,0.1
187549705,3,23,3.0,26,0.11538461538461539
187549854,12,8,8.0,20,0.4
187569588,4,5,4.0,9,0.4444444444444444
187570170,5,5,5.0,10,0.5
187582740,1,9,1.0,10,0.1
187612048,3,6,3.0,9,0.3333333333333333
187622461,4,5,4.0,9,0.4444444444444444
187622465,2,8,2.0,10,0.2
187638262,3,6,3.0,9,0.3333333333333333
187641123,1,7,1.0,8,0.125
187642678,7,2,2.0,9,0.2222222222222222
187643987,5,4,4.0,9,0.4444444444444444
187651395,9,1,1.0,10,0.1
187654090,2,8,2.0,10,0.2
187665885,4,6,4.0,10,0.4
187666640,2,8,2.0,10,0.2
187669539,1,8,1.0,9,0.1111111111111111
187670788,2,8,2.0,10,0.2
187679407,2,7,2.0,9,0.2222222222222222
187703030,3,7,3.0,10,0.3
187731034,1,9,1.0,10,0.1
187736777,2,8,2.0,10,0.2
187744459,1,17,1.0,18,0.05555555555555555
187765552,8,2,2.0,10,0.2
187765807,6,4,4.0,10,0.4
187767321,4,14,4.0,18,0.2222222222222222
187771745,4,16,4.0,20,0.2
187779946,1,9,1.0,10,0.1
187785110,1,18,1.0,19,0.05263157894736842
187797838,1,9,1.0,10,0.1
187808321,2,8,2.0,10,0.2
187816351,1,9,1.0,10,0.1
187826026,1,7,1.0,8,0.125
187827856,1,8,1.0,9,0.1111111111111111
187831211,5,25,5.0,30,0.16666666666666666
187834639,2,8,2.0,10,0.2
187848695,2,7,2.0,9,0.2222222222222222
187849781,4,5,4.0,9,0.4444444444444444
187850391,2,8,2.0,10,0.2
187857359,8,1,1.0,9,0.1111111111111111
187877621,2,18,2.0,20,0.1
187896349,4,6,4.0,10,0.4
187922718,1,19,1.0,20,0.05
187941381,2,6,2.0,8,0.25
187957352,8,2,2.0,10,0.2
187957939,1,8,1.0,9,0.1111111111111111
187959542,2,8,2.0,10,0.2
187968491,6,3,3.0,9,0.3333333333333333
187979191,1,9,1.0,10,0.1
188000015,7,2,2.0,9,0.2222222222222222
188000940,2,8,2.0,10,0.2
188002153,18,11,11.0,29,0.3793103448275862
188004554,1,9,1.0,10,0.1
188005408,8,2,2.0,10,0.2
188016886,2,8,2.0,10,0.2
188050470,1,16,1.0,17,0.058823529411764705
188061665,5,3,3.0,8,0.375
188061993,1,9,1.0,10,0.1
188062624,2,8,2.0,10,0.2
188063251,28,1,1.0,29,0.034482758620689655
188066835,8,2,2.0,10,0.2
188090552,6,4,4.0,10,0.4
188092186,3,6,3.0,9,0.3333333333333333
188096752,2,8,2.0,10,0.2
188097143,1,7,1.0,8,0.125
188101560,1,7,1.0,8,0.125
188104130,2,7,2.0,9,0.2222222222222222
188108382,1,9,1.0,10,0.1
188108692,5,5,5.0,10,0.5
188108980,1,9,1.0,10,0.1
188109707,1,9,1.0,10,0.1
188110434,3,6,3.0,9,0.3333333333333333
188112361,1,9,1.0,10,0.1
188124988,3,16,3.0,19,0.15789473684210525
188126831,1,9,1.0,10,0.1
188127238,1,9,1.0,10,0.1
188150830,3,16,3.0,19,0.15789473684210525
188175443,1,8,1.0,9,0.1111111111111111
188179682,1,8,1.0,9,0.1111111111111111
188184965,1,8,1.0,9,0.1111111111111111
188185413,1,18,1.0,19,0.05263157894736842
188186013,7,3,3.0,10,0.3
188186401,2,8,2.0,10,0.2
188186783,3,5,3.0,8,0.375
188187225,2,8,2.0,10,0.2
188188276,6,4,4.0,10,0.4
188195127,7,1,1.0,8,0.125
188211853,2,8,2.0,10,0.2
188215667,2,6,2.0,8,0.25
188219661,4,25,4.0,29,0.13793103448275862
188228110,1,29,1.0,30,0.03333333333333333
188229862,2,8,2.0,10,0.2
188231414,1,8,1.0,9,0.1111111111111111
188232581,1,9,1.0,10,0.1
188246191,1,18,1.0,19,0.05263157894736842
188252260,14,14,14.0,28,0.5
188275315,7,1,1.0,8,0.125
188330509,1,17,1.0,18,0.05555555555555555
188348539,3,6,3.0,9,0.3333333333333333
188352882,5,4,4.0,9,0.4444444444444444
188372321,1,9,1.0,10,0.1
188374986,4,25,4.0,29,0.13793103448275862
188385852,8,2,2.0,10,0.2
188402784,1,9,1.0,10,0.1
188408979,2,7,2.0,9,0.2222222222222222
188442815,2,18,2.0,20,0.1
188450716,1,8,1.0,9,0.1111111111111111
188452228,1,9,1.0,10,0.1
188458877,1,9,1.0,10,0.1
188466159,1,9,1.0,10,0.1
188471338,2,7,2.0,9,0.2222222222222222
188487936,2,17,2.0,19,0.10526315789473684
188493325,1,9,1.0,10,0.1
188503901,2,7,2.0,9,0.2222222222222222
188509911,1,19,1.0,20,0.05
188514026,6,3,3.0,9,0.3333333333333333
188518157,2,17,2.0,19,0.10526315789473684
188530141,1,19,1.0,20,0.05
188532325,2,7,2.0,9,0.2222222222222222
188551622,1,9,1.0,10,0.1
188552443,4,6,4.0,10,0.4
188552896,1,9,1.0,10,0.1
188555473,2,8,2.0,10,0.2
188580137,3,6,3.0,9,0.3333333333333333
188610439,4,24,4.0,28,0.14285714285714285
188638852,1,15,1.0,16,0.0625
188650224,3,7,3.0,10,0.3
188665575,1,17,1.0,18,0.05555555555555555
188686705,3,7,3.0,10,0.3
188699829,1,9,1.0,10,0.1
188714436,7,3,3.0,10,0.3
188716181,4,26,4.0,30,0.13333333333333333
188719728,2,17,2.0,19,0.10526315789473684
188730627,8,1,1.0,9,0.1111111111111111
188743244,4,16,4.0,20,0.2
188755070,8,2,2.0,10,0.2
188767108,2,8,2.0,10,0.2
188767892,2,15,2.0,17,0.11764705882352941
188773001,2,7,2.0,9,0.2222222222222222
188773349,1,9,1.0,10,0.1
188781433,3,6,3.0,9,0.3333333333333333
188808959,1,8,1.0,9,0.1111111111111111
188826529,7,12,7.0,19,0.3684210526315789
188844433,1,17,1.0,18,0.05555555555555555
188861563,3,7,3.0,10,0.3
188864687,1,9,1.0,10,0.1
188891256,1,8,1.0,9,0.1111111111111111
188892012,2,8,2.0,10,0.2
188900266,1,9,1.0,10,0.1
188927795,3,6,3.0,9,0.3333333333333333
188927867,3,25,3.0,28,0.10714285714285714
188928638,3,7,3.0,10,0.3
188932002,5,3,3.0,8,0.375
188934439,4,5,4.0,9,0.4444444444444444
188934459,1,9,1.0,10,0.1
188979726,1,7,1.0,8,0.125
188984473,2,7,2.0,9,0.2222222222222222
188985092,1,8,1.0,9,0.1111111111111111
188986058,5,4,4.0,9,0.4444444444444444
189004311,2,7,2.0,9,0.2222222222222222
189009131,2,17,2.0,19,0.10526315789473684
189027789,16,4,4.0,20,0.2
189031368,2,8,2.0,10,0.2
189034357,2,7,2.0,9,0.2222222222222222
189034783,1,9,1.0,10,0.1
189036916,3,7,3.0,10,0.3
189037356,1,17,1.0,18,0.05555555555555555
189043079,1,9,1.0,10,0.1
189089407,1,9,1.0,10,0.1
189097951,3,7,3.0,10,0.3
189138234,7,12,7.0,19,0.3684210526315789
189140122,1,8,1.0,9,0.1111111111111111
189141245,4,6,4.0,10,0.4
189164284,8,2,2.0,10,0.2
189184131,4,5,4.0,9,0.4444444444444444
189184343,2,8,2.0,10,0.2
189184658,2,8,2.0,10,0.2
189186371,3,7,3.0,10,0.3
189187943,6,22,6.0,28,0.21428571428571427
189188295,3,6,3.0,9,0.3333333333333333
189195445,2,7,2.0,9,0.2222222222222222
189198377,23,5,5.0,28,0.17857142857142858
189198904,2,17,2.0,19,0.10526315789473684
189215231,1,9,1.0,10,0.1
189217727,1,7,1.0,8,0.125
189217779,4,26,4.0,30,0.13333333333333333
189218310,2,8,2.0,10,0.2
189226055,2,8,2.0,10,0.2
189226675,1,8,1.0,9,0.1111111111111111
189271002,3,25,3.0,28,0.10714285714285714
189286957,1,9,1.0,10,0.1
189287996,1,8,1.0,9,0.1111111111111111
189296014,3,14,3.0,17,0.17647058823529413
189300457,2,8,2.0,10,0.2
189301771,6,4,4.0,10,0.4
189308522,6,22,6.0,28,0.21428571428571427
189309884,15,12,12.0,27,0.4444444444444444
189310226,5,4,4.0,9,0.4444444444444444
189317911,4,6,4.0,10,0.4
189326291,9,1,1.0,10,0.1
189328364,5,5,5.0,10,0.5
189336045,8,2,2.0,10,0.2
189345169,17,13,13.0,30,0.43333333333333335
189348660,1,9,1.0,10,0.1
189354918,1,9,1.0,10,0.1
189367626,2,8,2.0,10,0.2
189403226,4,5,4.0,9,0.4444444444444444
189404486,2,8,2.0,10,0.2
189418544,2,8,2.0,10,0.2
189430248,1,18,1.0,19,0.05263157894736842
189443689,1,7,1.0,8,0.125
189458002,3,5,3.0,8,0.375
189465942,1,9,1.0,10,0.1
189480955,5,5,5.0,10,0.5
189481389,1,9,1.0,10,0.1
189501602,1,8,1.0,9,0.1111111111111111
189509395,1,8,1.0,9,0.1111111111111111
189519991,1,17,1.0,18,0.05555555555555555
189525519,1,9,1.0,10,0.1
189535277,1,7,1.0,8,0.125
189542757,6,4,4.0,10,0.4
189546547,1,9,1.0,10,0.1
189550049,1,9,1.0,10,0.1
189557923,1,8,1.0,9,0.1111111111111111
189558203,4,6,4.0,10,0.4
189564185,8,2,2.0,10,0.2
189571115,2,8,2.0,10,0.2
189615212,1,8,1.0,9,0.1111111111111111
189618832,3,6,3.0,9,0.3333333333333333
189624230,5,5,5.0,10,0.5
189627949,4,23,4.0,27,0.14814814814814814
189643706,9,1,1.0,10,0.1
189650511,2,8,2.0,10,0.2
189655137,5,5,5.0,10,0.5
189663373,1,8,1.0,9,0.1111111111111111
189677916,1,8,1.0,9,0.1111111111111111
189679121,1,9,1.0,10,0.1
189695954,3,6,3.0,9,0.3333333333333333
189708906,1,9,1.0,10,0.1
189713080,8,1,1.0,9,0.1111111111111111
189714583,2,8,2.0,10,0.2
189721685,4,6,4.0,10,0.4
189721737,1,9,1.0,10,0.1
189721879,1,9,1.0,10,0.1
189738244,2,16,2.0,18,0.1111111111111111
189738533,3,16,3.0,19,0.15789473684210525
189744153,4,5,4.0,9,0.4444444444444444
189750683,2,17,2.0,19,0.10526315789473684
189759802,1,19,1.0,20,0.05
189774352,1,8,1.0,9,0.1111111111111111
189775153,2,7,2.0,9,0.2222222222222222
189784671,6,4,4.0,10,0.4
189785621,1,8,1.0,9,0.1111111111111111
189790195,7,3,3.0,10,0.3
189791945,5,5,5.0,10,0.5
189795307,2,8,2.0,10,0.2
189803756,2,8,2.0,10,0.2
189813989,8,2,2.0,10,0.2
189814234,5,24,5.0,29,0.1724137931034483
189815101,1,8,1.0,9,0.1111111111111111
189819277,4,6,4.0,10,0.4
189829505,12,8,8.0,20,0.4
189840758,2,8,2.0,10,0.2
189842136,3,7,3.0,10,0.3
189844818,2,8,2.0,10,0.2
189845718,3,7,3.0,10,0.3
189848348,6,4,4.0,10,0.4
189849955,7,3,3.0,10,0.3
189855579,3,6,3.0,9,0.3333333333333333
189857136,5,5,5.0,10,0.5
189858066,5,4,4.0,9,0.4444444444444444
189868925,2,8,2.0,10,0.2
189873687,8,2,2.0,10,0.2
189874818,7,2,2.0,9,0.2222222222222222
189875226,5,5,5.0,10,0.5
189875574,5,5,5.0,10,0.5
189875770,6,24,6.0,30,0.2
189882212,1,9,1.0,10,0.1
189890776,1,9,1.0,10,0.1
189896391,4,15,4.0,19,0.21052631578947367
189897563,1,9,1.0,10,0.1
189898783,1,9,1.0,10,0.1
189906076,8,1,1.0,9,0.1111111111111111
189947155,2,7,2.0,9,0.2222222222222222
189967340,1,8,1.0,9,0.1111111111111111
190005494,2,18,2.0,20,0.1
190027124,5,4,4.0,9,0.4444444444444444
190031548,4,6,4.0,10,0.4
190034372,1,9,1.0,10,0.1
190034809,2,8,2.0,10,0.2
190035049,4,4,4.0,8,0.5
190036691,1,8,1.0,9,0.1111111111111111
190037051,8,21,8.0,29,0.27586206896551724
190048058,5,5,5.0,10,0.5
190048444,9,1,1.0,10,0.1
190052945,5,4,4.0,9,0.4444444444444444
190061048,1,27,1.0,28,0.03571428571428571
190064579,3,15,3.0,18,0.16666666666666666
190066310,6,4,4.0,10,0.4
190067734,3,7,3.0,10,0.3
190068079,1,9,1.0,10,0.1
190069612,1,9,1.0,10,0.1
190069830,2,8,2.0,10,0.2
190071353,1,9,1.0,10,0.1
190072957,1,9,1.0,10,0.1
190080805,2,8,2.0,10,0.2
190085169,6,3,3.0,9,0.3333333333333333
190085460,3,7,3.0,10,0.3
190085660,1,9,1.0,10,0.1
190086490,3,7,3.0,10,0.3
190090851,8,2,2.0,10,0.2
190097722,1,9,1.0,10,0.1
190098910,3,7,3.0,10,0.3
190099001,5,4,4.0,9,0.4444444444444444
190099925,6,4,4.0,10,0.4
190100291,1,9,1.0,10,0.1
190102988,5,4,4.0,9,0.4444444444444444
190104778,19,1,1.0,20,0.05
190105022,7,1,1.0,8,0.125
190116877,4,6,4.0,10,0.4
190117509,1,9,1.0,10,0.1
190118739,4,5,4.0,9,0.4444444444444444
190130376,1,9,1.0,10,0.1
190170296,1,8,1.0,9,0.1111111111111111
190221565,1,17,1.0,18,0.05555555555555555
190240475,1,8,1.0,9,0.1111111111111111
190254298,7,3,3.0,10,0.3
190279931,1,9,1.0,10,0.1
190293033,1,8,1.0,9,0.1111111111111111
190296764,3,6,3.0,9,0.3333333333333333
190299534,2,8,2.0,10,0.2
190301926,4,5,4.0,9,0.4444444444444444
190302935,1,8,1.0,9,0.1111111111111111
190310332,3,7,3.0,10,0.3
190316426,2,8,2.0,10,0.2
190318321,4,5,4.0,9,0.4444444444444444
190325722,3,6,3.0,9,0.3333333333333333
190325845,5,13,5.0,18,0.2777777777777778
190326781,2,8,2.0,10,0.2
190333270,2,8,2.0,10,0.2
190334657,3,7,3.0,10,0.3
190335151,1,9,1.0,10,0.1
190336702,1,9,1.0,10,0.1
190336861,13,12,12.0,25,0.48
190337416,1,9,1.0,10,0.1
190337746,1,8,1.0,9,0.1111111111111111
190338783,1,9,1.0,10,0.1
190340304,1,17,1.0,18,0.05555555555555555
190340533,8,2,2.0,10,0.2
190341115,27,1,1.0,28,0.03571428571428571
190342874,1,27,1.0,28,0.03571428571428571
190356840,3,16,3.0,19,0.15789473684210525
190369228,1,9,1.0,10,0.1
190401728,19,10,10.0,29,0.3448275862068966
190405612,5,4,4.0,9,0.4444444444444444
190424733,7,3,3.0,10,0.3
190458954,4,6,4.0,10,0.4
190459047,3,7,3.0,10,0.3
190459138,2,7,2.0,9,0.2222222222222222
190459245,11,17,11.0,28,0.39285714285714285
190459389,7,2,2.0,9,0.2222222222222222
190464291,1,9,1.0,10,0.1
190465631,1,8,1.0,9,0.1111111111111111
190467542,1,18,1.0,19,0.05263157894736842
190479539,1,9,1.0,10,0.1
190492831,5,5,5.0,10,0.5
190493761,3,7,3.0,10,0.3
190497935,7,3,3.0,10,0.3
190514987,2,8,2.0,10,0.2
190517077,5,5,5.0,10,0.5
190517865,1,9,1.0,10,0.1
190519143,1,18,1.0,19,0.05263157894736842
190523068,1,27,1.0,28,0.03571428571428571
190525358,1,9,1.0,10,0.1
190527821,8,1,1.0,9,0.1111111111111111
190546407,2,8,2.0,10,0.2
190561513,2,8,2.0,10,0.2
190562281,1,9,1.0,10,0.1
190562820,3,16,3.0,19,0.15789473684210525
190589351,3,17,3.0,20,0.15
190598903,1,9,1.0,10,0.1
190613103,8,2,2.0,10,0.2
190613501,9,1,1.0,10,0.1
190613576,3,7,3.0,10,0.3
190613646,3,6,3.0,9,0.3333333333333333
190687934,6,3,3.0,9,0.3333333333333333
190689830,4,5,4.0,9,0.4444444444444444
190690003,3,7,3.0,10,0.3
190720032,1,8,1.0,9,0.1111111111111111
190731066,5,4,4.0,9,0.4444444444444444
190747377,8,22,8.0,30,0.26666666666666666
190753199,8,1,1.0,9,0.1111111111111111
190769120,1,9,1.0,10,0.1
190770457,2,8,2.0,10,0.2
190772764,1,18,1.0,19,0.05263157894736842
190773150,2,7,2.0,9,0.2222222222222222
190777746,26,1,1.0,27,0.037037037037037035
190823608,1,18,1.0,19,0.05263157894736842
190832135,19,4,4.0,23,0.17391304347826086
190843270,1,9,1.0,10,0.1
190853369,4,23,4.0,27,0.14814814814814814
190856173,2,8,2.0,10,0.2
190856822,1,8,1.0,9,0.1111111111111111
190857856,2,26,2.0,28,0.07142857142857142
190858205,1,9,1.0,10,0.1
190859898,1,9,1.0,10,0.1
190860510,1,8,1.0,9,0.1111111111111111
190860585,1,9,1.0,10,0.1
190860771,2,8,2.0,10,0.2
190861433,3,7,3.0,10,0.3
190862336,3,7,3.0,10,0.3
190863804,1,8,1.0,9,0.1111111111111111
190864398,4,6,4.0,10,0.4
190866575,1,9,1.0,10,0.1
190868922,3,6,3.0,9,0.3333333333333333
190876040,1,9,1.0,10,0.1
190877487,8,21,8.0,29,0.27586206896551724
190878870,1,8,1.0,9,0.1111111111111111
190881820,1,9,1.0,10,0.1
190885461,1,8,1.0,9,0.1111111111111111
190912600,5,5,5.0,10,0.5
190913537,3,6,3.0,9,0.3333333333333333
190944358,7,3,3.0,10,0.3
190944922,6,2,2.0,8,0.25
190945828,2,8,2.0,10,0.2
190952280,5,23,5.0,28,0.17857142857142858
190986755,2,28,2.0,30,0.06666666666666667
190989770,2,8,2.0,10,0.2
191011128,1,28,1.0,29,0.034482758620689655
191015364,7,12,7.0,19,0.3684210526315789
191033871,1,9,1.0,10,0.1
191062369,1,9,1.0,10,0.1
191090486,1,18,1.0,19,0.05263157894736842
191097165,2,8,2.0,10,0.2
191099992,4,4,4.0,8,0.5
191101901,2,8,2.0,10,0.2
191114894,1,17,1.0,18,0.05555555555555555
191117253,3,7,3.0,10,0.3
191130938,1,18,1.0,19,0.05263157894736842
191157256,3,6,3.0,9,0.3333333333333333
191171730,3,7,3.0,10,0.3
191227773,3,7,3.0,10,0.3
191262500,1,8,1.0,9,0.1111111111111111
191271249,1,8,1.0,9,0.1111111111111111
191271693,1,8,1.0,9,0.1111111111111111
191273894,8,22,8.0,30,0.26666666666666666
191276728,1,8,1.0,9,0.1111111111111111
191278283,4,5,4.0,9,0.4444444444444444
191291599,1,8,1.0,9,0.1111111111111111
191303923,2,7,2.0,9,0.2222222222222222
191342989,1,9,1.0,10,0.1
191363263,14,14,14.0,28,0.5
191371795,2,8,2.0,10,0.2
191391578,2,8,2.0,10,0.2
191402271,1,7,1.0,8,0.125
191417150,6,3,3.0,9,0.3333333333333333
191429800,3,16,3.0,19,0.15789473684210525
191441141,1,9,1.0,10,0.1
191454329,9,1,1.0,10,0.1
191455985,1,7,1.0,8,0.125
191458074,7,3,3.0,10,0.3
191465862,5,5,5.0,10,0.5
191491471,1,9,1.0,10,0.1
191530983,4,6,4.0,10,0.4
191551896,1,9,1.0,10,0.1
191573530,6,3,3.0,9,0.3333333333333333
191577786,5,5,5.0,10,0.5
191585243,4,5,4.0,9,0.4444444444444444
191585341,4,6,4.0,10,0.4
191586300,2,7,2.0,9,0.2222222222222222
191586439,3,5,3.0,8,0.375
191595269,9,1,1.0,10,0.1
191656257,4,6,4.0,10,0.4
191657399,6,3,3.0,9,0.3333333333333333
191660683,8,2,2.0,10,0.2
191671952,3,16,3.0,19,0.15789473684210525
191673437,8,2,2.0,10,0.2
191686495,5,5,5.0,10,0.5
191688759,21,7,7.0,28,0.25
191689136,3,17,3.0,20,0.15
191705188,1,8,1.0,9,0.1111111111111111
191723178,2,17,2.0,19,0.10526315789473684
191726485,1,9,1.0,10,0.1
191753929,6,3,3.0,9,0.3333333333333333
191757659,9,1,1.0,10,0.1
191758739,4,5,4.0,9,0.4444444444444444
191793479,2,7,2.0,9,0.2222222222222222
191794983,1,9,1.0,10,0.1
191798261,4,24,4.0,28,0.14285714285714285
191799288,1,9,1.0,10,0.1
191806794,9,1,1.0,10,0.1
191806892,7,2,2.0,9,0.2222222222222222
191807063,20,9,9.0,29,0.3103448275862069
191807888,1,8,1.0,9,0.1111111111111111
191809396,1,18,1.0,19,0.05263157894736842
191814052,2,7,2.0,9,0.2222222222222222
191815360,1,17,1.0,18,0.05555555555555555
191815740,1,18,1.0,19,0.05263157894736842
191820369,7,20,7.0,27,0.25925925925925924
191824711,3,7,3.0,10,0.3
191834220,8,12,8.0,20,0.4
191844545,4,6,4.0,10,0.4
191844817,9,1,1.0,10,0.1
191867996,1,9,1.0,10,0.1
191869782,1,8,1.0,9,0.1111111111111111
191870879,5,4,4.0,9,0.4444444444444444
191874811,14,5,5.0,19,0.2631578947368421
191917311,2,7,2.0,9,0.2222222222222222
191919696,8,1,1.0,9,0.1111111111111111
191921493,1,9,1.0,10,0.1
191921959,1,7,1.0,8,0.125
191922495,2,7,2.0,9,0.2222222222222222
191923828,15,5,5.0,20,0.25
191928941,1,8,1.0,9,0.1111111111111111
191936447,6,20,6.0,26,0.23076923076923078
191942045,3,15,3.0,18,0.16666666666666666
191958162,6,23,6.0,29,0.20689655172413793
191958551,3,6,3.0,9,0.3333333333333333
191964323,2,8,2.0,10,0.2
191964795,6,3,3.0,9,0.3333333333333333
191965607,4,6,4.0,10,0.4
191968699,1,27,1.0,28,0.03571428571428571
191969298,8,2,2.0,10,0.2
191984174,1,9,1.0,10,0.1
191985573,9,1,1.0,10,0.1
191995847,1,9,1.0,10,0.1
191997432,1,17,1.0,18,0.05555555555555555
192021016,6,4,4.0,10,0.4
192025371,7,2,2.0,9,0.2222222222222222
192026598,1,9,1.0,10,0.1
192070027,1,19,1.0,20,0.05
192072386,1,9,1.0,10,0.1
192099162,6,2,2.0,8,0.25
192099543,3,6,3.0,9,0.3333333333333333
192105705,1,17,1.0,18,0.05555555555555555
192110144,10,19,10.0,29,0.3448275862068966
192130231,9,11,9.0,20,0.45
192134117,4,5,4.0,9,0.4444444444444444
192150158,8,1,1.0,9,0.1111111111111111
192168584,7,23,7.0,30,0.23333333333333334
192169259,6,3,3.0,9,0.3333333333333333
192169639,3,16,3.0,19,0.15789473684210525
192169658,3,7,3.0,10,0.3
192172190,6,4,4.0,10,0.4
192172711,6,19,6.0,25,0.24
192173185,24,5,5.0,29,0.1724137931034483
192176177,3,7,3.0,10,0.3
192208583,23,3,3.0,26,0.11538461538461539
192209039,9,1,1.0,10,0.1
192222683,1,9,1.0,10,0.1
192228795,1,9,1.0,10,0.1
192242944,2,17,2.0,19,0.10526315789473684
192255092,8,2,2.0,10,0.2
192278092,6,24,6.0,30,0.2
192287117,3,7,3.0,10,0.3
192295467,8,2,2.0,10,0.2
192318044,4,6,4.0,10,0.4
192318701,1,18,1.0,19,0.05263157894736842
192327635,4,5,4.0,9,0.4444444444444444
192333292,1,8,1.0,9,0.1111111111111111
192335884,2,6,2.0,8,0.25
192347986,3,6,3.0,9,0.3333333333333333
192350419,1,9,1.0,10,0.1
192360573,2,8,2.0,10,0.2
192362635,1,8,1.0,9,0.1111111111111111
192386956,4,6,4.0,10,0.4
192387903,1,27,1.0,28,0.03571428571428571
192417172,1,8,1.0,9,0.1111111111111111
192442006,8,2,2.0,10,0.2
192442447,5,5,5.0,10,0.5
192442720,6,4,4.0,10,0.4
192448312,9,1,1.0,10,0.1
192454385,1,17,1.0,18,0.05555555555555555
192454769,1,9,1.0,10,0.1
192457347,1,8,1.0,9,0.1111111111111111
192463338,7,20,7.0,27,0.25925925925925924
192463631,5,5,5.0,10,0.5
192468225,1,8,1.0,9,0.1111111111111111
192470426,2,8,2.0,10,0.2
192476475,9,1,1.0,10,0.1
192483549,2,7,2.0,9,0.2222222222222222
192502063,2,8,2.0,10,0.2
192503752,2,18,2.0,20,0.1
192525288,6,4,4.0,10,0.4
192542993,1,19,1.0,20,0.05
192549666,3,7,3.0,10,0.3
192562744,1,8,1.0,9,0.1111111111111111
192599836,4,5,4.0,9,0.4444444444444444
192609231,1,8,1.0,9,0.1111111111111111
192638177,1,9,1.0,10,0.1
192646893,1,8,1.0,9,0.1111111111111111
192649192,3,16,3.0,19,0.15789473684210525
192671513,1,8,1.0,9,0.1111111111111111
192709891,4,6,4.0,10,0.4
192710537,1,7,1.0,8,0.125
192722724,3,6,3.0,9,0.3333333333333333
192723883,2,7,2.0,9,0.2222222222222222
192736383,1,9,1.0,10,0.1
192739149,1,17,1.0,18,0.05555555555555555
192743267,5,13,5.0,18,0.2777777777777778
192743956,2,8,2.0,10,0.2
192747749,7,3,3.0,10,0.3
192748028,5,5,5.0,10,0.5
192749604,8,2,2.0,10,0.2
192750596,5,4,4.0,9,0.4444444444444444
192750778,10,18,10.0,28,0.35714285714285715
192756846,1,9,1.0,10,0.1
192767462,2,8,2.0,10,0.2
192772663,2,8,2.0,10,0.2
192854288,15,13,13.0,28,0.4642857142857143
192854700,1,18,1.0,19,0.05263157894736842
192862262,1,9,1.0,10,0.1
192872834,5,5,5.0,10,0.5
192913871,1,18,1.0,19,0.05263157894736842
192919831,1,9,1.0,10,0.1
192922066,1,8,1.0,9,0.1111111111111111
192923828,1,9,1.0,10,0.1
192934475,1,19,1.0,20,0.05
192940834,2,8,2.0,10,0.2
192951261,3,6,3.0,9,0.3333333333333333
192955987,9,1,1.0,10,0.1
192956136,1,28,1.0,29,0.034482758620689655
192964370,1,9,1.0,10,0.1
192967351,2,8,2.0,10,0.2
192977102,21,8,8.0,29,0.27586206896551724
192977681,3,7,3.0,10,0.3
192982569,19,4,4.0,23,0.17391304347826086
192982581,9,1,1.0,10,0.1
192982665,7,2,2.0,9,0.2222222222222222
192999302,1,9,1.0,10,0.1
193022119,3,15,3.0,18,0.16666666666666666
193022783,1,8,1.0,9,0.1111111111111111
193030361,2,7,2.0,9,0.2222222222222222
193076959,1,9,1.0,10,0.1
193098169,3,6,3.0,9,0.3333333333333333
193100294,10,10,10.0,20,0.5
193109230,1,9,1.0,10,0.1
193114631,17,2,2.0,19,0.10526315789473684
193123560,5,5,5.0,10,0.5
193132544,1,8,1.0,9,0.1111111111111111
193132584,3,7,3.0,10,0.3
193134248,9,1,1.0,10,0.1
193167738,4,5,4.0,9,0.4444444444444444
193178393,2,17,2.0,19,0.10526315789473684
193189882,7,3,3.0,10,0.3
193190353,2,8,2.0,10,0.2
193249154,2,8,2.0,10,0.2
193251094,1,9,1.0,10,0.1
193270703,2,7,2.0,9,0.2222222222222222
193270894,1,7,1.0,8,0.125
193271146,5,4,4.0,9,0.4444444444444444
193277508,8,1,1.0,9,0.1111111111111111
193303748,1,28,1.0,29,0.034482758620689655
193309474,1,9,1.0,10,0.1
193310003,5,24,5.0,29,0.1724137931034483
193314014,2,8,2.0,10,0.2
193323713,1,8,1.0,9,0.1111111111111111
193324190,7,3,3.0,10,0.3
193324716,6,4,4.0,10,0.4
193325841,7,3,3.0,10,0.3
193329364,1,9,1.0,10,0.1
193330468,1,9,1.0,10,0.1
193344522,1,9,1.0,10,0.1
193358404,1,8,1.0,9,0.1111111111111111
193373350,1,9,1.0,10,0.1
193373850,6,4,4.0,10,0.4
193376142,5,5,5.0,10,0.5
193377429,1,9,1.0,10,0.1
193393582,1,9,1.0,10,0.1
193398036,1,8,1.0,9,0.1111111111111111
193398381,1,9,1.0,10,0.1
193401336,2,8,2.0,10,0.2
193422521,4,4,4.0,8,0.5
193424917,2,8,2.0,10,0.2
193435387,2,8,2.0,10,0.2
193447908,5,5,5.0,10,0.5
193457894,8,2,2.0,10,0.2
193458795,8,2,2.0,10,0.2
193463621,28,2,2.0,30,0.06666666666666667
193487135,1,9,1.0,10,0.1
193499059,8,2,2.0,10,0.2
193519644,6,4,4.0,10,0.4
193528152,2,8,2.0,10,0.2
193540614,6,4,4.0,10,0.4
193569219,7,2,2.0,9,0.2222222222222222
193569718,6,3,3.0,9,0.3333333333333333
193589348,3,7,3.0,10,0.3
193590928,1,18,1.0,19,0.05263157894736842
193601147,3,16,3.0,19,0.15789473684210525
193632945,2,8,2.0,10,0.2
193636075,18,7,7.0,25,0.28
193636206,2,7,2.0,9,0.2222222222222222
193636485,4,6,4.0,10,0.4
193636706,2,8,2.0,10,0.2
193638554,1,18,1.0,19,0.05263157894736842
193646273,2,7,2.0,9,0.2222222222222222
193692197,1,9,1.0,10,0.1
193692881,27,3,3.0,30,0.1
193719660,2,7,2.0,9,0.2222222222222222
193731051,2,8,2.0,10,0.2
193735474,2,7,2.0,9,0.2222222222222222
193755577,6,2,2.0,8,0.25
193758400,1,17,1.0,18,0.05555555555555555
193759360,2,8,2.0,10,0.2
193770531,1,24,1.0,25,0.04
193773628,1,9,1.0,10,0.1
193773871,1,9,1.0,10,0.1
193799228,1,8,1.0,9,0.1111111111111111
193806621,7,3,3.0,10,0.3
193823859,1,9,1.0,10,0.1
193824423,1,8,1.0,9,0.1111111111111111
193839873,2,26,2.0,28,0.07142857142857142
193840473,1,24,1.0,25,0.04
193843383,3,7,3.0,10,0.3
193844289,5,5,5.0,10,0.5
193844498,4,5,4.0,9,0.4444444444444444
193853987,8,11,8.0,19,0.42105263157894735
193886120,9,1,1.0,10,0.1
193888843,6,20,6.0,26,0.23076923076923078
193898660,9,1,1.0,10,0.1
193905955,4,4,4.0,8,0.5
193906223,3,6,3.0,9,0.3333333333333333
193935158,1,9,1.0,10,0.1
193960028,1,9,1.0,10,0.1
193975644,9,1,1.0,10,0.1
194007088,1,9,1.0,10,0.1
194013490,1,19,1.0,20,0.05
194015795,1,17,1.0,18,0.05555555555555555
194028892,1,9,1.0,10,0.1
194048883,4,6,4.0,10,0.4
194063820,1,9,1.0,10,0.1
194077840,1,19,1.0,20,0.05
194078091,1,8,1.0,9,0.1111111111111111
194080254,1,9,1.0,10,0.1
194121269,1,18,1.0,19,0.05263157894736842
194128747,2,17,2.0,19,0.10526315789473684
194138300,7,13,7.0,20,0.35
194144173,2,8,2.0,10,0.2
194147853,18,2,2.0,20,0.1
194177050,3,7,3.0,10,0.3
194180627,2,8,2.0,10,0.2
194185942,3,7,3.0,10,0.3
194192165,4,6,4.0,10,0.4
194192246,9,1,1.0,10,0.1
194193849,5,5,5.0,10,0.5
194193927,3,6,3.0,9,0.3333333333333333
194216124,20,8,8.0,28,0.2857142857142857
194224727,2,7,2.0,9,0.2222222222222222
194224963,2,8,2.0,10,0.2
194226236,3,7,3.0,10,0.3
194234281,7,22,7.0,29,0.2413793103448276
194235290,1,9,1.0,10,0.1
194246465,3,7,3.0,10,0.3
194249566,3,5,3.0,8,0.375
194256864,7,3,3.0,10,0.3
194290672,3,7,3.0,10,0.3
194297510,1,9,1.0,10,0.1
194307570,5,24,5.0,29,0.1724137931034483
194311096,20,8,8.0,28,0.2857142857142857
194365355,5,4,4.0,9,0.4444444444444444
194379851,2,13,2.0,15,0.13333333333333333
194387154,1,9,1.0,10,0.1
194390901,3,17,3.0,20,0.15
194393168,3,17,3.0,20,0.15
194411394,5,5,5.0,10,0.5
194432946,19,1,1.0,20,0.05
194434869,1,9,1.0,10,0.1
194455707,1,8,1.0,9,0.1111111111111111
194457605,2,8,2.0,10,0.2
194460652,1,8,1.0,9,0.1111111111111111
194464023,1,9,1.0,10,0.1
194485302,3,17,3.0,20,0.15
194502275,1,9,1.0,10,0.1
194519619,1,18,1.0,19,0.05263157894736842
194526933,1,9,1.0,10,0.1
194545741,2,7,2.0,9,0.2222222222222222
194568640,1,9,1.0,10,0.1
194573169,1,8,1.0,9,0.1111111111111111
194576237,4,5,4.0,9,0.4444444444444444
194586884,1,9,1.0,10,0.1
194590172,1,7,1.0,8,0.125
194620240,1,8,1.0,9,0.1111111111111111
194635405,1,9,1.0,10,0.1
194639893,2,7,2.0,9,0.2222222222222222
194644714,1,9,1.0,10,0.1
194653287,2,8,2.0,10,0.2
194661384,3,6,3.0,9,0.3333333333333333
194664310,2,8,2.0,10,0.2
194675071,1,8,1.0,9,0.1111111111111111
194676607,1,9,1.0,10,0.1
194677863,2,8,2.0,10,0.2
194682667,5,4,4.0,9,0.4444444444444444
194689946,5,5,5.0,10,0.5
194692955,15,4,4.0,19,0.21052631578947367
194704858,2,8,2.0,10,0.2
194708448,4,5,4.0,9,0.4444444444444444
194709607,1,9,1.0,10,0.1
194715347,1,9,1.0,10,0.1
194716514,2,8,2.0,10,0.2
194718603,5,5,5.0,10,0.5
194722924,1,9,1.0,10,0.1
194724846,1,9,1.0,10,0.1
194726168,1,9,1.0,10,0.1
194729393,1,9,1.0,10,0.1
194730635,4,6,4.0,10,0.4
194731366,5,5,5.0,10,0.5
194731502,4,6,4.0,10,0.4
194731663,2,8,2.0,10,0.2
194732878,3,7,3.0,10,0.3
194737720,2,8,2.0,10,0.2
194740611,2,7,2.0,9,0.2222222222222222
194741597,5,5,5.0,10,0.5
194742145,1,19,1.0,20,0.05
194743162,2,7,2.0,9,0.2222222222222222
194748684,4,6,4.0,10,0.4
194750885,1,8,1.0,9,0.1111111111111111
194756716,7,1,1.0,8,0.125
194767329,2,17,2.0,19,0.10526315789473684
194780410,1,8,1.0,9,0.1111111111111111
194790899,3,7,3.0,10,0.3
194806875,1,8,1.0,9,0.1111111111111111
194814090,1,18,1.0,19,0.05263157894736842
194828133,4,6,4.0,10,0.4
194836116,1,8,1.0,9,0.1111111111111111
194838968,9,1,1.0,10,0.1
194862578,1,8,1.0,9,0.1111111111111111
194862595,2,8,2.0,10,0.2
194862932,1,27,1.0,28,0.03571428571428571
194872155,5,4,4.0,9,0.4444444444444444
194876467,7,3,3.0,10,0.3
194890037,2,7,2.0,9,0.2222222222222222
194890224,1,9,1.0,10,0.1
194890588,5,5,5.0,10,0.5
194891942,4,6,4.0,10,0.4
194893670,1,9,1.0,10,0.1
194894098,2,7,2.0,9,0.2222222222222222
194894379,2,8,2.0,10,0.2
194895949,2,8,2.0,10,0.2
194916332,1,19,1.0,20,0.05
194917859,3,7,3.0,10,0.3
194920941,1,8,1.0,9,0.1111111111111111
194922225,10,19,10.0,29,0.3448275862068966
194924604,3,23,3.0,26,0.11538461538461539
194928519,3,7,3.0,10,0.3
194928770,6,4,4.0,10,0.4
194937716,5,5,5.0,10,0.5
194962431,3,7,3.0,10,0.3
194964469,1,9,1.0,10,0.1
194966064,7,3,3.0,10,0.3
194977781,1,9,1.0,10,0.1
194978797,27,1,1.0,28,0.03571428571428571
194982693,7,2,2.0,9,0.2222222222222222
194985974,4,6,4.0,10,0.4
195027320,2,8,2.0,10,0.2
195034923,7,2,2.0,9,0.2222222222222222
195035509,6,14,6.0,20,0.3
195039815,27,2,2.0,29,0.06896551724137931
195044573,5,4,4.0,9,0.4444444444444444
195046118,7,3,3.0,10,0.3
195066978,3,6,3.0,9,0.3333333333333333
195078900,1,7,1.0,8,0.125
195084545,1,8,1.0,9,0.1111111111111111
195099638,6,4,4.0,10,0.4
195100742,4,6,4.0,10,0.4
195114914,1,9,1.0,10,0.1
195119534,6,3,3.0,9,0.3333333333333333
195119864,28,1,1.0,29,0.034482758620689655
195120525,1,9,1.0,10,0.1
195129719,5,4,4.0,9,0.4444444444444444
195200044,4,5,4.0,9,0.4444444444444444
195215976,7,1,1.0,8,0.125
195223852,1,9,1.0,10,0.1
195252168,6,3,3.0,9,0.3333333333333333
195252358,1,9,1.0,10,0.1
195267765,6,4,4.0,10,0.4
195283848,17,11,11.0,28,0.39285714285714285
195293476,1,8,1.0,9,0.1111111111111111
195294116,2,8,2.0,10,0.2
195321490,1,9,1.0,10,0.1
195329403,5,5,5.0,10,0.5
195341672,9,10,9.0,19,0.47368421052631576
195344335,1,18,1.0,19,0.05263157894736842
195345507,4,5,4.0,9,0.4444444444444444
195347488,9,1,1.0,10,0.1
195367546,1,9,1.0,10,0.1
195394890,4,6,4.0,10,0.4
195397507,1,17,1.0,18,0.05555555555555555
195398347,1,19,1.0,20,0.05
195399412,3,7,3.0,10,0.3
195410450,1,7,1.0,8,0.125
195420803,1,8,1.0,9,0.1111111111111111
195422536,1,9,1.0,10,0.1
195426335,1,9,1.0,10,0.1
195428879,2,8,2.0,10,0.2
195446290,3,6,3.0,9,0.3333333333333333
195450238,1,8,1.0,9,0.1111111111111111
195460507,6,4,4.0,10,0.4
195467425,4,16,4.0,20,0.2
195482448,7,3,3.0,10,0.3
195495990,1,19,1.0,20,0.05
195498589,1,9,1.0,10,0.1
195500457,3,6,3.0,9,0.3333333333333333
195514311,2,8,2.0,10,0.2
195514855,7,2,2.0,9,0.2222222222222222
195515248,6,4,4.0,10,0.4
195545164,7,3,3.0,10,0.3
195560440,3,7,3.0,10,0.3
195572773,1,16,1.0,17,0.058823529411764705
195595530,6,4,4.0,10,0.4
195600431,8,11,8.0,19,0.42105263157894735
195604193,3,7,3.0,10,0.3
195605384,6,4,4.0,10,0.4
195621066,4,6,4.0,10,0.4
195621351,7,3,3.0,10,0.3
195626350,4,6,4.0,10,0.4
195628867,3,7,3.0,10,0.3
195646072,5,23,5.0,28,0.17857142857142858
195655796,9,1,1.0,10,0.1
195656788,5,23,5.0,28,0.17857142857142858
195657460,7,3,3.0,10,0.3
195676911,1,9,1.0,10,0.1
195693835,2,7,2.0,9,0.2222222222222222
195693941,5,4,4.0,9,0.4444444444444444
195722594,1,16,1.0,17,0.058823529411764705
195724119,2,25,2.0,27,0.07407407407407407
195724413,2,8,2.0,10,0.2
195724610,1,9,1.0,10,0.1
195735727,5,4,4.0,9,0.4444444444444444
195737666,7,3,3.0,10,0.3
195739894,5,5,5.0,10,0.5
195744302,5,5,5.0,10,0.5
195749714,3,7,3.0,10,0.3
195753171,1,19,1.0,20,0.05
195767358,4,6,4.0,10,0.4
195767388,1,9,1.0,10,0.1
195767712,3,6,3.0,9,0.3333333333333333
195768281,13,6,6.0,19,0.3157894736842105
195774151,2,16,2.0,18,0.1111111111111111
195786930,1,9,1.0,10,0.1
195787926,1,22,1.0,23,0.043478260869565216
195795751,6,21,6.0,27,0.2222222222222222
195796292,2,8,2.0,10,0.2
195797935,8,2,2.0,10,0.2
195798276,2,8,2.0,10,0.2
195817928,3,7,3.0,10,0.3
195822278,1,9,1.0,10,0.1
195823209,1,9,1.0,10,0.1
195826988,3,7,3.0,10,0.3
195832277,2,8,2.0,10,0.2
195850111,1,8,1.0,9,0.1111111111111111
195851818,1,9,1.0,10,0.1
195851880,5,5,5.0,10,0.5
195856262,1,9,1.0,10,0.1
195861872,3,7,3.0,10,0.3
195863032,1,9,1.0,10,0.1
195878798,1,8,1.0,9,0.1111111111111111
195882271,1,8,1.0,9,0.1111111111111111
195885775,4,5,4.0,9,0.4444444444444444
195893596,4,6,4.0,10,0.4
195903389,3,7,3.0,10,0.3
195904603,1,18,1.0,19,0.05263157894736842
195908169,2,7,2.0,9,0.2222222222222222
195908457,3,7,3.0,10,0.3
195908741,2,7,2.0,9,0.2222222222222222
195909588,3,7,3.0,10,0.3
195919636,1,7,1.0,8,0.125
195920747,1,8,1.0,9,0.1111111111111111
195932588,4,5,4.0,9,0.4444444444444444
195957920,9,1,1.0,10,0.1
195958222,7,2,2.0,9,0.2222222222222222
195964446,1,28,1.0,29,0.034482758620689655
195973723,3,7,3.0,10,0.3
195974907,1,9,1.0,10,0.1
195981909,1,9,1.0,10,0.1
195982178,9,1,1.0,10,0.1
195982531,7,3,3.0,10,0.3
195983131,1,9,1.0,10,0.1
195988056,1,9,1.0,10,0.1
196005433,1,9,1.0,10,0.1
196020811,2,7,2.0,9,0.2222222222222222
196048625,3,7,3.0,10,0.3
196052570,1,8,1.0,9,0.1111111111111111
196057836,1,8,1.0,9,0.1111111111111111
196059050,6,22,6.0,28,0.21428571428571427
196065695,2,7,2.0,9,0.2222222222222222
196067083,2,8,2.0,10,0.2
196071954,1,9,1.0,10,0.1
196090158,1,19,1.0,20,0.05
196109217,1,9,1.0,10,0.1
196109785,4,5,4.0,9,0.4444444444444444
196131593,3,6,3.0,9,0.3333333333333333
196141928,8,2,2.0,10,0.2
196152236,4,5,4.0,9,0.4444444444444444
196152980,3,7,3.0,10,0.3
196192565,2,8,2.0,10,0.2
196199634,25,2,2.0,27,0.07407407407407407
196215574,16,13,13.0,29,0.4482758620689655
196217297,1,9,1.0,10,0.1
196222736,14,14,14.0,28,0.5
196247432,23,4,4.0,27,0.14814814814814814
196248359,5,4,4.0,9,0.4444444444444444
196294526,1,8,1.0,9,0.1111111111111111
196315124,3,16,3.0,19,0.15789473684210525
196318054,3,7,3.0,10,0.3
196318321,1,17,1.0,18,0.05555555555555555
196321666,1,9,1.0,10,0.1
196331244,10,18,10.0,28,0.35714285714285715
196332042,1,9,1.0,10,0.1
196341181,9,1,1.0,10,0.1
196345562,2,8,2.0,10,0.2
196379650,3,7,3.0,10,0.3
196379896,9,1,1.0,10,0.1
196381613,8,2,2.0,10,0.2
196382897,1,9,1.0,10,0.1
196387335,4,15,4.0,19,0.21052631578947367
196387595,1,9,1.0,10,0.1
196389023,7,1,1.0,8,0.125
196398070,6,21,6.0,27,0.2222222222222222
196399720,5,3,3.0,8,0.375
196400744,9,1,1.0,10,0.1
196400826,1,8,1.0,9,0.1111111111111111
196428863,3,7,3.0,10,0.3
196431455,7,2,2.0,9,0.2222222222222222
196433348,1,9,1.0,10,0.1
196434030,2,8,2.0,10,0.2
196434412,7,19,7.0,26,0.2692307692307692
196434544,8,1,1.0,9,0.1111111111111111
196437216,6,4,4.0,10,0.4
196443105,2,17,2.0,19,0.10526315789473684
196443977,1,8,1.0,9,0.1111111111111111
196452974,2,7,2.0,9,0.2222222222222222
196463698,5,5,5.0,10,0.5
196465000,3,16,3.0,19,0.15789473684210525
196466451,6,4,4.0,10,0.4
196470335,2,6,2.0,8,0.25
196470456,1,8,1.0,9,0.1111111111111111
196476302,2,8,2.0,10,0.2
196477707,1,7,1.0,8,0.125
196489229,6,4,4.0,10,0.4
196491595,4,6,4.0,10,0.4
196492188,1,9,1.0,10,0.1
196493937,1,9,1.0,10,0.1
196517143,1,7,1.0,8,0.125
196526204,5,5,5.0,10,0.5
196533686,1,8,1.0,9,0.1111111111111111
196536927,1,8,1.0,9,0.1111111111111111
196537171,6,3,3.0,9,0.3333333333333333
196545365,6,3,3.0,9,0.3333333333333333
196546273,7,3,3.0,10,0.3
196560485,5,4,4.0,9,0.4444444444444444
196567414,9,1,1.0,10,0.1
196569409,7,3,3.0,10,0.3
196570387,1,19,1.0,20,0.05
196572931,1,7,1.0,8,0.125
196574291,2,15,2.0,17,0.11764705882352941
196575513,2,8,2.0,10,0.2
196583201,1,9,1.0,10,0.1
196598199,2,8,2.0,10,0.2
196601683,4,6,4.0,10,0.4
196603428,1,8,1.0,9,0.1111111111111111
196618529,7,2,2.0,9,0.2222222222222222
196618904,1,9,1.0,10,0.1
196621100,1,9,1.0,10,0.1
196627999,1,9,1.0,10,0.1
196635257,1,9,1.0,10,0.1
196637424,3,16,3.0,19,0.15789473684210525
196648165,2,18,2.0,20,0.1
196682980,1,9,1.0,10,0.1
196733828,2,8,2.0,10,0.2
196742583,1,9,1.0,10,0.1
196792393,2,8,2.0,10,0.2
196794868,1,9,1.0,10,0.1
196801798,9,1,1.0,10,0.1
196826997,9,1,1.0,10,0.1
196843728,1,9,1.0,10,0.1
196844654,1,17,1.0,18,0.05555555555555555
196865660,1,9,1.0,10,0.1
196875724,1,9,1.0,10,0.1
196882777,1,25,1.0,26,0.038461538461538464
196886552,5,5,5.0,10,0.5
196898897,2,17,2.0,19,0.10526315789473684
196954769,2,8,2.0,10,0.2
196955232,7,3,3.0,10,0.3
196961929,1,9,1.0,10,0.1
196971331,1,9,1.0,10,0.1
196973562,2,7,2.0,9,0.2222222222222222
196986400,1,9,1.0,10,0.1
196988885,7,2,2.0,9,0.2222222222222222
196992856,2,7,2.0,9,0.2222222222222222
197018275,1,9,1.0,10,0.1
197036737,8,1,1.0,9,0.1111111111111111
197037163,3,6,3.0,9,0.3333333333333333
197037254,7,3,3.0,10,0.3
197037508,5,5,5.0,10,0.5
197054554,1,19,1.0,20,0.05
197058867,4,6,4.0,10,0.4
197061733,8,1,1.0,9,0.1111111111111111
197076328,6,3,3.0,9,0.3333333333333333
197099303,1,8,1.0,9,0.1111111111111111
197120449,1,7,1.0,8,0.125
197137431,1,9,1.0,10,0.1
197137633,2,7,2.0,9,0.2222222222222222
197138524,3,7,3.0,10,0.3
197156486,5,5,5.0,10,0.5
197157340,2,7,2.0,9,0.2222222222222222
197163223,26,3,3.0,29,0.10344827586206896
197179774,3,7,3.0,10,0.3
197181701,3,24,3.0,27,0.1111111111111111
197181747,3,6,3.0,9,0.3333333333333333
197185773,3,7,3.0,10,0.3
197203115,2,7,2.0,9,0.2222222222222222
197209804,3,7,3.0,10,0.3
197216184,7,3,3.0,10,0.3
197240810,6,4,4.0,10,0.4
197249751,1,9,1.0,10,0.1
197250678,6,4,4.0,10,0.4
197250961,1,17,1.0,18,0.05555555555555555
197254682,2,7,2.0,9,0.2222222222222222
197259874,2,8,2.0,10,0.2
197269854,1,9,1.0,10,0.1
197271037,8,2,2.0,10,0.2
197278007,2,8,2.0,10,0.2
197298149,1,9,1.0,10,0.1
197307774,6,4,4.0,10,0.4
197321737,8,1,1.0,9,0.1111111111111111
197367956,2,8,2.0,10,0.2
197370869,6,2,2.0,8,0.25
197371230,6,2,2.0,8,0.25
197389721,1,7,1.0,8,0.125
197392726,1,9,1.0,10,0.1
197403031,3,7,3.0,10,0.3
197409473,4,25,4.0,29,0.13793103448275862
197418953,9,20,9.0,29,0.3103448275862069
197460200,5,24,5.0,29,0.1724137931034483
197513272,2,23,2.0,25,0.08
197515699,2,8,2.0,10,0.2
197545490,9,11,9.0,20,0.45
197573828,4,6,4.0,10,0.4
197626717,17,3,3.0,20,0.15
197628711,4,6,4.0,10,0.4
197629267,10,16,10.0,26,0.38461538461538464
197630292,1,9,1.0,10,0.1
197630602,9,1,1.0,10,0.1
197634991,1,9,1.0,10,0.1
197636544,6,3,3.0,9,0.3333333333333333
197636986,5,5,5.0,10,0.5
197637301,2,7,2.0,9,0.2222222222222222
197641374,1,9,1.0,10,0.1
197648313,7,3,3.0,10,0.3
197648448,3,7,3.0,10,0.3
197648602,7,23,7.0,30,0.23333333333333334
197663786,6,4,4.0,10,0.4
197665041,2,7,2.0,9,0.2222222222222222
197665092,9,1,1.0,10,0.1
197665245,2,8,2.0,10,0.2
197700088,3,6,3.0,9,0.3333333333333333
197700265,6,3,3.0,9,0.3333333333333333
197702266,1,8,1.0,9,0.1111111111111111
197724382,4,14,4.0,18,0.2222222222222222
197730138,3,7,3.0,10,0.3
197736927,1,8,1.0,9,0.1111111111111111
197746438,1,19,1.0,20,0.05
197753088,3,7,3.0,10,0.3
197758869,2,7,2.0,9,0.2222222222222222
197763072,6,3,3.0,9,0.3333333333333333
197766658,1,9,1.0,10,0.1
197773475,12,16,12.0,28,0.42857142857142855
197775899,1,9,1.0,10,0.1
197790484,1,26,1.0,27,0.037037037037037035
197804351,1,19,1.0,20,0.05
197827756,2,6,2.0,8,0.25
197828617,2,6,2.0,8,0.25
197829331,2,8,2.0,10,0.2
197841388,3,7,3.0,10,0.3
197842980,4,6,4.0,10,0.4
197853451,1,8,1.0,9,0.1111111111111111
197867724,1,29,1.0,30,0.03333333333333333
197868197,1,8,1.0,9,0.1111111111111111
197868620,1,19,1.0,20,0.05
197887741,1,17,1.0,18,0.05555555555555555
197890274,2,8,2.0,10,0.2
197908048,1,17,1.0,18,0.05555555555555555
197915574,1,9,1.0,10,0.1
197958558,4,5,4.0,9,0.4444444444444444
197959268,2,7,2.0,9,0.2222222222222222
197964607,5,25,5.0,30,0.16666666666666666
197969137,6,4,4.0,10,0.4
197978143,1,16,1.0,17,0.058823529411764705
197989903,1,9,1.0,10,0.1
197993727,1,9,1.0,10,0.1
198007723,10,20,10.0,30,0.3333333333333333
198016434,6,4,4.0,10,0.4
198023183,9,1,1.0,10,0.1
198029894,7,3,3.0,10,0.3
198040481,1,9,1.0,10,0.1
198042725,7,2,2.0,9,0.2222222222222222
198053828,1,7,1.0,8,0.125
198059502,1,9,1.0,10,0.1
198062988,5,5,5.0,10,0.5
198063838,1,9,1.0,10,0.1
198067520,1,9,1.0,10,0.1
198073198,2,7,2.0,9,0.2222222222222222
198090516,1,7,1.0,8,0.125
198091653,2,8,2.0,10,0.2
198095809,2,8,2.0,10,0.2
198102843,9,1,1.0,10,0.1
198106679,3,6,3.0,9,0.3333333333333333
198113536,4,6,4.0,10,0.4
198118270,1,19,1.0,20,0.05
198126836,1,9,1.0,10,0.1
198154817,7,3,3.0,10,0.3
198162865,9,1,1.0,10,0.1
198169323,1,19,1.0,20,0.05
198178065,1,9,1.0,10,0.1
198183856,1,9,1.0,10,0.1
198189871,7,3,3.0,10,0.3
198200010,1,8,1.0,9,0.1111111111111111
198207426,2,7,2.0,9,0.2222222222222222
198223856,3,6,3.0,9,0.3333333333333333
198231988,3,7,3.0,10,0.3
198237506,5,5,5.0,10,0.5
198267806,1,8,1.0,9,0.1111111111111111
198272742,1,9,1.0,10,0.1
198282916,6,4,4.0,10,0.4
198287647,1,8,1.0,9,0.1111111111111111
198301184,7,1,1.0,8,0.125
198333449,3,6,3.0,9,0.3333333333333333
198336180,3,6,3.0,9,0.3333333333333333
198337071,8,2,2.0,10,0.2
198338470,3,7,3.0,10,0.3
198361418,1,9,1.0,10,0.1
198367767,8,2,2.0,10,0.2
198372138,9,1,1.0,10,0.1
198375642,1,9,1.0,10,0.1
198382022,2,18,2.0,20,0.1
198406297,1,7,1.0,8,0.125
198406594,1,9,1.0,10,0.1
198438678,1,9,1.0,10,0.1
198446456,3,6,3.0,9,0.3333333333333333
198448139,9,1,1.0,10,0.1
198452259,28,1,1.0,29,0.034482758620689655
198453702,14,15,14.0,29,0.4827586206896552
198460443,1,7,1.0,8,0.125
198465592,1,8,1.0,9,0.1111111111111111
198474714,1,9,1.0,10,0.1
198488480,2,7,2.0,9,0.2222222222222222
198492483,2,8,2.0,10,0.2
198492613,1,7,1.0,8,0.125
198507767,2,8,2.0,10,0.2
198513779,1,18,1.0,19,0.05263157894736842
198514685,7,2,2.0,9,0.2222222222222222
198516972,1,9,1.0,10,0.1
198518354,1,9,1.0,10,0.1
198530760,1,17,1.0,18,0.05555555555555555
198533795,1,19,1.0,20,0.05
198538528,1,18,1.0,19,0.05263157894736842
198539030,1,9,1.0,10,0.1
198539999,18,10,10.0,28,0.35714285714285715
198546678,1,9,1.0,10,0.1
198550743,1,9,1.0,10,0.1
198580564,1,17,1.0,18,0.05555555555555555
198586613,11,17,11.0,28,0.39285714285714285
198595331,2,7,2.0,9,0.2222222222222222
198596944,1,9,1.0,10,0.1
198616775,1,8,1.0,9,0.1111111111111111
198621703,5,4,4.0,9,0.4444444444444444
198674751,8,1,1.0,9,0.1111111111111111
198689248,3,7,3.0,10,0.3
198703344,2,8,2.0,10,0.2
198726491,1,9,1.0,10,0.1
198731079,3,7,3.0,10,0.3
198731884,8,2,2.0,10,0.2
198734278,4,26,4.0,30,0.13333333333333333
198735817,1,8,1.0,9,0.1111111111111111
198738613,2,7,2.0,9,0.2222222222222222
198751271,19,9,9.0,28,0.32142857142857145
198793668,29,1,1.0,30,0.03333333333333333
198798135,1,9,1.0,10,0.1
198801540,2,7,2.0,9,0.2222222222222222
198820559,1,26,1.0,27,0.037037037037037035
198901625,8,1,1.0,9,0.1111111111111111
198903427,1,9,1.0,10,0.1
198932808,1,9,1.0,10,0.1
198933018,3,7,3.0,10,0.3
198950940,1,9,1.0,10,0.1
198956871,2,8,2.0,10,0.2
198965152,14,13,13.0,27,0.48148148148148145
198972237,2,18,2.0,20,0.1
198988406,2,8,2.0,10,0.2
198991079,4,15,4.0,19,0.21052631578947367
199013227,15,11,11.0,26,0.4230769230769231
199014442,6,4,4.0,10,0.4
199016993,2,7,2.0,9,0.2222222222222222
199025105,3,6,3.0,9,0.3333333333333333
199030412,1,9,1.0,10,0.1
199033242,2,7,2.0,9,0.2222222222222222
199042558,1,9,1.0,10,0.1
199054449,4,6,4.0,10,0.4
199072816,4,5,4.0,9,0.4444444444444444
199072973,2,8,2.0,10,0.2
199082339,3,16,3.0,19,0.15789473684210525
199091536,7,2,2.0,9,0.2222222222222222
199097784,3,7,3.0,10,0.3
199097905,2,8,2.0,10,0.2
199104136,8,2,2.0,10,0.2
199107444,1,9,1.0,10,0.1
199107626,10,17,10.0,27,0.37037037037037035
199110162,4,14,4.0,18,0.2222222222222222
199114156,6,4,4.0,10,0.4
199124503,1,9,1.0,10,0.1
199139236,9,1,1.0,10,0.1
199146960,2,7,2.0,9,0.2222222222222222
199162983,1,18,1.0,19,0.05263157894736842
199175658,1,19,1.0,20,0.05
199203048,2,17,2.0,19,0.10526315789473684
199229725,1,28,1.0,29,0.034482758620689655
199231073,6,4,4.0,10,0.4
199245567,3,6,3.0,9,0.3333333333333333
199246995,2,6,2.0,8,0.25
199272058,2,7,2.0,9,0.2222222222222222
199280624,1,8,1.0,9,0.1111111111111111
199280790,16,13,13.0,29,0.4482758620689655
199285896,9,1,1.0,10,0.1
199305526,4,25,4.0,29,0.13793103448275862
199316655,1,9,1.0,10,0.1
199316693,1,8,1.0,9,0.1111111111111111
199317079,3,7,3.0,10,0.3
199317383,2,8,2.0,10,0.2
199317732,2,26,2.0,28,0.07142857142857142
199318718,2,8,2.0,10,0.2
199319777,9,1,1.0,10,0.1
199321080,4,6,4.0,10,0.4
199324553,7,3,3.0,10,0.3
199328773,1,9,1.0,10,0.1
199336246,2,6,2.0,8,0.25
199345913,1,9,1.0,10,0.1
199347427,3,6,3.0,9,0.3333333333333333
199352659,2,7,2.0,9,0.2222222222222222
199360905,1,8,1.0,9,0.1111111111111111
199367982,1,8,1.0,9,0.1111111111111111
199368071,2,6,2.0,8,0.25
199369138,4,6,4.0,10,0.4
199377910,2,8,2.0,10,0.2
199379570,2,8,2.0,10,0.2
199379776,3,7,3.0,10,0.3
199380648,8,2,2.0,10,0.2
199382533,1,18,1.0,19,0.05263157894736842
199383159,7,3,3.0,10,0.3
199407484,1,8,1.0,9,0.1111111111111111
199407705,1,8,1.0,9,0.1111111111111111
199417666,2,8,2.0,10,0.2
199419151,10,19,10.0,29,0.3448275862068966
199425126,4,6,4.0,10,0.4
199426630,7,3,3.0,10,0.3
199431217,3,7,3.0,10,0.3
199433611,1,9,1.0,10,0.1
199434465,2,8,2.0,10,0.2
199434952,8,2,2.0,10,0.2
199436215,3,7,3.0,10,0.3
199437871,1,9,1.0,10,0.1
199439039,10,8,8.0,18,0.4444444444444444
199441589,1,8,1.0,9,0.1111111111111111
199455351,1,9,1.0,10,0.1
199458683,1,8,1.0,9,0.1111111111111111
199461262,2,8,2.0,10,0.2
199472089,2,17,2.0,19,0.10526315789473684
199480291,4,5,4.0,9,0.4444444444444444
199482125,4,5,4.0,9,0.4444444444444444
199483528,5,4,4.0,9,0.4444444444444444
199492739,3,7,3.0,10,0.3
199507660,8,2,2.0,10,0.2
199508159,9,1,1.0,10,0.1
199509049,1,28,1.0,29,0.034482758620689655
199512330,26,2,2.0,28,0.07142857142857142
199519141,2,8,2.0,10,0.2
199527281,6,4,4.0,10,0.4
199528982,1,9,1.0,10,0.1
199530509,6,3,3.0,9,0.3333333333333333
199530958,1,8,1.0,9,0.1111111111111111
199533153,1,8,1.0,9,0.1111111111111111
199560252,7,3,3.0,10,0.3
199561472,7,3,3.0,10,0.3
199563279,4,5,4.0,9,0.4444444444444444
199565808,1,8,1.0,9,0.1111111111111111
199599705,4,6,4.0,10,0.4
199602615,3,7,3.0,10,0.3
199650898,1,9,1.0,10,0.1
199652078,1,8,1.0,9,0.1111111111111111
199671206,6,12,6.0,18,0.3333333333333333
199689935,8,2,2.0,10,0.2
199695106,1,9,1.0,10,0.1
199696238,2,8,2.0,10,0.2
199699317,4,22,4.0,26,0.15384615384615385
199700056,1,8,1.0,9,0.1111111111111111
199735049,1,9,1.0,10,0.1
199771202,1,8,1.0,9,0.1111111111111111
199778276,4,5,4.0,9,0.4444444444444444
199793459,9,1,1.0,10,0.1
199822432,15,14,14.0,29,0.4827586206896552
199825470,1,18,1.0,19,0.05263157894736842
199847271,1,19,1.0,20,0.05
199849078,3,7,3.0,10,0.3
199853414,1,18,1.0,19,0.05263157894736842
199855372,2,8,2.0,10,0.2
199863391,1,9,1.0,10,0.1
199866185,6,3,3.0,9,0.3333333333333333
199878602,3,7,3.0,10,0.3
199879307,18,11,11.0,29,0.3793103448275862
199891255,1,18,1.0,19,0.05263157894736842
199892874,7,3,3.0,10,0.3
199912516,23,5,5.0,28,0.17857142857142858
199914739,5,5,5.0,10,0.5
199916776,5,4,4.0,9,0.4444444444444444
199917660,9,1,1.0,10,0.1
199918166,2,8,2.0,10,0.2
199919088,1,8,1.0,9,0.1111111111111111
199922467,2,7,2.0,9,0.2222222222222222
199923941,4,6,4.0,10,0.4
199941072,1,8,1.0,9,0.1111111111111111
199941724,3,5,3.0,8,0.375
199942254,1,27,1.0,28,0.03571428571428571
199943133,1,7,1.0,8,0.125
199943454,3,7,3.0,10,0.3
199945246,3,7,3.0,10,0.3
199945620,1,9,1.0,10,0.1
199956813,1,9,1.0,10,0.1
199977394,2,8,2.0,10,0.2
199984002,5,5,5.0,10,0.5
199993003,13,6,6.0,19,0.3157894736842105
200005118,1,18,1.0,19,0.05263157894736842
200005462,6,4,4.0,10,0.4
200006568,3,7,3.0,10,0.3
200006891,5,4,4.0,9,0.4444444444444444
200031491,8,1,1.0,9,0.1111111111111111
200031741,9,1,1.0,10,0.1
200037296,1,8,1.0,9,0.1111111111111111
200061911,1,8,1.0,9,0.1111111111111111
200066994,2,7,2.0,9,0.2222222222222222
200088478,1,8,1.0,9,0.1111111111111111
200120387,1,9,1.0,10,0.1
200133682,1,18,1.0,19,0.05263157894736842
200140796,4,6,4.0,10,0.4
200142779,2,26,2.0,28,0.07142857142857142
200162420,3,7,3.0,10,0.3
200163543,1,8,1.0,9,0.1111111111111111
200178953,1,9,1.0,10,0.1
200183959,2,8,2.0,10,0.2
200193134,4,6,4.0,10,0.4
200239488,2,8,2.0,10,0.2
200245379,4,6,4.0,10,0.4
200247546,1,9,1.0,10,0.1
200248577,8,1,1.0,9,0.1111111111111111
200261685,15,4,4.0,19,0.21052631578947367
200269062,3,6,3.0,9,0.3333333333333333
200271028,1,7,1.0,8,0.125
200276286,4,6,4.0,10,0.4
200276963,1,9,1.0,10,0.1
200278149,1,8,1.0,9,0.1111111111111111
200302030,3,7,3.0,10,0.3
200303450,7,3,3.0,10,0.3
200328850,1,9,1.0,10,0.1
200328948,1,9,1.0,10,0.1
200356919,4,6,4.0,10,0.4
200361526,8,2,2.0,10,0.2
200379961,5,5,5.0,10,0.5
200392047,3,7,3.0,10,0.3
200431703,9,20,9.0,29,0.3103448275862069
200433197,1,7,1.0,8,0.125
200436041,1,8,1.0,9,0.1111111111111111
200438628,8,1,1.0,9,0.1111111111111111
200438842,2,23,2.0,25,0.08
200446903,3,24,3.0,27,0.1111111111111111
200448489,1,19,1.0,20,0.05
200461147,8,2,2.0,10,0.2
200467451,3,5,3.0,8,0.375
200468615,5,4,4.0,9,0.4444444444444444
200484618,1,9,1.0,10,0.1
200504577,2,7,2.0,9,0.2222222222222222
200505493,1,9,1.0,10,0.1
200509926,3,7,3.0,10,0.3
200525542,5,4,4.0,9,0.4444444444444444
200558461,17,11,11.0,28,0.39285714285714285
200564502,7,1,1.0,8,0.125
200565606,4,6,4.0,10,0.4
200566036,8,2,2.0,10,0.2
200568100,8,2,2.0,10,0.2
200574370,6,4,4.0,10,0.4
200576071,3,6,3.0,9,0.3333333333333333
200577305,3,6,3.0,9,0.3333333333333333
200577954,5,5,5.0,10,0.5
200579773,1,9,1.0,10,0.1
200584774,9,1,1.0,10,0.1
200591415,1,9,1.0,10,0.1
200598913,1,8,1.0,9,0.1111111111111111
200600440,4,24,4.0,28,0.14285714285714285
200602053,5,3,3.0,8,0.375
200602524,1,8,1.0,9,0.1111111111111111
200603844,4,5,4.0,9,0.4444444444444444
200603963,3,6,3.0,9,0.3333333333333333
200605297,2,7,2.0,9,0.2222222222222222
200605318,1,7,1.0,8,0.125
200605373,1,9,1.0,10,0.1
200617924,2,7,2.0,9,0.2222222222222222
200618074,1,9,1.0,10,0.1
200619496,6,4,4.0,10,0.4
200625535,4,6,4.0,10,0.4
200652378,4,6,4.0,10,0.4
200675511,9,1,1.0,10,0.1
200713470,3,6,3.0,9,0.3333333333333333
200722461,8,2,2.0,10,0.2
200746306,1,8,1.0,9,0.1111111111111111
200757472,3,6,3.0,9,0.3333333333333333
200757668,2,27,2.0,29,0.06896551724137931
200757998,2,8,2.0,10,0.2
200760752,29,1,1.0,30,0.03333333333333333
200762448,4,5,4.0,9,0.4444444444444444
200765303,2,8,2.0,10,0.2
200768519,1,9,1.0,10,0.1
200770993,19,8,8.0,27,0.2962962962962963
200772787,1,8,1.0,9,0.1111111111111111
200834146,8,1,1.0,9,0.1111111111111111
200852316,5,14,5.0,19,0.2631578947368421
200857578,7,3,3.0,10,0.3
200858464,8,1,1.0,9,0.1111111111111111
200860561,9,1,1.0,10,0.1
200860867,2,8,2.0,10,0.2
200866380,2,7,2.0,9,0.2222222222222222
200869675,1,8,1.0,9,0.1111111111111111
200872199,3,5,3.0,8,0.375
200880910,4,6,4.0,10,0.4
200888252,1,9,1.0,10,0.1
200897739,2,8,2.0,10,0.2
200903267,1,8,1.0,9,0.1111111111111111
200918862,5,5,5.0,10,0.5
200920003,4,6,4.0,10,0.4
200921922,1,9,1.0,10,0.1
200952298,7,2,2.0,9,0.2222222222222222
200966094,2,8,2.0,10,0.2
200967997,2,8,2.0,10,0.2
200969505,1,9,1.0,10,0.1
200971298,4,6,4.0,10,0.4
200981689,4,23,4.0,27,0.14814814814814814
200998598,3,6,3.0,9,0.3333333333333333
201013342,1,8,1.0,9,0.1111111111111111
201019771,2,16,2.0,18,0.1111111111111111
201031089,1,9,1.0,10,0.1
201043554,1,17,1.0,18,0.05555555555555555
201065252,1,9,1.0,10,0.1
201095264,1,8,1.0,9,0.1111111111111111
201107768,1,17,1.0,18,0.05555555555555555
201108121,8,1,1.0,9,0.1111111111111111
201108506,5,4,4.0,9,0.4444444444444444
201110123,1,7,1.0,8,0.125
201110900,8,2,2.0,10,0.2
201112547,5,13,5.0,18,0.2777777777777778
201113653,5,5,5.0,10,0.5
201115279,1,8,1.0,9,0.1111111111111111
201115646,1,9,1.0,10,0.1
201125688,1,7,1.0,8,0.125
201126115,11,16,11.0,27,0.4074074074074074
201127186,1,9,1.0,10,0.1
201129574,1,9,1.0,10,0.1
201129794,1,8,1.0,9,0.1111111111111111
201130263,2,8,2.0,10,0.2
201132267,3,25,3.0,28,0.10714285714285714
201151813,3,6,3.0,9,0.3333333333333333
201154466,2,8,2.0,10,0.2
201160035,1,8,1.0,9,0.1111111111111111
201161221,1,9,1.0,10,0.1
201163694,1,8,1.0,9,0.1111111111111111
201164169,2,8,2.0,10,0.2
201167335,2,8,2.0,10,0.2
201172382,11,16,11.0,27,0.4074074074074074
201173786,1,9,1.0,10,0.1
201178982,1,7,1.0,8,0.125
201181539,6,4,4.0,10,0.4
201191030,1,9,1.0,10,0.1
201194303,9,1,1.0,10,0.1
201209046,7,1,1.0,8,0.125
201213485,3,7,3.0,10,0.3
201215404,1,18,1.0,19,0.05263157894736842
201220401,2,8,2.0,10,0.2
201226261,1,18,1.0,19,0.05263157894736842
201226941,8,1,1.0,9,0.1111111111111111
201227355,6,2,2.0,8,0.25
201229095,4,6,4.0,10,0.4
201229776,7,3,3.0,10,0.3
201229974,5,5,5.0,10,0.5
201230258,3,7,3.0,10,0.3
201232791,1,7,1.0,8,0.125
201234746,4,6,4.0,10,0.4
201236243,1,7,1.0,8,0.125
201237906,3,7,3.0,10,0.3
201237953,5,3,3.0,8,0.375
201240656,2,7,2.0,9,0.2222222222222222
201250290,3,22,3.0,25,0.12
201251578,1,9,1.0,10,0.1
201252931,1,9,1.0,10,0.1
201257225,4,6,4.0,10,0.4
201266383,8,2,2.0,10,0.2
201267045,6,4,4.0,10,0.4
201271896,6,23,6.0,29,0.20689655172413793
201273066,15,10,10.0,25,0.4
201273544,1,9,1.0,10,0.1
201274322,2,8,2.0,10,0.2
201275210,1,9,1.0,10,0.1
201275868,1,9,1.0,10,0.1
201277432,1,9,1.0,10,0.1
201278955,1,18,1.0,19,0.05263157894736842
201298815,2,16,2.0,18,0.1111111111111111
201318447,1,9,1.0,10,0.1
201321143,8,2,2.0,10,0.2
201322104,1,8,1.0,9,0.1111111111111111
201327453,2,7,2.0,9,0.2222222222222222
201329281,1,9,1.0,10,0.1
201338239,6,4,4.0,10,0.4
201339515,4,6,4.0,10,0.4
201347801,2,8,2.0,10,0.2
201349054,3,6,3.0,9,0.3333333333333333
201352805,5,3,3.0,8,0.375
201358689,2,7,2.0,9,0.2222222222222222
201370661,1,29,1.0,30,0.03333333333333333
201388135,1,9,1.0,10,0.1
201407017,2,6,2.0,8,0.25
201408358,1,18,1.0,19,0.05263157894736842
201409510,1,8,1.0,9,0.1111111111111111
201413184,2,8,2.0,10,0.2
201424425,4,6,4.0,10,0.4
201424860,1,8,1.0,9,0.1111111111111111
201429606,7,2,2.0,9,0.2222222222222222
201436405,1,9,1.0,10,0.1
201438464,4,6,4.0,10,0.4
201438819,1,18,1.0,19,0.05263157894736842
201441919,1,9,1.0,10,0.1
201445402,1,18,1.0,19,0.05263157894736842
201447683,3,7,3.0,10,0.3
201453800,13,16,13.0,29,0.4482758620689655
201455707,2,8,2.0,10,0.2
201469426,9,1,1.0,10,0.1
201473019,5,3,3.0,8,0.375
201478378,2,28,2.0,30,0.06666666666666667
201489887,1,19,1.0,20,0.05
201490726,6,4,4.0,10,0.4
201494209,2,7,2.0,9,0.2222222222222222
201496314,2,8,2.0,10,0.2
201506910,2,8,2.0,10,0.2
201525989,7,1,1.0,8,0.125
201543066,4,6,4.0,10,0.4
201543629,4,25,4.0,29,0.13793103448275862
201544262,2,7,2.0,9,0.2222222222222222
201552057,1,9,1.0,10,0.1
201552505,1,19,1.0,20,0.05
201552599,2,7,2.0,9,0.2222222222222222
201553940,3,7,3.0,10,0.3
201559298,1,8,1.0,9,0.1111111111111111
201560596,1,9,1.0,10,0.1
201560797,1,9,1.0,10,0.1
201561143,4,6,4.0,10,0.4
201562474,1,9,1.0,10,0.1
201562809,7,3,3.0,10,0.3
201564122,8,20,8.0,28,0.2857142857142857
201564471,2,8,2.0,10,0.2
201564938,9,10,9.0,19,0.47368421052631576
201574243,2,7,2.0,9,0.2222222222222222
201574528,3,7,3.0,10,0.3
201578079,6,2,2.0,8,0.25
201585204,3,7,3.0,10,0.3
201585775,4,6,4.0,10,0.4
201587550,4,6,4.0,10,0.4
201616392,8,12,8.0,20,0.4
201648018,2,8,2.0,10,0.2
201682458,7,3,3.0,10,0.3
201683039,8,12,8.0,20,0.4
201684810,7,2,2.0,9,0.2222222222222222
201685011,5,4,4.0,9,0.4444444444444444
201685734,4,6,4.0,10,0.4
201688444,2,8,2.0,10,0.2
201702789,1,19,1.0,20,0.05
201705585,2,7,2.0,9,0.2222222222222222
201705911,4,24,4.0,28,0.14285714285714285
201717142,1,17,1.0,18,0.05555555555555555
201718125,2,18,2.0,20,0.1
201722057,1,18,1.0,19,0.05263157894736842
201726438,2,7,2.0,9,0.2222222222222222
201756732,1,9,1.0,10,0.1
201769595,3,7,3.0,10,0.3
201822790,1,9,1.0,10,0.1
201823073,2,8,2.0,10,0.2
201826478,1,7,1.0,8,0.125
201849591,1,18,1.0,19,0.05263157894736842
201859705,1,8,1.0,9,0.1111111111111111
201859834,1,9,1.0,10,0.1
201861502,1,18,1.0,19,0.05263157894736842
201877985,1,8,1.0,9,0.1111111111111111
201907849,3,6,3.0,9,0.3333333333333333
201910168,1,8,1.0,9,0.1111111111111111
201924389,3,5,3.0,8,0.375
201942439,2,8,2.0,10,0.2
201971138,3,7,3.0,10,0.3
201973150,5,14,5.0,19,0.2631578947368421
201983387,9,1,1.0,10,0.1
201994099,1,9,1.0,10,0.1
202000594,1,9,1.0,10,0.1
202068513,3,7,3.0,10,0.3
202069166,4,16,4.0,20,0.2
202096213,2,8,2.0,10,0.2
202127364,1,8,1.0,9,0.1111111111111111
202127377,2,18,2.0,20,0.1
202128444,4,6,4.0,10,0.4
202128532,2,7,2.0,9,0.2222222222222222
202128831,5,5,5.0,10,0.5
202129463,4,4,4.0,8,0.5
202142895,1,8,1.0,9,0.1111111111111111
202148238,8,2,2.0,10,0.2
202164259,2,7,2.0,9,0.2222222222222222
202178221,2,7,2.0,9,0.2222222222222222
202180658,6,3,3.0,9,0.3333333333333333
202190656,1,8,1.0,9,0.1111111111111111
202205817,6,4,4.0,10,0.4
202206462,7,2,2.0,9,0.2222222222222222
202207725,4,6,4.0,10,0.4
202208016,3,7,3.0,10,0.3
202222181,1,9,1.0,10,0.1
202232598,8,2,2.0,10,0.2
202234763,1,9,1.0,10,0.1
202241814,1,9,1.0,10,0.1
202247729,1,9,1.0,10,0.1
202263755,1,9,1.0,10,0.1
202265104,2,17,2.0,19,0.10526315789473684
202277367,7,2,2.0,9,0.2222222222222222
202278433,4,6,4.0,10,0.4
202286991,4,5,4.0,9,0.4444444444444444
202287050,27,2,2.0,29,0.06896551724137931
202300516,1,8,1.0,9,0.1111111111111111
202322357,1,17,1.0,18,0.05555555555555555
202327804,1,9,1.0,10,0.1
202343872,6,14,6.0,20,0.3
202350416,1,18,1.0,19,0.05263157894736842
202350832,7,13,7.0,20,0.35
202390642,3,16,3.0,19,0.15789473684210525
202397718,1,9,1.0,10,0.1
202406949,1,9,1.0,10,0.1
202407734,1,9,1.0,10,0.1
202411436,11,8,8.0,19,0.42105263157894735
202419154,2,8,2.0,10,0.2
202419467,2,7,2.0,9,0.2222222222222222
202478649,1,9,1.0,10,0.1
202479794,5,5,5.0,10,0.5
202570904,2,8,2.0,10,0.2
202603019,3,17,3.0,20,0.15
202604427,9,1,1.0,10,0.1
202604501,2,7,2.0,9,0.2222222222222222
202609233,7,3,3.0,10,0.3
202610601,17,12,12.0,29,0.41379310344827586
202610829,9,1,1.0,10,0.1
202611404,2,8,2.0,10,0.2
202612949,4,6,4.0,10,0.4
202613417,7,3,3.0,10,0.3
202613755,2,8,2.0,10,0.2
202614930,9,1,1.0,10,0.1
202619764,9,8,8.0,17,0.47058823529411764
202620509,3,7,3.0,10,0.3
202623269,4,6,4.0,10,0.4
202632455,1,7,1.0,8,0.125
202637365,1,9,1.0,10,0.1
202637471,1,8,1.0,9,0.1111111111111111
202642374,3,7,3.0,10,0.3
202643206,1,8,1.0,9,0.1111111111111111
202648696,2,8,2.0,10,0.2
202687829,5,5,5.0,10,0.5
202711287,3,6,3.0,9,0.3333333333333333
202731639,8,9,8.0,17,0.47058823529411764
202753241,7,3,3.0,10,0.3
202773986,1,9,1.0,10,0.1
202788802,1,9,1.0,10,0.1
202801749,1,8,1.0,9,0.1111111111111111
202815953,2,7,2.0,9,0.2222222222222222
202818563,1,8,1.0,9,0.1111111111111111
202851359,1,7,1.0,8,0.125
202853384,8,2,2.0,10,0.2
202854670,15,5,5.0,20,0.25
202860138,2,8,2.0,10,0.2
202876686,1,9,1.0,10,0.1
202879301,2,17,2.0,19,0.10526315789473684
202896950,2,8,2.0,10,0.2
202902033,1,8,1.0,9,0.1111111111111111
202909100,1,17,1.0,18,0.05555555555555555
202938745,3,7,3.0,10,0.3
202953216,2,17,2.0,19,0.10526315789473684
202956964,4,12,4.0,16,0.25
202972333,6,2,2.0,8,0.25
202973425,8,2,2.0,10,0.2
202976186,6,3,3.0,9,0.3333333333333333
202984758,18,8,8.0,26,0.3076923076923077
202985790,3,6,3.0,9,0.3333333333333333
202992493,2,7,2.0,9,0.2222222222222222
202999972,9,1,1.0,10,0.1
203005914,7,3,3.0,10,0.3
203017373,7,3,3.0,10,0.3
203021467,1,9,1.0,10,0.1
203022426,9,1,1.0,10,0.1
203038058,4,5,4.0,9,0.4444444444444444
203041943,5,13,5.0,18,0.2777777777777778
203065133,4,6,4.0,10,0.4
203069495,1,9,1.0,10,0.1
203104486,2,7,2.0,9,0.2222222222222222
203110430,1,9,1.0,10,0.1
203111211,2,7,2.0,9,0.2222222222222222
203121925,1,9,1.0,10,0.1
203122532,1,9,1.0,10,0.1
203123047,4,5,4.0,9,0.4444444444444444
203125321,1,9,1.0,10,0.1
203133592,1,9,1.0,10,0.1
203150783,1,17,1.0,18,0.05555555555555555
203150929,1,19,1.0,20,0.05
203178308,5,5,5.0,10,0.5
203178568,4,16,4.0,20,0.2
203180684,1,8,1.0,9,0.1111111111111111
203187242,1,8,1.0,9,0.1111111111111111
203193303,2,8,2.0,10,0.2
203199897,1,9,1.0,10,0.1
203204411,1,9,1.0,10,0.1
203207226,2,6,2.0,8,0.25
203223848,2,16,2.0,18,0.1111111111111111
203227986,4,5,4.0,9,0.4444444444444444
203232054,9,1,1.0,10,0.1
203232858,4,6,4.0,10,0.4
203232925,1,9,1.0,10,0.1
203234183,9,1,1.0,10,0.1
203234647,7,2,2.0,9,0.2222222222222222
203234737,2,7,2.0,9,0.2222222222222222
203244495,1,9,1.0,10,0.1
203255673,1,7,1.0,8,0.125
203257213,6,4,4.0,10,0.4
203293211,1,7,1.0,8,0.125
203301841,9,1,1.0,10,0.1
203302277,2,8,2.0,10,0.2
203308480,2,25,2.0,27,0.07407407407407407
203325734,1,9,1.0,10,0.1
203352823,1,8,1.0,9,0.1111111111111111
203372685,1,7,1.0,8,0.125
203404244,1,9,1.0,10,0.1
203407066,1,18,1.0,19,0.05263157894736842
203411293,1,9,1.0,10,0.1
203411497,7,3,3.0,10,0.3
203413584,3,7,3.0,10,0.3
203414100,1,8,1.0,9,0.1111111111111111
203416885,1,19,1.0,20,0.05
203425877,17,10,10.0,27,0.37037037037037035
203431340,3,6,3.0,9,0.3333333333333333
203444070,6,3,3.0,9,0.3333333333333333
203450235,1,19,1.0,20,0.05
203491126,1,8,1.0,9,0.1111111111111111
203512090,2,7,2.0,9,0.2222222222222222
203513072,1,8,1.0,9,0.1111111111111111
203515515,9,21,9.0,30,0.3
203521921,1,15,1.0,16,0.0625
203567043,29,1,1.0,30,0.03333333333333333
203571097,2,17,2.0,19,0.10526315789473684
203571978,9,1,1.0,10,0.1
203597856,4,5,4.0,9,0.4444444444444444
203637027,4,5,4.0,9,0.4444444444444444
203642533,7,3,3.0,10,0.3
203657826,3,6,3.0,9,0.3333333333333333
203658274,8,2,2.0,10,0.2
203658370,2,8,2.0,10,0.2
203666761,1,9,1.0,10,0.1
203670138,3,15,3.0,18,0.16666666666666666
203671151,5,5,5.0,10,0.5
203673479,5,3,3.0,8,0.375
203693621,1,18,1.0,19,0.05263157894736842
203709124,5,5,5.0,10,0.5
203709627,2,7,2.0,9,0.2222222222222222
203733357,1,8,1.0,9,0.1111111111111111
203735223,8,2,2.0,10,0.2
203742432,1,8,1.0,9,0.1111111111111111
203743829,4,5,4.0,9,0.4444444444444444
203756347,9,10,9.0,19,0.47368421052631576
203763334,1,18,1.0,19,0.05263157894736842
203764336,3,17,3.0,20,0.15
203771504,1,9,1.0,10,0.1
203772624,2,8,2.0,10,0.2
203774802,1,8,1.0,9,0.1111111111111111
203775601,1,9,1.0,10,0.1
203780640,27,1,1.0,28,0.03571428571428571
203788648,5,25,5.0,30,0.16666666666666666
203790417,3,6,3.0,9,0.3333333333333333
203791013,1,9,1.0,10,0.1
203796640,1,9,1.0,10,0.1
203801166,1,9,1.0,10,0.1
203826202,2,8,2.0,10,0.2
203830037,1,9,1.0,10,0.1
203830779,4,4,4.0,8,0.5
203853453,3,7,3.0,10,0.3
203854300,5,4,4.0,9,0.4444444444444444
203854897,4,6,4.0,10,0.4
203873082,1,9,1.0,10,0.1
203873491,5,5,5.0,10,0.5
203877001,2,7,2.0,9,0.2222222222222222
203877215,4,6,4.0,10,0.4
203878098,2,8,2.0,10,0.2
203879284,1,9,1.0,10,0.1
203880300,3,7,3.0,10,0.3
203891635,2,8,2.0,10,0.2
203914075,15,14,14.0,29,0.4827586206896552
203917224,3,7,3.0,10,0.3
203918068,2,6,2.0,8,0.25
203918297,2,8,2.0,10,0.2
203922931,1,8,1.0,9,0.1111111111111111
203938231,1,8,1.0,9,0.1111111111111111
203938815,7,3,3.0,10,0.3
203966193,3,6,3.0,9,0.3333333333333333
203966991,3,6,3.0,9,0.3333333333333333
203982808,1,19,1.0,20,0.05
204017511,2,8,2.0,10,0.2
204024136,2,8,2.0,10,0.2
204045878,1,8,1.0,9,0.1111111111111111
204046118,2,7,2.0,9,0.2222222222222222
204049848,7,3,3.0,10,0.3
204052928,2,8,2.0,10,0.2
204053359,7,2,2.0,9,0.2222222222222222
204060557,1,9,1.0,10,0.1
204088921,3,7,3.0,10,0.3
204097495,2,7,2.0,9,0.2222222222222222
204098910,6,22,6.0,28,0.21428571428571427
204106678,1,9,1.0,10,0.1
204108133,1,9,1.0,10,0.1
204115058,5,4,4.0,9,0.4444444444444444
204115097,6,3,3.0,9,0.3333333333333333
204128739,1,7,1.0,8,0.125
204140085,1,9,1.0,10,0.1
204140279,1,9,1.0,10,0.1
204140588,4,4,4.0,8,0.5
204143900,4,6,4.0,10,0.4
204144279,2,7,2.0,9,0.2222222222222222
204144659,9,1,1.0,10,0.1
204151821,8,1,1.0,9,0.1111111111111111
204166368,1,9,1.0,10,0.1
204169051,4,6,4.0,10,0.4
204180289,1,8,1.0,9,0.1111111111111111
204196250,1,8,1.0,9,0.1111111111111111
204196767,2,7,2.0,9,0.2222222222222222
204202693,5,5,5.0,10,0.5
204206295,1,9,1.0,10,0.1
204212766,14,13,13.0,27,0.48148148148148145
204214010,6,4,4.0,10,0.4
204216778,1,19,1.0,20,0.05
204223385,18,9,9.0,27,0.3333333333333333
204228285,4,6,4.0,10,0.4
204228734,1,9,1.0,10,0.1
204229082,2,7,2.0,9,0.2222222222222222
204231455,3,26,3.0,29,0.10344827586206896
204233341,1,9,1.0,10,0.1
204235890,1,9,1.0,10,0.1
204237641,6,4,4.0,10,0.4
204241689,7,3,3.0,10,0.3
204242364,1,9,1.0,10,0.1
204242563,1,8,1.0,9,0.1111111111111111
204244074,4,6,4.0,10,0.4
204244752,1,8,1.0,9,0.1111111111111111
204254245,1,9,1.0,10,0.1
204255308,1,8,1.0,9,0.1111111111111111
204257714,5,13,5.0,18,0.2777777777777778
204257961,11,17,11.0,28,0.39285714285714285
204258202,2,7,2.0,9,0.2222222222222222
204258763,8,1,1.0,9,0.1111111111111111
204272250,1,8,1.0,9,0.1111111111111111
204293312,1,9,1.0,10,0.1
204296706,10,10,10.0,20,0.5
204300369,1,8,1.0,9,0.1111111111111111
204300546,9,1,1.0,10,0.1
204304884,2,18,2.0,20,0.1
204308237,8,2,2.0,10,0.2
204328002,1,9,1.0,10,0.1
204355550,1,18,1.0,19,0.05263157894736842
204360894,5,5,5.0,10,0.5
204370983,1,7,1.0,8,0.125
204371279,9,1,1.0,10,0.1
204372173,5,4,4.0,9,0.4444444444444444
204377961,2,6,2.0,8,0.25
204433105,1,9,1.0,10,0.1
204449928,3,17,3.0,20,0.15
204454284,1,18,1.0,19,0.05263157894736842
204458467,1,9,1.0,10,0.1
204459142,2,7,2.0,9,0.2222222222222222
204473548,9,1,1.0,10,0.1
204473973,6,2,2.0,8,0.25
204504660,22,7,7.0,29,0.2413793103448276
204505393,1,8,1.0,9,0.1111111111111111
204509381,3,7,3.0,10,0.3
204528026,2,8,2.0,10,0.2
204530431,5,3,3.0,8,0.375
204533306,1,18,1.0,19,0.05263157894736842
204534360,1,9,1.0,10,0.1
204534921,1,9,1.0,10,0.1
204544935,7,21,7.0,28,0.25
204545224,7,3,3.0,10,0.3
204559876,3,7,3.0,10,0.3
204569585,1,9,1.0,10,0.1
204576358,5,13,5.0,18,0.2777777777777778
204614961,3,7,3.0,10,0.3
204616673,2,8,2.0,10,0.2
204620172,1,9,1.0,10,0.1
204620566,4,5,4.0,9,0.4444444444444444
204625814,1,9,1.0,10,0.1
204638088,1,9,1.0,10,0.1
204653945,1,18,1.0,19,0.05263157894736842
204662583,1,7,1.0,8,0.125
204673617,4,5,4.0,9,0.4444444444444444
204675879,22,1,1.0,23,0.043478260869565216
204676553,4,6,4.0,10,0.4
204686096,10,9,9.0,19,0.47368421052631576
204691775,2,8,2.0,10,0.2
204696132,3,7,3.0,10,0.3
204699350,6,13,6.0,19,0.3157894736842105
204699411,1,7,1.0,8,0.125
204699802,5,4,4.0,9,0.4444444444444444
204703387,8,1,1.0,9,0.1111111111111111
204705244,1,9,1.0,10,0.1
204705991,1,9,1.0,10,0.1
204707919,2,7,2.0,9,0.2222222222222222
204717085,4,6,4.0,10,0.4
204730553,7,1,1.0,8,0.125
204736909,6,4,4.0,10,0.4
204737037,9,1,1.0,10,0.1
204741137,3,7,3.0,10,0.3
204743284,9,1,1.0,10,0.1
204744357,9,1,1.0,10,0.1
204752052,7,3,3.0,10,0.3
204756705,1,8,1.0,9,0.1111111111111111
204782010,2,8,2.0,10,0.2
204783889,2,6,2.0,8,0.25
204801408,1,9,1.0,10,0.1
204817434,7,1,1.0,8,0.125
204819439,1,9,1.0,10,0.1
204828087,6,3,3.0,9,0.3333333333333333
204830993,2,15,2.0,17,0.11764705882352941
204834397,2,17,2.0,19,0.10526315789473684
204837493,2,7,2.0,9,0.2222222222222222
204837600,2,16,2.0,18,0.1111111111111111
204870347,1,28,1.0,29,0.034482758620689655
204874088,5,14,5.0,19,0.2631578947368421
204931777,2,8,2.0,10,0.2
204947569,1,19,1.0,20,0.05
204956450,1,9,1.0,10,0.1
204964978,1,8,1.0,9,0.1111111111111111
204965115,1,9,1.0,10,0.1
204971930,1,18,1.0,19,0.05263157894736842
204985013,2,8,2.0,10,0.2
204986620,2,8,2.0,10,0.2
204988992,2,8,2.0,10,0.2
205002731,24,4,4.0,28,0.14285714285714285
205035227,1,7,1.0,8,0.125
205053405,1,8,1.0,9,0.1111111111111111
205056072,1,8,1.0,9,0.1111111111111111
205094386,1,9,1.0,10,0.1
205094690,8,1,1.0,9,0.1111111111111111
205113816,2,8,2.0,10,0.2
205114437,1,9,1.0,10,0.1
205115705,1,8,1.0,9,0.1111111111111111
205127174,18,7,7.0,25,0.28
205128334,1,9,1.0,10,0.1
205128913,1,9,1.0,10,0.1
205156452,1,9,1.0,10,0.1
205161842,1,7,1.0,8,0.125
205164178,1,27,1.0,28,0.03571428571428571
205167501,1,9,1.0,10,0.1
205167962,1,9,1.0,10,0.1
205168510,6,4,4.0,10,0.4
205173609,1,18,1.0,19,0.05263157894736842
205178043,2,8,2.0,10,0.2
205219641,1,9,1.0,10,0.1
205227973,3,6,3.0,9,0.3333333333333333
205231858,1,18,1.0,19,0.05263157894736842
205236847,4,4,4.0,8,0.5
205237561,3,7,3.0,10,0.3
205241693,3,7,3.0,10,0.3
205243069,3,7,3.0,10,0.3
205265774,2,25,2.0,27,0.07407407407407407
205266789,7,2,2.0,9,0.2222222222222222
205268636,1,17,1.0,18,0.05555555555555555
205270596,2,8,2.0,10,0.2
205273108,1,9,1.0,10,0.1
205315392,2,7,2.0,9,0.2222222222222222
205315585,1,9,1.0,10,0.1
205316806,6,3,3.0,9,0.3333333333333333
205317081,2,8,2.0,10,0.2
205317498,1,9,1.0,10,0.1
205317550,3,26,3.0,29,0.10344827586206896
205320123,1,9,1.0,10,0.1
205320885,2,8,2.0,10,0.2
205324015,2,8,2.0,10,0.2
205357967,7,2,2.0,9,0.2222222222222222
205362718,4,15,4.0,19,0.21052631578947367
205364528,8,2,2.0,10,0.2
205364802,8,1,1.0,9,0.1111111111111111
205371882,19,1,1.0,20,0.05
205382483,4,16,4.0,20,0.2
205385263,9,1,1.0,10,0.1
205387587,7,1,1.0,8,0.125
205389416,1,8,1.0,9,0.1111111111111111
205390987,4,25,4.0,29,0.13793103448275862
205399290,3,6,3.0,9,0.3333333333333333
205403788,6,2,2.0,8,0.25
205404653,1,7,1.0,8,0.125
205407300,2,18,2.0,20,0.1
205416943,4,6,4.0,10,0.4
205421475,5,5,5.0,10,0.5
205425064,1,18,1.0,19,0.05263157894736842
205447682,1,9,1.0,10,0.1
205450463,7,3,3.0,10,0.3
205467125,4,6,4.0,10,0.4
205472855,6,4,4.0,10,0.4
205472870,8,2,2.0,10,0.2
205473894,17,10,10.0,27,0.37037037037037035
205474265,1,9,1.0,10,0.1
205475164,3,6,3.0,9,0.3333333333333333
205486130,4,6,4.0,10,0.4
205492760,5,5,5.0,10,0.5
205494526,3,7,3.0,10,0.3
205500127,2,6,2.0,8,0.25
205500577,2,8,2.0,10,0.2
205500817,1,8,1.0,9,0.1111111111111111
205500948,2,8,2.0,10,0.2
205512079,1,9,1.0,10,0.1
205519799,8,2,2.0,10,0.2
205520168,2,7,2.0,9,0.2222222222222222
205544659,9,1,1.0,10,0.1
205567741,3,7,3.0,10,0.3
205571436,3,7,3.0,10,0.3
205590446,7,1,1.0,8,0.125
205594255,1,19,1.0,20,0.05
205613819,1,9,1.0,10,0.1
205634930,1,19,1.0,20,0.05
205641757,1,8,1.0,9,0.1111111111111111
205647286,7,2,2.0,9,0.2222222222222222
205648217,6,4,4.0,10,0.4
205649108,1,9,1.0,10,0.1
205649739,8,1,1.0,9,0.1111111111111111
205649852,7,3,3.0,10,0.3
205651153,3,5,3.0,8,0.375
205684148,2,8,2.0,10,0.2
205685004,3,7,3.0,10,0.3
205685057,7,1,1.0,8,0.125
205695479,1,8,1.0,9,0.1111111111111111
205696224,2,8,2.0,10,0.2
205718535,1,9,1.0,10,0.1
205764113,1,8,1.0,9,0.1111111111111111
205785123,8,2,2.0,10,0.2
205795639,2,7,2.0,9,0.2222222222222222
205802068,7,13,7.0,20,0.35
205829165,4,21,4.0,25,0.16
205833531,4,5,4.0,9,0.4444444444444444
205844523,1,9,1.0,10,0.1
205855162,1,18,1.0,19,0.05263157894736842
205857183,1,8,1.0,9,0.1111111111111111
205858055,1,8,1.0,9,0.1111111111111111
205863250,2,8,2.0,10,0.2
205866983,15,5,5.0,20,0.25
205867299,2,7,2.0,9,0.2222222222222222
205867637,1,9,1.0,10,0.1
205868441,2,7,2.0,9,0.2222222222222222
205868794,1,9,1.0,10,0.1
205869349,5,5,5.0,10,0.5
205875983,3,7,3.0,10,0.3
205881647,2,27,2.0,29,0.06896551724137931
205910572,2,8,2.0,10,0.2
205920948,1,9,1.0,10,0.1
205964034,17,12,12.0,29,0.41379310344827586
205975249,8,2,2.0,10,0.2
205975838,4,4,4.0,8,0.5
205988377,6,2,2.0,8,0.25
205988866,6,2,2.0,8,0.25
205989317,2,8,2.0,10,0.2
205989611,4,23,4.0,27,0.14814814814814814
205993713,9,11,9.0,20,0.45
205995262,3,6,3.0,9,0.3333333333333333
205997643,3,7,3.0,10,0.3
206001278,6,4,4.0,10,0.4
206009859,2,7,2.0,9,0.2222222222222222
206012123,4,5,4.0,9,0.4444444444444444
206021992,1,15,1.0,16,0.0625
206050308,1,8,1.0,9,0.1111111111111111
206055184,1,8,1.0,9,0.1111111111111111
206061122,1,8,1.0,9,0.1111111111111111
206069317,1,8,1.0,9,0.1111111111111111
206077882,1,9,1.0,10,0.1
206082872,2,17,2.0,19,0.10526315789473684
206089414,3,6,3.0,9,0.3333333333333333
206110269,1,8,1.0,9,0.1111111111111111
206112761,1,18,1.0,19,0.05263157894736842
206135486,26,3,3.0,29,0.10344827586206896
206160349,2,8,2.0,10,0.2
206184187,3,7,3.0,10,0.3
206187848,2,6,2.0,8,0.25
206194819,3,7,3.0,10,0.3
206224643,1,19,1.0,20,0.05
206227097,1,8,1.0,9,0.1111111111111111
206227529,8,2,2.0,10,0.2
206244208,1,9,1.0,10,0.1
206244710,8,11,8.0,19,0.42105263157894735
206250721,1,19,1.0,20,0.05
206253000,1,7,1.0,8,0.125
206254566,5,4,4.0,9,0.4444444444444444
206266796,2,7,2.0,9,0.2222222222222222
206287288,6,4,4.0,10,0.4
206292089,7,2,2.0,9,0.2222222222222222
206297104,1,9,1.0,10,0.1
206305193,1,9,1.0,10,0.1
206308546,1,9,1.0,10,0.1
206310208,3,15,3.0,18,0.16666666666666666
206325572,1,9,1.0,10,0.1
206326710,1,9,1.0,10,0.1
206328106,1,9,1.0,10,0.1
206333033,1,19,1.0,20,0.05
206352628,6,4,4.0,10,0.4
206354403,1,8,1.0,9,0.1111111111111111
206354761,1,9,1.0,10,0.1
206364100,2,7,2.0,9,0.2222222222222222
206407126,3,6,3.0,9,0.3333333333333333
206412713,9,1,1.0,10,0.1
206422590,4,5,4.0,9,0.4444444444444444
206429112,1,29,1.0,30,0.03333333333333333
206429997,2,7,2.0,9,0.2222222222222222
206433084,1,8,1.0,9,0.1111111111111111
206437288,9,1,1.0,10,0.1
206455187,1,9,1.0,10,0.1
206476700,7,3,3.0,10,0.3
206477386,7,2,2.0,9,0.2222222222222222
206497179,8,21,8.0,29,0.27586206896551724
206498132,7,3,3.0,10,0.3
206511807,7,3,3.0,10,0.3
206522859,9,10,9.0,19,0.47368421052631576
206523158,6,4,4.0,10,0.4
206531118,1,7,1.0,8,0.125
206534187,2,6,2.0,8,0.25
206556430,7,3,3.0,10,0.3
206558637,3,6,3.0,9,0.3333333333333333
206571709,1,9,1.0,10,0.1
206577565,1,9,1.0,10,0.1
206577788,3,5,3.0,8,0.375
206579270,2,8,2.0,10,0.2
206593203,1,9,1.0,10,0.1
206601543,5,4,4.0,9,0.4444444444444444
206602610,1,8,1.0,9,0.1111111111111111
206606476,2,8,2.0,10,0.2
206607288,1,9,1.0,10,0.1
206616136,5,5,5.0,10,0.5
206618551,8,1,1.0,9,0.1111111111111111
206618714,1,9,1.0,10,0.1
206621071,2,7,2.0,9,0.2222222222222222
206624637,8,2,2.0,10,0.2
206648413,2,8,2.0,10,0.2
206654663,14,14,14.0,28,0.5
206658584,4,5,4.0,9,0.4444444444444444
206663384,1,9,1.0,10,0.1
206663425,1,9,1.0,10,0.1
206664024,6,3,3.0,9,0.3333333333333333
206672444,6,4,4.0,10,0.4
206672902,6,21,6.0,27,0.2222222222222222
206683653,3,6,3.0,9,0.3333333333333333
206708163,6,2,2.0,8,0.25
206724590,2,6,2.0,8,0.25
206776977,4,6,4.0,10,0.4
206787086,2,7,2.0,9,0.2222222222222222
206799993,1,8,1.0,9,0.1111111111111111
206800183,1,9,1.0,10,0.1
206816100,2,8,2.0,10,0.2
206835536,1,9,1.0,10,0.1
206864887,2,7,2.0,9,0.2222222222222222
206868762,1,8,1.0,9,0.1111111111111111
206882997,5,12,5.0,17,0.29411764705882354
206903685,1,9,1.0,10,0.1
206915477,2,7,2.0,9,0.2222222222222222
206920710,4,5,4.0,9,0.4444444444444444
206920873,1,9,1.0,10,0.1
206921012,5,4,4.0,9,0.4444444444444444
206921230,9,19,9.0,28,0.32142857142857145
206921579,1,9,1.0,10,0.1
206929448,3,6,3.0,9,0.3333333333333333
206929493,8,2,2.0,10,0.2
206929663,1,8,1.0,9,0.1111111111111111
206930227,4,6,4.0,10,0.4
206930765,8,1,1.0,9,0.1111111111111111
206931086,5,5,5.0,10,0.5
206931998,3,7,3.0,10,0.3
206933459,7,2,2.0,9,0.2222222222222222
206938393,6,3,3.0,9,0.3333333333333333
206940495,1,8,1.0,9,0.1111111111111111
206947846,5,5,5.0,10,0.5
206949702,4,6,4.0,10,0.4
206952817,5,4,4.0,9,0.4444444444444444
206952935,3,26,3.0,29,0.10344827586206896
206953110,1,9,1.0,10,0.1
206953470,6,23,6.0,29,0.20689655172413793
206962112,1,8,1.0,9,0.1111111111111111
206975289,1,8,1.0,9,0.1111111111111111
206996249,3,6,3.0,9,0.3333333333333333
206996690,1,9,1.0,10,0.1
206996829,7,2,2.0,9,0.2222222222222222
206998054,3,16,3.0,19,0.15789473684210525
206999685,4,6,4.0,10,0.4
207000155,2,8,2.0,10,0.2
207000453,3,6,3.0,9,0.3333333333333333
207000683,1,8,1.0,9,0.1111111111111111
207001886,3,7,3.0,10,0.3
207003488,2,7,2.0,9,0.2222222222222222
207006283,1,9,1.0,10,0.1
207058424,1,8,1.0,9,0.1111111111111111
207061589,3,6,3.0,9,0.3333333333333333
207071135,8,2,2.0,10,0.2
207078913,3,6,3.0,9,0.3333333333333333
207079030,7,3,3.0,10,0.3
207085100,6,4,4.0,10,0.4
207096547,8,2,2.0,10,0.2
207102735,1,8,1.0,9,0.1111111111111111
207109608,2,17,2.0,19,0.10526315789473684
207116220,1,8,1.0,9,0.1111111111111111
207116245,1,8,1.0,9,0.1111111111111111
207116536,6,4,4.0,10,0.4
207119346,4,6,4.0,10,0.4
207128950,2,8,2.0,10,0.2
207131782,20,6,6.0,26,0.23076923076923078
207133384,2,6,2.0,8,0.25
207135141,13,16,13.0,29,0.4482758620689655
207143994,1,8,1.0,9,0.1111111111111111
207145377,7,3,3.0,10,0.3
207149589,1,9,1.0,10,0.1
207152601,3,17,3.0,20,0.15
207158104,5,4,4.0,9,0.4444444444444444
207158852,2,8,2.0,10,0.2
207159242,7,3,3.0,10,0.3
207163032,2,8,2.0,10,0.2
207165902,2,7,2.0,9,0.2222222222222222
207169491,2,8,2.0,10,0.2
207182449,4,6,4.0,10,0.4
207198933,1,19,1.0,20,0.05
207210140,3,7,3.0,10,0.3
207221995,5,24,5.0,29,0.1724137931034483
207227099,5,5,5.0,10,0.5
207235952,4,6,4.0,10,0.4
207237036,3,7,3.0,10,0.3
207247088,1,18,1.0,19,0.05263157894736842
207267552,1,9,1.0,10,0.1
207268615,3,26,3.0,29,0.10344827586206896
207271485,2,8,2.0,10,0.2
207283050,1,9,1.0,10,0.1
207284025,2,7,2.0,9,0.2222222222222222
207285808,2,8,2.0,10,0.2
207286520,2,8,2.0,10,0.2
207287960,1,18,1.0,19,0.05263157894736842
207300523,1,8,1.0,9,0.1111111111111111
207302802,3,6,3.0,9,0.3333333333333333
207304272,1,8,1.0,9,0.1111111111111111
207322044,2,7,2.0,9,0.2222222222222222
207330912,2,7,2.0,9,0.2222222222222222
207336929,1,9,1.0,10,0.1
207340501,1,9,1.0,10,0.1
207340939,1,9,1.0,10,0.1
207341353,7,2,2.0,9,0.2222222222222222
207342769,3,7,3.0,10,0.3
207374306,1,8,1.0,9,0.1111111111111111
207380758,1,9,1.0,10,0.1
207381574,1,9,1.0,10,0.1
207385854,1,7,1.0,8,0.125
207394687,2,7,2.0,9,0.2222222222222222
207396013,2,7,2.0,9,0.2222222222222222
207415406,1,9,1.0,10,0.1
207424397,1,19,1.0,20,0.05
207425164,2,8,2.0,10,0.2
207425824,2,8,2.0,10,0.2
207426383,2,8,2.0,10,0.2
207427443,4,6,4.0,10,0.4
207434183,5,5,5.0,10,0.5
207437294,2,8,2.0,10,0.2
207453932,1,9,1.0,10,0.1
207466964,5,5,5.0,10,0.5
207474286,7,10,7.0,17,0.4117647058823529
207475479,2,17,2.0,19,0.10526315789473684
207486593,4,5,4.0,9,0.4444444444444444
207487350,3,6,3.0,9,0.3333333333333333
207488140,22,5,5.0,27,0.18518518518518517
207488582,5,5,5.0,10,0.5
207510983,1,8,1.0,9,0.1111111111111111
207512149,1,19,1.0,20,0.05
207512762,1,9,1.0,10,0.1
207518553,1,9,1.0,10,0.1
207523905,2,7,2.0,9,0.2222222222222222
207530056,12,13,12.0,25,0.48
207536712,1,18,1.0,19,0.05263157894736842
207559927,8,2,2.0,10,0.2
207563096,1,8,1.0,9,0.1111111111111111
207570258,3,7,3.0,10,0.3
207570642,9,1,1.0,10,0.1
207571164,1,8,1.0,9,0.1111111111111111
207571410,1,9,1.0,10,0.1
207578036,1,9,1.0,10,0.1
207579471,4,6,4.0,10,0.4
207590194,1,9,1.0,10,0.1
207608942,2,7,2.0,9,0.2222222222222222
207622015,3,7,3.0,10,0.3
207622455,3,7,3.0,10,0.3
207625732,2,8,2.0,10,0.2
207627029,1,18,1.0,19,0.05263157894736842
207628601,1,9,1.0,10,0.1
207629329,7,12,7.0,19,0.3684210526315789
207700663,1,8,1.0,9,0.1111111111111111
207705387,6,3,3.0,9,0.3333333333333333
207720621,6,3,3.0,9,0.3333333333333333
207735736,2,6,2.0,8,0.25
207738082,1,9,1.0,10,0.1
207742622,3,7,3.0,10,0.3
207746315,1,17,1.0,18,0.05555555555555555
207756333,1,8,1.0,9,0.1111111111111111
207761041,1,18,1.0,19,0.05263157894736842
207774195,1,17,1.0,18,0.05555555555555555
207778681,1,9,1.0,10,0.1
207778714,1,8,1.0,9,0.1111111111111111
207802773,1,8,1.0,9,0.1111111111111111
207870546,2,8,2.0,10,0.2
207871034,1,9,1.0,10,0.1
207871885,1,9,1.0,10,0.1
207872383,6,22,6.0,28,0.21428571428571427
207880677,1,8,1.0,9,0.1111111111111111
207881755,6,24,6.0,30,0.2
207882953,1,9,1.0,10,0.1
207887667,4,5,4.0,9,0.4444444444444444
207893926,1,9,1.0,10,0.1
207937003,1,9,1.0,10,0.1
207943073,6,13,6.0,19,0.3157894736842105
207943276,2,8,2.0,10,0.2
207962546,3,7,3.0,10,0.3
207963746,7,2,2.0,9,0.2222222222222222
207974311,1,7,1.0,8,0.125
208002360,6,4,4.0,10,0.4
208025911,2,8,2.0,10,0.2
208026536,1,9,1.0,10,0.1
208032468,1,9,1.0,10,0.1
208033656,8,2,2.0,10,0.2
208043785,2,8,2.0,10,0.2
208054559,1,8,1.0,9,0.1111111111111111
208054708,2,8,2.0,10,0.2
208068870,1,9,1.0,10,0.1
208095734,3,7,3.0,10,0.3
208101719,1,9,1.0,10,0.1
208104115,2,18,2.0,20,0.1
208104276,8,1,1.0,9,0.1111111111111111
208105684,28,1,1.0,29,0.034482758620689655
208105963,2,8,2.0,10,0.2
208107931,1,8,1.0,9,0.1111111111111111
208119810,13,2,2.0,15,0.13333333333333333
208165341,1,19,1.0,20,0.05
208167003,1,17,1.0,18,0.05555555555555555
208176262,9,9,9.0,18,0.5
208181770,1,8,1.0,9,0.1111111111111111
208189238,2,7,2.0,9,0.2222222222222222
208189773,2,17,2.0,19,0.10526315789473684
208190252,1,9,1.0,10,0.1
208192783,4,5,4.0,9,0.4444444444444444
208200378,7,3,3.0,10,0.3
208205546,1,7,1.0,8,0.125
208235987,1,18,1.0,19,0.05263157894736842
208236002,1,7,1.0,8,0.125
208244010,1,9,1.0,10,0.1
208258040,1,19,1.0,20,0.05
208279418,3,7,3.0,10,0.3
208299058,14,16,14.0,30,0.4666666666666667
208319163,2,8,2.0,10,0.2
208331492,1,7,1.0,8,0.125
208359833,7,2,2.0,9,0.2222222222222222
208360571,1,7,1.0,8,0.125
208360725,15,12,12.0,27,0.4444444444444444
208361486,7,3,3.0,10,0.3
208361618,4,25,4.0,29,0.13793103448275862
208362309,5,4,4.0,9,0.4444444444444444
208372396,1,19,1.0,20,0.05
208374427,5,4,4.0,9,0.4444444444444444
208374672,1,8,1.0,9,0.1111111111111111
208378477,6,4,4.0,10,0.4
208379864,2,7,2.0,9,0.2222222222222222
208380052,3,5,3.0,8,0.375
208380172,6,3,3.0,9,0.3333333333333333
208380378,3,6,3.0,9,0.3333333333333333
208392094,3,6,3.0,9,0.3333333333333333
208401301,11,8,8.0,19,0.42105263157894735
208416313,2,8,2.0,10,0.2
208434726,1,19,1.0,20,0.05
208443450,2,7,2.0,9,0.2222222222222222
208467944,8,2,2.0,10,0.2
208473250,2,8,2.0,10,0.2
208501204,4,6,4.0,10,0.4
208507777,1,19,1.0,20,0.05
208515932,1,19,1.0,20,0.05
208528201,9,1,1.0,10,0.1
208575508,9,1,1.0,10,0.1
208576493,2,8,2.0,10,0.2
208608597,6,3,3.0,9,0.3333333333333333
208613537,5,5,5.0,10,0.5
208639932,6,4,4.0,10,0.4
208640769,8,2,2.0,10,0.2
208649632,1,9,1.0,10,0.1
208651592,1,9,1.0,10,0.1
208654891,4,6,4.0,10,0.4
208655110,8,1,1.0,9,0.1111111111111111
208670675,2,8,2.0,10,0.2
208671093,1,7,1.0,8,0.125
208671756,6,4,4.0,10,0.4
208673674,4,6,4.0,10,0.4
208681531,3,15,3.0,18,0.16666666666666666
208682983,2,8,2.0,10,0.2
208683869,4,5,4.0,9,0.4444444444444444
208709187,4,6,4.0,10,0.4
208709619,1,17,1.0,18,0.05555555555555555
208719332,4,5,4.0,9,0.4444444444444444
208728723,5,5,5.0,10,0.5
208750273,9,1,1.0,10,0.1
208754867,2,8,2.0,10,0.2
208761594,7,3,3.0,10,0.3
208761798,8,2,2.0,10,0.2
208762366,5,4,4.0,9,0.4444444444444444
208766554,9,1,1.0,10,0.1
208768101,7,3,3.0,10,0.3
208768320,4,5,4.0,9,0.4444444444444444
208768339,1,8,1.0,9,0.1111111111111111
208768879,7,3,3.0,10,0.3
208769542,5,5,5.0,10,0.5
208770458,7,2,2.0,9,0.2222222222222222
208778454,4,16,4.0,20,0.2
208793056,2,8,2.0,10,0.2
208796707,3,6,3.0,9,0.3333333333333333
208804932,2,7,2.0,9,0.2222222222222222
208805679,1,19,1.0,20,0.05
208807910,9,1,1.0,10,0.1
208808727,2,8,2.0,10,0.2
208810739,7,2,2.0,9,0.2222222222222222
208839029,1,9,1.0,10,0.1
208847202,7,3,3.0,10,0.3
208882386,4,6,4.0,10,0.4
208882713,1,9,1.0,10,0.1
208884401,1,9,1.0,10,0.1
208885958,1,9,1.0,10,0.1
208887204,3,6,3.0,9,0.3333333333333333
208887650,1,8,1.0,9,0.1111111111111111
208889285,1,9,1.0,10,0.1
208890166,2,8,2.0,10,0.2
208892967,2,7,2.0,9,0.2222222222222222
208896193,1,9,1.0,10,0.1
208945106,1,19,1.0,20,0.05
208979150,6,3,3.0,9,0.3333333333333333
208980279,3,6,3.0,9,0.3333333333333333
208981395,5,5,5.0,10,0.5
209013484,7,18,7.0,25,0.28
209021397,7,2,2.0,9,0.2222222222222222
209056438,7,2,2.0,9,0.2222222222222222
209084955,8,2,2.0,10,0.2
209099853,5,5,5.0,10,0.5
209102386,5,4,4.0,9,0.4444444444444444
209119031,7,3,3.0,10,0.3
209120629,1,8,1.0,9,0.1111111111111111
209122744,8,1,1.0,9,0.1111111111111111
209123665,6,4,4.0,10,0.4
209124566,9,1,1.0,10,0.1
209124757,1,9,1.0,10,0.1
209124899,8,1,1.0,9,0.1111111111111111
209162889,5,5,5.0,10,0.5
209172906,1,9,1.0,10,0.1
209181882,1,9,1.0,10,0.1
209183420,3,7,3.0,10,0.3
209224676,1,7,1.0,8,0.125
209229399,1,9,1.0,10,0.1
209233648,3,7,3.0,10,0.3
209233868,7,2,2.0,9,0.2222222222222222
209253283,1,16,1.0,17,0.058823529411764705
209284108,4,5,4.0,9,0.4444444444444444
209288861,7,2,2.0,9,0.2222222222222222
209289797,7,3,3.0,10,0.3
209293605,6,3,3.0,9,0.3333333333333333
209307068,1,8,1.0,9,0.1111111111111111
209311350,6,24,6.0,30,0.2
209327768,7,13,7.0,20,0.35
209341441,5,5,5.0,10,0.5
209341583,7,3,3.0,10,0.3
209349688,1,28,1.0,29,0.034482758620689655
209389727,2,7,2.0,9,0.2222222222222222
209390904,3,7,3.0,10,0.3
209392988,2,8,2.0,10,0.2
209396218,3,15,3.0,18,0.16666666666666666
209404702,1,7,1.0,8,0.125
209410397,1,9,1.0,10,0.1
209414000,2,15,2.0,17,0.11764705882352941
209435370,8,1,1.0,9,0.1111111111111111
209455557,3,6,3.0,9,0.3333333333333333
209461522,3,7,3.0,10,0.3
209463076,2,7,2.0,9,0.2222222222222222
209466866,2,8,2.0,10,0.2
209469862,1,8,1.0,9,0.1111111111111111
209471162,1,9,1.0,10,0.1
209472334,2,17,2.0,19,0.10526315789473684
209473720,5,3,3.0,8,0.375
209473983,1,9,1.0,10,0.1
209474143,1,9,1.0,10,0.1
209477160,1,9,1.0,10,0.1
209487366,2,8,2.0,10,0.2
209490004,1,8,1.0,9,0.1111111111111111
209498224,3,7,3.0,10,0.3
209499570,7,3,3.0,10,0.3
209502261,2,7,2.0,9,0.2222222222222222
209503553,4,6,4.0,10,0.4
209520649,9,1,1.0,10,0.1
209540692,3,7,3.0,10,0.3
209542311,3,7,3.0,10,0.3
209542475,7,13,7.0,20,0.35
209543207,7,3,3.0,10,0.3
209544066,4,6,4.0,10,0.4
209554361,5,22,5.0,27,0.18518518518518517
209588104,4,5,4.0,9,0.4444444444444444
209620672,4,4,4.0,8,0.5
209631748,8,1,1.0,9,0.1111111111111111
209636500,7,2,2.0,9,0.2222222222222222
209638176,2,25,2.0,27,0.07407407407407407
209648697,1,9,1.0,10,0.1
209688584,1,8,1.0,9,0.1111111111111111
209710217,2,8,2.0,10,0.2
209721443,1,9,1.0,10,0.1
209722369,1,18,1.0,19,0.05263157894736842
209724022,1,8,1.0,9,0.1111111111111111
209724704,5,5,5.0,10,0.5
209726144,3,7,3.0,10,0.3
209731272,3,7,3.0,10,0.3
209744357,5,5,5.0,10,0.5
209751607,1,9,1.0,10,0.1
209756952,7,2,2.0,9,0.2222222222222222
209758732,5,4,4.0,9,0.4444444444444444
209774430,3,7,3.0,10,0.3
209811719,6,4,4.0,10,0.4
209811738,1,16,1.0,17,0.058823529411764705
209814236,1,9,1.0,10,0.1
209821536,1,19,1.0,20,0.05
209852035,3,7,3.0,10,0.3
209854808,3,15,3.0,18,0.16666666666666666
209874445,2,7,2.0,9,0.2222222222222222
209925609,1,9,1.0,10,0.1
209925804,5,5,5.0,10,0.5
209946767,8,2,2.0,10,0.2
209947460,8,2,2.0,10,0.2
209956912,1,9,1.0,10,0.1
209958467,4,6,4.0,10,0.4
209968753,1,9,1.0,10,0.1
209975592,4,16,4.0,20,0.2
209981867,3,6,3.0,9,0.3333333333333333
209999143,2,8,2.0,10,0.2
210012966,9,1,1.0,10,0.1
210013065,4,6,4.0,10,0.4
210026595,2,8,2.0,10,0.2
210038954,2,8,2.0,10,0.2
210040755,5,5,5.0,10,0.5
210043966,1,9,1.0,10,0.1
210048589,1,17,1.0,18,0.05555555555555555
210078384,5,5,5.0,10,0.5
210129731,1,8,1.0,9,0.1111111111111111
210130604,3,25,3.0,28,0.10714285714285714
210135338,6,4,4.0,10,0.4
210140481,3,7,3.0,10,0.3
210141202,5,4,4.0,9,0.4444444444444444
210154396,4,6,4.0,10,0.4
210163241,3,7,3.0,10,0.3
210168085,2,8,2.0,10,0.2
210168185,1,9,1.0,10,0.1
210169312,4,6,4.0,10,0.4
210181876,3,7,3.0,10,0.3
210184125,1,9,1.0,10,0.1
210184293,1,9,1.0,10,0.1
210185580,1,9,1.0,10,0.1
210196928,2,8,2.0,10,0.2
210197153,1,9,1.0,10,0.1
210197917,1,8,1.0,9,0.1111111111111111
210200639,4,5,4.0,9,0.4444444444444444
210201021,4,6,4.0,10,0.4
210201507,1,27,1.0,28,0.03571428571428571
210201581,3,7,3.0,10,0.3
210203118,4,23,4.0,27,0.14814814814814814
210203259,5,5,5.0,10,0.5
210205050,4,5,4.0,9,0.4444444444444444
210208919,2,27,2.0,29,0.06896551724137931
210216199,3,6,3.0,9,0.3333333333333333
210220361,1,9,1.0,10,0.1
210222408,4,6,4.0,10,0.4
210247641,3,7,3.0,10,0.3
210250379,1,19,1.0,20,0.05
210251331,2,17,2.0,19,0.10526315789473684
210260761,1,9,1.0,10,0.1
210301697,1,9,1.0,10,0.1
210310370,2,17,2.0,19,0.10526315789473684
210332127,3,6,3.0,9,0.3333333333333333
210337267,9,1,1.0,10,0.1
210346158,3,7,3.0,10,0.3
210368948,3,7,3.0,10,0.3
210373180,1,9,1.0,10,0.1
210378168,8,2,2.0,10,0.2
210385541,7,21,7.0,28,0.25
210386144,5,5,5.0,10,0.5
210391727,4,5,4.0,9,0.4444444444444444
210392087,3,7,3.0,10,0.3
210392505,1,7,1.0,8,0.125
210394177,2,8,2.0,10,0.2
210395063,9,1,1.0,10,0.1
210395150,1,8,1.0,9,0.1111111111111111
210395563,1,8,1.0,9,0.1111111111111111
210395581,9,1,1.0,10,0.1
210396156,6,3,3.0,9,0.3333333333333333
210397494,17,3,3.0,20,0.15
210397692,2,8,2.0,10,0.2
210398303,1,19,1.0,20,0.05
210400168,1,9,1.0,10,0.1
210400381,2,8,2.0,10,0.2
210401956,1,9,1.0,10,0.1
210410668,7,3,3.0,10,0.3
210426186,7,2,2.0,9,0.2222222222222222
210433153,1,16,1.0,17,0.058823529411764705
210433759,6,3,3.0,9,0.3333333333333333
210452282,1,9,1.0,10,0.1
210485678,2,16,2.0,18,0.1111111111111111
210505623,1,18,1.0,19,0.05263157894736842
210570976,4,14,4.0,18,0.2222222222222222
210583260,1,9,1.0,10,0.1
210584114,1,9,1.0,10,0.1
210589444,1,8,1.0,9,0.1111111111111111
210590766,3,7,3.0,10,0.3
210591638,12,6,6.0,18,0.3333333333333333
210630664,4,16,4.0,20,0.2
210633308,6,4,4.0,10,0.4
210635424,5,5,5.0,10,0.5
210636060,7,3,3.0,10,0.3
210639308,9,1,1.0,10,0.1
210641806,3,7,3.0,10,0.3
210643798,8,2,2.0,10,0.2
210646112,3,7,3.0,10,0.3
210655453,1,19,1.0,20,0.05
210672188,1,9,1.0,10,0.1
210673289,5,5,5.0,10,0.5
210677081,4,5,4.0,9,0.4444444444444444
210678522,2,6,2.0,8,0.25
210680595,2,18,2.0,20,0.1
210687097,4,6,4.0,10,0.4
210734472,1,9,1.0,10,0.1
210753305,9,1,1.0,10,0.1
210753657,4,6,4.0,10,0.4
210780478,1,9,1.0,10,0.1
210802527,1,8,1.0,9,0.1111111111111111
210819064,1,8,1.0,9,0.1111111111111111
210823632,1,8,1.0,9,0.1111111111111111
210824867,2,8,2.0,10,0.2
210834295,3,7,3.0,10,0.3
210835573,1,9,1.0,10,0.1
210844843,1,8,1.0,9,0.1111111111111111
210850602,5,5,5.0,10,0.5
210856256,2,18,2.0,20,0.1
210859958,1,19,1.0,20,0.05
210861574,1,9,1.0,10,0.1
210861963,2,6,2.0,8,0.25
210865380,1,9,1.0,10,0.1
210866452,1,9,1.0,10,0.1
210879124,7,2,2.0,9,0.2222222222222222
210882580,1,9,1.0,10,0.1
210904358,10,19,10.0,29,0.3448275862068966
210914898,1,7,1.0,8,0.125
210925953,1,19,1.0,20,0.05
210951462,1,9,1.0,10,0.1
210956752,6,12,6.0,18,0.3333333333333333
210957191,1,9,1.0,10,0.1
210960173,6,2,2.0,8,0.25
210961489,2,7,2.0,9,0.2222222222222222
210962324,2,8,2.0,10,0.2
210964774,1,9,1.0,10,0.1
210967488,17,12,12.0,29,0.41379310344827586
210969452,2,8,2.0,10,0.2
210969657,1,7,1.0,8,0.125
210969679,5,4,4.0,9,0.4444444444444444
210972014,1,8,1.0,9,0.1111111111111111
210984772,1,19,1.0,20,0.05
210992058,1,19,1.0,20,0.05
211024214,3,17,3.0,20,0.15
211047653,7,2,2.0,9,0.2222222222222222
211048713,26,3,3.0,29,0.10344827586206896
211054208,2,8,2.0,10,0.2
211064549,8,1,1.0,9,0.1111111111111111
211065262,14,14,14.0,28,0.5
211065602,1,9,1.0,10,0.1
211068607,2,16,2.0,18,0.1111111111111111
211089570,2,7,2.0,9,0.2222222222222222
211108585,2,8,2.0,10,0.2
211132009,8,1,1.0,9,0.1111111111111111
211135615,1,9,1.0,10,0.1
211158640,2,6,2.0,8,0.25
211195296,7,22,7.0,29,0.2413793103448276
211232582,1,9,1.0,10,0.1
211236127,2,8,2.0,10,0.2
211238446,1,9,1.0,10,0.1
211238573,1,8,1.0,9,0.1111111111111111
211242439,4,6,4.0,10,0.4
211245361,7,2,2.0,9,0.2222222222222222
211273416,3,16,3.0,19,0.15789473684210525
211277135,1,9,1.0,10,0.1
211287349,1,19,1.0,20,0.05
211312498,20,9,9.0,29,0.3103448275862069
211351084,4,6,4.0,10,0.4
211354332,1,8,1.0,9,0.1111111111111111
211367111,1,19,1.0,20,0.05
211367491,2,8,2.0,10,0.2
211386328,7,3,3.0,10,0.3
211390845,1,9,1.0,10,0.1
211393405,1,8,1.0,9,0.1111111111111111
211398358,7,2,2.0,9,0.2222222222222222
211402105,7,2,2.0,9,0.2222222222222222
211403606,2,8,2.0,10,0.2
211404739,17,12,12.0,29,0.41379310344827586
211405022,1,9,1.0,10,0.1
211467932,1,9,1.0,10,0.1
211474221,22,7,7.0,29,0.2413793103448276
211489352,2,7,2.0,9,0.2222222222222222
211493209,3,7,3.0,10,0.3
211502737,8,2,2.0,10,0.2
211546533,1,9,1.0,10,0.1
211563068,1,19,1.0,20,0.05
211563858,1,9,1.0,10,0.1
211576076,1,9,1.0,10,0.1
211576524,1,8,1.0,9,0.1111111111111111
211580228,2,8,2.0,10,0.2
211590980,1,9,1.0,10,0.1
211632392,1,8,1.0,9,0.1111111111111111
211633344,1,8,1.0,9,0.1111111111111111
211638213,1,8,1.0,9,0.1111111111111111
211640702,2,17,2.0,19,0.10526315789473684
211670092,2,7,2.0,9,0.2222222222222222
211700694,2,7,2.0,9,0.2222222222222222
211706229,1,18,1.0,19,0.05263157894736842
211708913,1,9,1.0,10,0.1
211736290,1,9,1.0,10,0.1
211742400,3,7,3.0,10,0.3
211743118,17,3,3.0,20,0.15
211743905,1,8,1.0,9,0.1111111111111111
211744088,5,3,3.0,8,0.375
211744117,3,7,3.0,10,0.3
211744366,8,2,2.0,10,0.2
211745283,6,4,4.0,10,0.4
211746266,4,5,4.0,9,0.4444444444444444
211746683,3,6,3.0,9,0.3333333333333333
211765799,5,5,5.0,10,0.5
211772161,1,8,1.0,9,0.1111111111111111
211788248,1,9,1.0,10,0.1
211827541,1,9,1.0,10,0.1
211848880,1,9,1.0,10,0.1
211864247,1,9,1.0,10,0.1
211895857,1,17,1.0,18,0.05555555555555555
211905966,1,17,1.0,18,0.05555555555555555
211910945,5,5,5.0,10,0.5
211914166,1,19,1.0,20,0.05
211914182,1,8,1.0,9,0.1111111111111111
211914358,4,4,4.0,8,0.5
211917383,4,16,4.0,20,0.2
211924470,1,9,1.0,10,0.1
211928436,5,5,5.0,10,0.5
211929573,1,9,1.0,10,0.1
211929657,3,7,3.0,10,0.3
211930417,4,6,4.0,10,0.4
211930775,1,8,1.0,9,0.1111111111111111
211931213,2,18,2.0,20,0.1
211939248,2,8,2.0,10,0.2
211939352,4,4,4.0,8,0.5
211942418,1,7,1.0,8,0.125
211943839,4,6,4.0,10,0.4
211948858,1,9,1.0,10,0.1
211950464,2,7,2.0,9,0.2222222222222222
211952226,1,9,1.0,10,0.1
211973048,2,8,2.0,10,0.2
211983222,2,7,2.0,9,0.2222222222222222
211991485,7,3,3.0,10,0.3
212010052,2,8,2.0,10,0.2
212011107,1,8,1.0,9,0.1111111111111111
212017867,1,9,1.0,10,0.1
212033400,6,4,4.0,10,0.4
212045420,3,7,3.0,10,0.3
212069695,5,4,4.0,9,0.4444444444444444
212136411,3,25,3.0,28,0.10714285714285714
212137396,2,6,2.0,8,0.25
212137956,1,8,1.0,9,0.1111111111111111
212148335,6,4,4.0,10,0.4
212163798,2,6,2.0,8,0.25
212169454,2,7,2.0,9,0.2222222222222222
212193974,1,9,1.0,10,0.1
212199673,7,1,1.0,8,0.125
212233806,2,8,2.0,10,0.2
212290661,1,8,1.0,9,0.1111111111111111
212293733,4,5,4.0,9,0.4444444444444444
212294846,2,8,2.0,10,0.2
212296252,1,19,1.0,20,0.05
212305511,1,8,1.0,9,0.1111111111111111
212307220,1,19,1.0,20,0.05
212307943,6,3,3.0,9,0.3333333333333333
212316719,5,5,5.0,10,0.5
212324391,3,6,3.0,9,0.3333333333333333
212345801,1,9,1.0,10,0.1
212346281,4,16,4.0,20,0.2
212356004,2,8,2.0,10,0.2
212363535,1,8,1.0,9,0.1111111111111111
212382538,4,5,4.0,9,0.4444444444444444
212415993,2,7,2.0,9,0.2222222222222222
212432073,1,9,1.0,10,0.1
212437062,27,1,1.0,28,0.03571428571428571
212438915,6,2,2.0,8,0.25
212451597,1,8,1.0,9,0.1111111111111111
212457727,6,2,2.0,8,0.25
212459626,6,2,2.0,8,0.25
212474018,1,8,1.0,9,0.1111111111111111
212486900,1,16,1.0,17,0.058823529411764705
212503009,7,3,3.0,10,0.3
212521051,1,9,1.0,10,0.1
212527544,3,7,3.0,10,0.3
212535996,13,6,6.0,19,0.3157894736842105
212554715,3,6,3.0,9,0.3333333333333333
212555199,2,6,2.0,8,0.25
212559428,2,8,2.0,10,0.2
212573636,4,15,4.0,19,0.21052631578947367
212598038,6,3,3.0,9,0.3333333333333333
212599575,7,3,3.0,10,0.3
212672485,2,8,2.0,10,0.2
212680010,9,20,9.0,29,0.3103448275862069
212686424,6,2,2.0,8,0.25
212692885,2,8,2.0,10,0.2
212693067,1,9,1.0,10,0.1
212695394,2,8,2.0,10,0.2
212700735,2,7,2.0,9,0.2222222222222222
212712908,8,1,1.0,9,0.1111111111111111
212713640,8,2,2.0,10,0.2
212726968,1,8,1.0,9,0.1111111111111111
212729578,1,9,1.0,10,0.1
212735042,1,9,1.0,10,0.1
212765579,9,1,1.0,10,0.1
212768726,2,25,2.0,27,0.07407407407407407
212777808,2,8,2.0,10,0.2
212794467,2,14,2.0,16,0.125
212806378,8,1,1.0,9,0.1111111111111111
212829846,1,9,1.0,10,0.1
212844265,6,22,6.0,28,0.21428571428571427
212854735,1,18,1.0,19,0.05263157894736842
212860560,2,8,2.0,10,0.2
212867126,3,7,3.0,10,0.3
212870112,5,5,5.0,10,0.5
212873718,3,6,3.0,9,0.3333333333333333
212873724,1,9,1.0,10,0.1
212874550,4,6,4.0,10,0.4
212882621,1,8,1.0,9,0.1111111111111111
212885566,4,4,4.0,8,0.5
212886308,1,9,1.0,10,0.1
212886865,1,28,1.0,29,0.034482758620689655
212894793,3,17,3.0,20,0.15
212909824,1,9,1.0,10,0.1
212920167,3,6,3.0,9,0.3333333333333333
212926079,4,6,4.0,10,0.4
212941167,6,3,3.0,9,0.3333333333333333
212967454,1,8,1.0,9,0.1111111111111111
212984963,1,8,1.0,9,0.1111111111111111
212986457,9,20,9.0,29,0.3103448275862069
212990355,1,18,1.0,19,0.05263157894736842
212992872,2,28,2.0,30,0.06666666666666667
212996662,1,9,1.0,10,0.1
213010795,1,29,1.0,30,0.03333333333333333
213025332,2,7,2.0,9,0.2222222222222222
213041946,1,8,1.0,9,0.1111111111111111
213066504,2,8,2.0,10,0.2
213092551,2,8,2.0,10,0.2
213092795,2,6,2.0,8,0.25
213096539,24,4,4.0,28,0.14285714285714285
213123392,9,1,1.0,10,0.1
213123895,27,1,1.0,28,0.03571428571428571
213134396,2,8,2.0,10,0.2
213135479,1,9,1.0,10,0.1
213149387,7,22,7.0,29,0.2413793103448276
213154518,3,6,3.0,9,0.3333333333333333
213154696,1,9,1.0,10,0.1
213163903,1,16,1.0,17,0.058823529411764705
213203072,6,4,4.0,10,0.4
213212208,10,10,10.0,20,0.5
213224951,8,1,1.0,9,0.1111111111111111
213225653,5,5,5.0,10,0.5
213226377,5,4,4.0,9,0.4444444444444444
213228726,2,8,2.0,10,0.2
213228845,1,8,1.0,9,0.1111111111111111
213243866,2,8,2.0,10,0.2
213244241,6,4,4.0,10,0.4
213257464,7,12,7.0,19,0.3684210526315789
213265003,1,8,1.0,9,0.1111111111111111
213277580,2,7,2.0,9,0.2222222222222222
213279796,1,18,1.0,19,0.05263157894736842
213287834,9,1,1.0,10,0.1
213291434,4,14,4.0,18,0.2222222222222222
213291828,8,11,8.0,19,0.42105263157894735
213300697,3,7,3.0,10,0.3
213306180,3,7,3.0,10,0.3
213329877,2,7,2.0,9,0.2222222222222222
213339048,3,7,3.0,10,0.3
213345040,1,8,1.0,9,0.1111111111111111
213345910,3,6,3.0,9,0.3333333333333333
213348137,6,22,6.0,28,0.21428571428571427
213370828,2,7,2.0,9,0.2222222222222222
213372325,8,1,1.0,9,0.1111111111111111
213375859,8,1,1.0,9,0.1111111111111111
213376920,1,18,1.0,19,0.05263157894736842
213378234,5,5,5.0,10,0.5
213378613,3,5,3.0,8,0.375
213379738,5,4,4.0,9,0.4444444444444444
213382291,1,9,1.0,10,0.1
213383599,2,8,2.0,10,0.2
213384753,2,8,2.0,10,0.2
213385752,4,5,4.0,9,0.4444444444444444
213391058,6,3,3.0,9,0.3333333333333333
213396752,12,17,12.0,29,0.41379310344827586
213397124,3,6,3.0,9,0.3333333333333333
213419955,1,9,1.0,10,0.1
213436365,1,18,1.0,19,0.05263157894736842
213468958,4,6,4.0,10,0.4
213470773,7,1,1.0,8,0.125
213488269,1,9,1.0,10,0.1
213492033,9,1,1.0,10,0.1
213495197,2,8,2.0,10,0.2
213498086,9,1,1.0,10,0.1
213515391,1,9,1.0,10,0.1
213526796,2,7,2.0,9,0.2222222222222222
213531379,4,6,4.0,10,0.4
213532400,6,4,4.0,10,0.4
213534320,6,4,4.0,10,0.4
213552640,12,6,6.0,18,0.3333333333333333
213566362,2,25,2.0,27,0.07407407407407407
213567803,1,9,1.0,10,0.1
213568137,2,7,2.0,9,0.2222222222222222
213577027,3,7,3.0,10,0.3
213577991,5,5,5.0,10,0.5
213581162,5,4,4.0,9,0.4444444444444444
213594337,8,2,2.0,10,0.2
213600252,4,4,4.0,8,0.5
213609987,6,4,4.0,10,0.4
213614978,2,8,2.0,10,0.2
213615622,1,7,1.0,8,0.125
213617452,1,9,1.0,10,0.1
213625744,3,5,3.0,8,0.375
213632417,1,7,1.0,8,0.125
213641072,5,5,5.0,10,0.5
213642240,7,3,3.0,10,0.3
213643474,9,1,1.0,10,0.1
213643537,28,1,1.0,29,0.034482758620689655
213644413,3,7,3.0,10,0.3
213647115,8,2,2.0,10,0.2
213647446,2,7,2.0,9,0.2222222222222222
213647524,4,6,4.0,10,0.4
213647771,1,9,1.0,10,0.1
213648766,6,4,4.0,10,0.4
213700603,1,8,1.0,9,0.1111111111111111
213703071,1,9,1.0,10,0.1
213722738,1,19,1.0,20,0.05
213737014,8,1,1.0,9,0.1111111111111111
213739944,3,7,3.0,10,0.3
213744781,7,10,7.0,17,0.4117647058823529
213746883,7,2,2.0,9,0.2222222222222222
213747555,6,4,4.0,10,0.4
213765761,5,5,5.0,10,0.5
213767162,4,6,4.0,10,0.4
213770160,1,8,1.0,9,0.1111111111111111
213789966,5,5,5.0,10,0.5
213803028,1,9,1.0,10,0.1
213832344,1,19,1.0,20,0.05
213849285,4,5,4.0,9,0.4444444444444444
213849772,4,6,4.0,10,0.4
213863554,2,6,2.0,8,0.25
213886095,7,2,2.0,9,0.2222222222222222
213897891,3,7,3.0,10,0.3
213899964,8,1,1.0,9,0.1111111111111111
213914344,8,2,2.0,10,0.2
213950081,2,8,2.0,10,0.2
213952748,4,6,4.0,10,0.4
213978497,3,7,3.0,10,0.3
213979881,2,8,2.0,10,0.2
214008832,1,9,1.0,10,0.1
214012312,3,17,3.0,20,0.15
214015522,1,9,1.0,10,0.1
214019094,7,21,7.0,28,0.25
214035301,2,15,2.0,17,0.11764705882352941
214047652,2,26,2.0,28,0.07142857142857142
214078379,1,9,1.0,10,0.1
214080978,1,9,1.0,10,0.1
214088631,7,2,2.0,9,0.2222222222222222
214088937,8,2,2.0,10,0.2
214089125,5,3,3.0,8,0.375
214089957,1,9,1.0,10,0.1
214090283,5,4,4.0,9,0.4444444444444444
214105103,7,2,2.0,9,0.2222222222222222
214131936,1,8,1.0,9,0.1111111111111111
214151500,9,1,1.0,10,0.1
214159143,1,9,1.0,10,0.1
214161604,1,8,1.0,9,0.1111111111111111
214198394,1,9,1.0,10,0.1
214217340,4,5,4.0,9,0.4444444444444444
214217529,2,8,2.0,10,0.2
214220782,1,8,1.0,9,0.1111111111111111
214252575,1,7,1.0,8,0.125
214253845,2,7,2.0,9,0.2222222222222222
214254258,4,5,4.0,9,0.4444444444444444
214260116,7,2,2.0,9,0.2222222222222222
214263927,4,6,4.0,10,0.4
214264149,1,9,1.0,10,0.1
214281876,2,7,2.0,9,0.2222222222222222
214284342,1,8,1.0,9,0.1111111111111111
214291782,3,7,3.0,10,0.3
214303047,3,6,3.0,9,0.3333333333333333
214306628,2,17,2.0,19,0.10526315789473684
214308353,1,17,1.0,18,0.05555555555555555
214308490,1,7,1.0,8,0.125
214309231,1,7,1.0,8,0.125
214309404,2,8,2.0,10,0.2
214309437,1,18,1.0,19,0.05263157894736842
214313738,4,4,4.0,8,0.5
214316147,1,9,1.0,10,0.1
214319145,1,8,1.0,9,0.1111111111111111
214320083,1,7,1.0,8,0.125
214341909,2,8,2.0,10,0.2
214342759,8,2,2.0,10,0.2
214345446,2,18,2.0,20,0.1
214379362,22,6,6.0,28,0.21428571428571427
214386418,2,8,2.0,10,0.2
214407561,2,7,2.0,9,0.2222222222222222
214413294,3,25,3.0,28,0.10714285714285714
214413789,2,7,2.0,9,0.2222222222222222
214416218,4,5,4.0,9,0.4444444444444444
214416643,2,7,2.0,9,0.2222222222222222
214416938,4,5,4.0,9,0.4444444444444444
214417810,3,7,3.0,10,0.3
214421035,2,8,2.0,10,0.2
214421353,4,25,4.0,29,0.13793103448275862
214424952,1,9,1.0,10,0.1
214435809,1,9,1.0,10,0.1
214452614,2,8,2.0,10,0.2
214454538,1,8,1.0,9,0.1111111111111111
214455681,3,7,3.0,10,0.3
214455969,1,8,1.0,9,0.1111111111111111
214499754,2,7,2.0,9,0.2222222222222222
214510598,2,8,2.0,10,0.2
214525255,2,8,2.0,10,0.2
214525526,3,7,3.0,10,0.3
214548489,1,9,1.0,10,0.1
214563739,8,1,1.0,9,0.1111111111111111
214570147,7,2,2.0,9,0.2222222222222222
214597038,2,8,2.0,10,0.2
214608393,2,8,2.0,10,0.2
214621209,7,2,2.0,9,0.2222222222222222
214622227,9,1,1.0,10,0.1
214662549,1,9,1.0,10,0.1
214664806,2,7,2.0,9,0.2222222222222222
214670756,1,17,1.0,18,0.05555555555555555
214680180,8,2,2.0,10,0.2
214680379,8,1,1.0,9,0.1111111111111111
214699993,5,4,4.0,9,0.4444444444444444
214727753,4,5,4.0,9,0.4444444444444444
214734843,23,3,3.0,26,0.11538461538461539
214746725,4,5,4.0,9,0.4444444444444444
214819200,7,3,3.0,10,0.3
214821631,6,4,4.0,10,0.4
214844838,4,6,4.0,10,0.4
214856363,2,8,2.0,10,0.2
214889191,21,8,8.0,29,0.27586206896551724
214898802,1,7,1.0,8,0.125
214960408,9,1,1.0,10,0.1
214966385,1,8,1.0,9,0.1111111111111111
214973234,5,4,4.0,9,0.4444444444444444
214981861,2,8,2.0,10,0.2
214983616,1,19,1.0,20,0.05
214998909,1,8,1.0,9,0.1111111111111111
215027683,1,9,1.0,10,0.1
215028886,7,1,1.0,8,0.125
215030676,5,4,4.0,9,0.4444444444444444
215033264,8,2,2.0,10,0.2
215033631,4,5,4.0,9,0.4444444444444444
215034010,1,8,1.0,9,0.1111111111111111
215041082,3,16,3.0,19,0.15789473684210525
215072179,2,26,2.0,28,0.07142857142857142
215081166,1,7,1.0,8,0.125
215091817,5,4,4.0,9,0.4444444444444444
215121687,1,27,1.0,28,0.03571428571428571
215135115,1,9,1.0,10,0.1
215153153,2,18,2.0,20,0.1
215166316,1,9,1.0,10,0.1
215168234,4,5,4.0,9,0.4444444444444444
215174691,1,9,1.0,10,0.1
215203869,1,7,1.0,8,0.125
215231896,8,2,2.0,10,0.2
215273943,2,8,2.0,10,0.2
215281270,1,9,1.0,10,0.1
215286060,4,15,4.0,19,0.21052631578947367
215287774,2,7,2.0,9,0.2222222222222222
215288637,2,8,2.0,10,0.2
215292501,3,7,3.0,10,0.3
215293102,3,7,3.0,10,0.3
215313892,6,3,3.0,9,0.3333333333333333
215331608,1,18,1.0,19,0.05263157894736842
215359298,1,17,1.0,18,0.05555555555555555
215360559,3,6,3.0,9,0.3333333333333333
215363744,2,8,2.0,10,0.2
215364814,1,9,1.0,10,0.1
215366038,1,8,1.0,9,0.1111111111111111
215374877,1,8,1.0,9,0.1111111111111111
215375181,3,17,3.0,20,0.15
215379704,2,7,2.0,9,0.2222222222222222
215380609,5,5,5.0,10,0.5
215391128,1,7,1.0,8,0.125
215397783,2,8,2.0,10,0.2
215402093,1,16,1.0,17,0.058823529411764705
215422740,1,9,1.0,10,0.1
215428405,8,1,1.0,9,0.1111111111111111
215428925,9,1,1.0,10,0.1
215431194,1,9,1.0,10,0.1
215431997,1,18,1.0,19,0.05263157894736842
215473446,3,5,3.0,8,0.375
215478223,1,18,1.0,19,0.05263157894736842
215485549,1,9,1.0,10,0.1
215505379,1,9,1.0,10,0.1
215519288,17,12,12.0,29,0.41379310344827586
215524800,1,9,1.0,10,0.1
215534558,16,14,14.0,30,0.4666666666666667
215559526,9,1,1.0,10,0.1
215563994,1,17,1.0,18,0.05555555555555555
215578107,2,7,2.0,9,0.2222222222222222
215580553,2,16,2.0,18,0.1111111111111111
215598457,1,8,1.0,9,0.1111111111111111
215627808,5,4,4.0,9,0.4444444444444444
215631741,1,7,1.0,8,0.125
215666714,1,8,1.0,9,0.1111111111111111
215667675,2,8,2.0,10,0.2
215686843,1,9,1.0,10,0.1
215719273,1,19,1.0,20,0.05
215724131,1,18,1.0,19,0.05263157894736842
215732838,9,1,1.0,10,0.1
215750140,1,9,1.0,10,0.1
215755090,1,8,1.0,9,0.1111111111111111
215756678,3,7,3.0,10,0.3
215767187,8,2,2.0,10,0.2
215768750,2,8,2.0,10,0.2
215782043,3,5,3.0,8,0.375
215784360,8,2,2.0,10,0.2
215787476,7,3,3.0,10,0.3
215792675,1,9,1.0,10,0.1
215798067,1,17,1.0,18,0.05555555555555555
215812386,6,12,6.0,18,0.3333333333333333
215814214,6,14,6.0,20,0.3
215816079,6,4,4.0,10,0.4
215822230,4,5,4.0,9,0.4444444444444444
215825575,1,9,1.0,10,0.1
215827451,2,7,2.0,9,0.2222222222222222
215828726,4,5,4.0,9,0.4444444444444444
215831600,7,23,7.0,30,0.23333333333333334
215833334,1,9,1.0,10,0.1
215833557,8,2,2.0,10,0.2
215861657,8,2,2.0,10,0.2
215901754,1,8,1.0,9,0.1111111111111111
215904457,1,9,1.0,10,0.1
215908658,5,5,5.0,10,0.5
215924954,1,8,1.0,9,0.1111111111111111
215960592,1,27,1.0,28,0.03571428571428571
215961087,6,4,4.0,10,0.4
215984654,1,17,1.0,18,0.05555555555555555
215985400,19,9,9.0,28,0.32142857142857145
216001967,2,6,2.0,8,0.25
216004824,7,3,3.0,10,0.3
216017510,3,7,3.0,10,0.3
216019602,21,7,7.0,28,0.25
216027515,1,9,1.0,10,0.1
216029851,3,7,3.0,10,0.3
216041534,1,8,1.0,9,0.1111111111111111
216055805,3,6,3.0,9,0.3333333333333333
216056338,5,5,5.0,10,0.5
216056824,1,26,1.0,27,0.037037037037037035
216065167,1,9,1.0,10,0.1
216077435,2,16,2.0,18,0.1111111111111111
216099640,2,8,2.0,10,0.2
216113968,1,19,1.0,20,0.05
216119528,3,13,3.0,16,0.1875
216168063,1,8,1.0,9,0.1111111111111111
216206115,9,1,1.0,10,0.1
216208793,4,6,4.0,10,0.4
216209124,4,5,4.0,9,0.4444444444444444
216210162,9,1,1.0,10,0.1
216210282,7,3,3.0,10,0.3
216221086,4,26,4.0,30,0.13333333333333333
216266321,6,4,4.0,10,0.4
216269927,5,5,5.0,10,0.5
216281668,9,1,1.0,10,0.1
216292903,2,6,2.0,8,0.25
216311636,1,8,1.0,9,0.1111111111111111
216314474,3,7,3.0,10,0.3
216317165,8,2,2.0,10,0.2
216318946,3,7,3.0,10,0.3
216321393,1,9,1.0,10,0.1
216323517,10,19,10.0,29,0.3448275862068966
216334317,3,7,3.0,10,0.3
216341918,1,8,1.0,9,0.1111111111111111
216350209,3,7,3.0,10,0.3
216371281,1,19,1.0,20,0.05
216371702,1,19,1.0,20,0.05
216389960,1,17,1.0,18,0.05555555555555555
216432116,9,1,1.0,10,0.1
216433011,8,2,2.0,10,0.2
216434940,4,6,4.0,10,0.4
216436116,9,1,1.0,10,0.1
216445146,2,18,2.0,20,0.1
216459892,2,8,2.0,10,0.2
216484832,4,6,4.0,10,0.4
216494612,1,8,1.0,9,0.1111111111111111
216504331,1,17,1.0,18,0.05555555555555555
216510992,6,4,4.0,10,0.4
216518051,1,9,1.0,10,0.1
216524341,1,9,1.0,10,0.1
216526999,1,9,1.0,10,0.1
216534339,1,8,1.0,9,0.1111111111111111
216535012,13,5,5.0,18,0.2777777777777778
216554068,8,1,1.0,9,0.1111111111111111
216554690,2,8,2.0,10,0.2
216560092,1,7,1.0,8,0.125
216567483,1,18,1.0,19,0.05263157894736842
216591219,4,6,4.0,10,0.4
216595769,1,17,1.0,18,0.05555555555555555
216641637,1,9,1.0,10,0.1
216681403,3,6,3.0,9,0.3333333333333333
216718064,2,18,2.0,20,0.1
216732854,8,2,2.0,10,0.2
216780412,5,4,4.0,9,0.4444444444444444
216805621,4,15,4.0,19,0.21052631578947367
216823574,18,1,1.0,19,0.05263157894736842
216831519,1,9,1.0,10,0.1
216877055,2,7,2.0,9,0.2222222222222222
216904370,2,18,2.0,20,0.1
216910614,1,9,1.0,10,0.1
216921939,1,8,1.0,9,0.1111111111111111
216922655,1,9,1.0,10,0.1
216924038,5,5,5.0,10,0.5
216924227,1,19,1.0,20,0.05
216926412,3,26,3.0,29,0.10344827586206896
216930839,1,9,1.0,10,0.1
216937082,3,6,3.0,9,0.3333333333333333
216948146,5,22,5.0,27,0.18518518518518517
216973967,9,1,1.0,10,0.1
216991452,8,1,1.0,9,0.1111111111111111
216991939,4,5,4.0,9,0.4444444444444444
216995365,4,4,4.0,8,0.5
217002941,1,8,1.0,9,0.1111111111111111
217031736,1,9,1.0,10,0.1
217060546,2,8,2.0,10,0.2
217069832,3,7,3.0,10,0.3
217081513,3,7,3.0,10,0.3
217084151,9,1,1.0,10,0.1
217084780,1,9,1.0,10,0.1
217110270,2,18,2.0,20,0.1
217121595,7,3,3.0,10,0.3
217132669,3,15,3.0,18,0.16666666666666666
217157747,2,8,2.0,10,0.2
217159792,1,9,1.0,10,0.1
217164129,2,8,2.0,10,0.2
217165778,3,7,3.0,10,0.3
217172116,5,5,5.0,10,0.5
217184969,2,18,2.0,20,0.1
217196817,2,7,2.0,9,0.2222222222222222
217201149,1,8,1.0,9,0.1111111111111111
217202684,7,3,3.0,10,0.3
217204662,4,4,4.0,8,0.5
217206338,8,2,2.0,10,0.2
217206984,20,8,8.0,28,0.2857142857142857
217209971,3,6,3.0,9,0.3333333333333333
217224251,25,3,3.0,28,0.10714285714285714
217228718,1,9,1.0,10,0.1
217232095,5,5,5.0,10,0.5
217235675,1,9,1.0,10,0.1
217252609,3,23,3.0,26,0.11538461538461539
217259718,7,3,3.0,10,0.3
217260615,27,3,3.0,30,0.1
217261731,8,2,2.0,10,0.2
217262178,1,7,1.0,8,0.125
217263497,2,7,2.0,9,0.2222222222222222
217263853,4,6,4.0,10,0.4
217285539,9,20,9.0,29,0.3103448275862069
217285945,1,9,1.0,10,0.1
217287358,1,7,1.0,8,0.125
217292252,3,6,3.0,9,0.3333333333333333
217293607,11,18,11.0,29,0.3793103448275862
217294185,5,5,5.0,10,0.5
217296836,7,3,3.0,10,0.3
217306299,7,2,2.0,9,0.2222222222222222
217323287,2,17,2.0,19,0.10526315789473684
217351012,2,17,2.0,19,0.10526315789473684
217354790,3,7,3.0,10,0.3
217359361,1,8,1.0,9,0.1111111111111111
217386051,2,14,2.0,16,0.125
217388498,6,4,4.0,10,0.4
217389497,7,3,3.0,10,0.3
217409298,1,9,1.0,10,0.1
217417751,28,1,1.0,29,0.034482758620689655
217418305,9,1,1.0,10,0.1
217418781,9,1,1.0,10,0.1
217419213,23,5,5.0,28,0.17857142857142858
217431715,2,7,2.0,9,0.2222222222222222
217433756,5,5,5.0,10,0.5
217439772,4,5,4.0,9,0.4444444444444444
217448768,1,9,1.0,10,0.1
217455401,3,27,3.0,30,0.1
217458850,4,5,4.0,9,0.4444444444444444
217461658,2,7,2.0,9,0.2222222222222222
217475371,3,6,3.0,9,0.3333333333333333
217476346,6,4,4.0,10,0.4
217476394,1,9,1.0,10,0.1
217476847,1,19,1.0,20,0.05
217492899,1,9,1.0,10,0.1
217495825,1,9,1.0,10,0.1
217496533,1,9,1.0,10,0.1
217497779,1,8,1.0,9,0.1111111111111111
217503448,3,22,3.0,25,0.12
217513831,2,7,2.0,9,0.2222222222222222
217529467,8,2,2.0,10,0.2
217537945,3,7,3.0,10,0.3
217544681,1,7,1.0,8,0.125
217545347,8,2,2.0,10,0.2
217550829,1,9,1.0,10,0.1
217577136,6,14,6.0,20,0.3
217579153,5,5,5.0,10,0.5
217589063,6,2,2.0,8,0.25
217591676,1,7,1.0,8,0.125
217596985,2,7,2.0,9,0.2222222222222222
217597641,1,8,1.0,9,0.1111111111111111
217605799,2,7,2.0,9,0.2222222222222222
217612185,1,18,1.0,19,0.05263157894736842
217621216,1,9,1.0,10,0.1
217629004,1,9,1.0,10,0.1
217643285,8,2,2.0,10,0.2
217645791,5,3,3.0,8,0.375
217662728,3,7,3.0,10,0.3
217669689,2,8,2.0,10,0.2
217675734,1,9,1.0,10,0.1
217680428,2,8,2.0,10,0.2
217687743,7,2,2.0,9,0.2222222222222222
217700824,2,7,2.0,9,0.2222222222222222
217714152,2,8,2.0,10,0.2
217717164,5,5,5.0,10,0.5
217717323,4,6,4.0,10,0.4
217742910,1,14,1.0,15,0.06666666666666667
217746359,4,5,4.0,9,0.4444444444444444
217751642,5,13,5.0,18,0.2777777777777778
217765372,1,9,1.0,10,0.1
217766646,1,8,1.0,9,0.1111111111111111
217768296,1,9,1.0,10,0.1
217775820,4,23,4.0,27,0.14814814814814814
217801378,7,3,3.0,10,0.3
217808451,1,8,1.0,9,0.1111111111111111
217812638,3,7,3.0,10,0.3
217813432,5,5,5.0,10,0.5
217819024,5,5,5.0,10,0.5
217822344,26,2,2.0,28,0.07142857142857142
217833104,1,18,1.0,19,0.05263157894736842
217836273,3,7,3.0,10,0.3
217838467,4,5,4.0,9,0.4444444444444444
217840921,1,7,1.0,8,0.125
217856499,4,14,4.0,18,0.2222222222222222
217860779,1,9,1.0,10,0.1
217875687,8,2,2.0,10,0.2
217883811,4,5,4.0,9,0.4444444444444444
217898918,4,6,4.0,10,0.4
217935089,1,28,1.0,29,0.034482758620689655
217971313,5,5,5.0,10,0.5
217974626,1,9,1.0,10,0.1
217974782,1,8,1.0,9,0.1111111111111111
218003090,4,5,4.0,9,0.4444444444444444
218037439,6,4,4.0,10,0.4
218037616,6,3,3.0,9,0.3333333333333333
218038632,3,6,3.0,9,0.3333333333333333
218040259,6,3,3.0,9,0.3333333333333333
218040872,9,1,1.0,10,0.1
218054476,5,4,4.0,9,0.4444444444444444
218063567,1,9,1.0,10,0.1
218087292,1,8,1.0,9,0.1111111111111111
218095141,3,15,3.0,18,0.16666666666666666
218098062,6,4,4.0,10,0.4
218099286,1,8,1.0,9,0.1111111111111111
218099714,1,8,1.0,9,0.1111111111111111
218100357,4,6,4.0,10,0.4
218100638,2,8,2.0,10,0.2
218103313,17,2,2.0,19,0.10526315789473684
218107896,3,5,3.0,8,0.375
218110757,1,9,1.0,10,0.1
218117783,3,7,3.0,10,0.3
218123176,2,8,2.0,10,0.2
218136373,1,9,1.0,10,0.1
218146103,26,3,3.0,29,0.10344827586206896
218168509,6,3,3.0,9,0.3333333333333333
218172446,8,2,2.0,10,0.2
218189036,1,19,1.0,20,0.05
218189455,1,8,1.0,9,0.1111111111111111
218190244,4,6,4.0,10,0.4
218197462,2,7,2.0,9,0.2222222222222222
218200291,3,7,3.0,10,0.3
218260681,5,4,4.0,9,0.4444444444444444
218266018,2,6,2.0,8,0.25
218267623,3,6,3.0,9,0.3333333333333333
218268106,7,3,3.0,10,0.3
218268216,5,4,4.0,9,0.4444444444444444
218268334,1,7,1.0,8,0.125
218269729,1,9,1.0,10,0.1
218270524,1,9,1.0,10,0.1
218298794,4,6,4.0,10,0.4
218330585,6,4,4.0,10,0.4
218339803,1,9,1.0,10,0.1
218348254,6,4,4.0,10,0.4
218349133,6,3,3.0,9,0.3333333333333333
218353384,3,6,3.0,9,0.3333333333333333
218354717,9,1,1.0,10,0.1
218356977,2,8,2.0,10,0.2
218357987,8,1,1.0,9,0.1111111111111111
218358395,1,9,1.0,10,0.1
218358558,9,1,1.0,10,0.1
218361618,4,6,4.0,10,0.4
218362044,9,1,1.0,10,0.1
218362176,8,2,2.0,10,0.2
218362972,2,7,2.0,9,0.2222222222222222
218363956,5,5,5.0,10,0.5
218401411,9,1,1.0,10,0.1
218419831,1,9,1.0,10,0.1
218420176,2,8,2.0,10,0.2
218421785,2,8,2.0,10,0.2
218432807,1,9,1.0,10,0.1
218458194,1,9,1.0,10,0.1
218460051,4,15,4.0,19,0.21052631578947367
218470434,3,6,3.0,9,0.3333333333333333
218471314,5,4,4.0,9,0.4444444444444444
218473391,2,7,2.0,9,0.2222222222222222
218475848,8,1,1.0,9,0.1111111111111111
218477259,2,7,2.0,9,0.2222222222222222
218490373,1,8,1.0,9,0.1111111111111111
218491518,3,16,3.0,19,0.15789473684210525
218506251,1,9,1.0,10,0.1
218539231,6,13,6.0,19,0.3157894736842105
218542959,1,19,1.0,20,0.05
218545903,1,7,1.0,8,0.125
218564291,3,7,3.0,10,0.3
218568635,1,9,1.0,10,0.1
218570852,1,9,1.0,10,0.1
218571829,1,8,1.0,9,0.1111111111111111
218577654,4,4,4.0,8,0.5
218578996,1,9,1.0,10,0.1
218587728,1,26,1.0,27,0.037037037037037035
218611654,7,2,2.0,9,0.2222222222222222
218611921,2,8,2.0,10,0.2
218620647,2,27,2.0,29,0.06896551724137931
218621930,2,8,2.0,10,0.2
218622055,4,6,4.0,10,0.4
218622760,7,3,3.0,10,0.3
218623579,1,8,1.0,9,0.1111111111111111
218626664,1,17,1.0,18,0.05555555555555555
218626733,4,18,4.0,22,0.18181818181818182
218627107,4,5,4.0,9,0.4444444444444444
218631001,28,2,2.0,30,0.06666666666666667
218666224,7,11,7.0,18,0.3888888888888889
218685778,4,4,4.0,8,0.5
218687275,1,8,1.0,9,0.1111111111111111
218706520,1,9,1.0,10,0.1
218707403,5,5,5.0,10,0.5
218708060,9,1,1.0,10,0.1
218708930,6,4,4.0,10,0.4
218710509,1,8,1.0,9,0.1111111111111111
218711643,1,9,1.0,10,0.1
218712513,9,1,1.0,10,0.1
218713073,4,6,4.0,10,0.4
218713823,3,7,3.0,10,0.3
218717545,8,2,2.0,10,0.2
218720206,1,9,1.0,10,0.1
218724492,1,9,1.0,10,0.1
218726632,1,8,1.0,9,0.1111111111111111
218731862,1,9,1.0,10,0.1
218748278,1,8,1.0,9,0.1111111111111111
218749760,1,8,1.0,9,0.1111111111111111
218761809,4,6,4.0,10,0.4
218764212,2,6,2.0,8,0.25
218765937,3,5,3.0,8,0.375
218771918,3,7,3.0,10,0.3
218812828,7,23,7.0,30,0.23333333333333334
218820289,1,7,1.0,8,0.125
218861414,4,5,4.0,9,0.4444444444444444
218861777,5,4,4.0,9,0.4444444444444444
218867496,8,2,2.0,10,0.2
218871448,1,19,1.0,20,0.05
218872107,1,9,1.0,10,0.1
218872946,3,6,3.0,9,0.3333333333333333
218878235,6,4,4.0,10,0.4
218883442,2,8,2.0,10,0.2
218887624,1,9,1.0,10,0.1
218901220,1,9,1.0,10,0.1
218910693,1,25,1.0,26,0.038461538461538464
218913768,3,6,3.0,9,0.3333333333333333
218921095,1,9,1.0,10,0.1
218927433,1,8,1.0,9,0.1111111111111111
218929332,1,9,1.0,10,0.1
218964484,12,8,8.0,20,0.4
218988284,3,6,3.0,9,0.3333333333333333
218989057,1,8,1.0,9,0.1111111111111111
218990037,8,1,1.0,9,0.1111111111111111
218991929,5,4,4.0,9,0.4444444444444444
218992722,9,1,1.0,10,0.1
219008668,6,4,4.0,10,0.4
219011533,6,2,2.0,8,0.25
219012519,2,8,2.0,10,0.2
219014168,2,8,2.0,10,0.2
219015813,3,7,3.0,10,0.3
219016094,6,13,6.0,19,0.3157894736842105
219016816,1,9,1.0,10,0.1
219017364,6,4,4.0,10,0.4
219017671,9,1,1.0,10,0.1
219018566,9,1,1.0,10,0.1
219028552,3,17,3.0,20,0.15
219029261,1,28,1.0,29,0.034482758620689655
219057951,7,2,2.0,9,0.2222222222222222
219060833,8,1,1.0,9,0.1111111111111111
219061051,9,1,1.0,10,0.1
219066892,3,7,3.0,10,0.3
219067374,2,8,2.0,10,0.2
219068766,2,8,2.0,10,0.2
219077243,1,9,1.0,10,0.1
219083068,6,2,2.0,8,0.25
219083358,8,2,2.0,10,0.2
219083610,4,6,4.0,10,0.4
219083727,9,1,1.0,10,0.1
219095573,1,9,1.0,10,0.1
219097830,13,16,13.0,29,0.4482758620689655
219105062,5,5,5.0,10,0.5
219130218,1,8,1.0,9,0.1111111111111111
219134914,1,9,1.0,10,0.1
219148291,16,12,12.0,28,0.42857142857142855
219156533,6,4,4.0,10,0.4
219170120,12,18,12.0,30,0.4
219170716,1,7,1.0,8,0.125
219172114,3,5,3.0,8,0.375
219186491,1,19,1.0,20,0.05
219213548,1,9,1.0,10,0.1
219214141,16,2,2.0,18,0.1111111111111111
219214614,8,1,1.0,9,0.1111111111111111
219217160,2,8,2.0,10,0.2
219221384,6,4,4.0,10,0.4
219242170,2,7,2.0,9,0.2222222222222222
219242841,3,7,3.0,10,0.3
219244020,4,5,4.0,9,0.4444444444444444
219244565,3,7,3.0,10,0.3
219248332,1,9,1.0,10,0.1
219249174,1,8,1.0,9,0.1111111111111111
219284214,4,6,4.0,10,0.4
219295720,3,17,3.0,20,0.15
219355492,1,8,1.0,9,0.1111111111111111
219356493,2,8,2.0,10,0.2
219365065,2,8,2.0,10,0.2
219375057,5,5,5.0,10,0.5
219385040,1,9,1.0,10,0.1
219396094,3,6,3.0,9,0.3333333333333333
219396187,4,6,4.0,10,0.4
219401164,8,2,2.0,10,0.2
219408604,1,9,1.0,10,0.1
219408934,9,1,1.0,10,0.1
219416355,6,4,4.0,10,0.4
219417753,5,4,4.0,9,0.4444444444444444
219419356,8,2,2.0,10,0.2
219422143,9,1,1.0,10,0.1
219422254,1,8,1.0,9,0.1111111111111111
219508220,1,9,1.0,10,0.1
219508935,2,7,2.0,9,0.2222222222222222
219528302,1,9,1.0,10,0.1
219551879,2,8,2.0,10,0.2
219563454,1,9,1.0,10,0.1
219563749,1,9,1.0,10,0.1
219585836,1,9,1.0,10,0.1
219589588,1,9,1.0,10,0.1
219615252,1,8,1.0,9,0.1111111111111111
219619400,1,9,1.0,10,0.1
219620231,9,1,1.0,10,0.1
219620979,3,6,3.0,9,0.3333333333333333
219621479,6,4,4.0,10,0.4
219629682,4,6,4.0,10,0.4
219666139,6,14,6.0,20,0.3
219668914,1,8,1.0,9,0.1111111111111111
219671936,6,4,4.0,10,0.4
219673221,3,5,3.0,8,0.375
219676277,4,6,4.0,10,0.4
219677665,1,9,1.0,10,0.1
219682709,8,2,2.0,10,0.2
219685679,17,2,2.0,19,0.10526315789473684
219700984,1,9,1.0,10,0.1
219706862,1,9,1.0,10,0.1
219707464,1,9,1.0,10,0.1
219712985,6,4,4.0,10,0.4
219714935,2,8,2.0,10,0.2
219717785,9,1,1.0,10,0.1
219723243,1,17,1.0,18,0.05555555555555555
219746663,1,9,1.0,10,0.1
219749780,1,7,1.0,8,0.125
219756449,1,9,1.0,10,0.1
219758957,8,2,2.0,10,0.2
219759379,19,9,9.0,28,0.32142857142857145
219769267,1,8,1.0,9,0.1111111111111111
219773528,1,9,1.0,10,0.1
219791279,1,18,1.0,19,0.05263157894736842
219823628,25,2,2.0,27,0.07407407407407407
219824500,2,6,2.0,8,0.25
219844387,1,9,1.0,10,0.1
219849222,1,9,1.0,10,0.1
219851831,1,9,1.0,10,0.1
219853246,4,6,4.0,10,0.4
219894154,2,7,2.0,9,0.2222222222222222
219927351,1,8,1.0,9,0.1111111111111111
219932931,1,7,1.0,8,0.125
219988888,5,5,5.0,10,0.5
219989806,2,8,2.0,10,0.2
219989902,5,4,4.0,9,0.4444444444444444
219994026,1,8,1.0,9,0.1111111111111111
220015381,2,8,2.0,10,0.2
220015734,9,1,1.0,10,0.1
220015835,6,4,4.0,10,0.4
220016142,8,2,2.0,10,0.2
220022479,6,2,2.0,8,0.25
220023443,9,1,1.0,10,0.1
220023969,9,1,1.0,10,0.1
220041949,14,12,12.0,26,0.46153846153846156
220048754,8,2,2.0,10,0.2
220055959,2,8,2.0,10,0.2
220056153,3,5,3.0,8,0.375
220065672,2,8,2.0,10,0.2
220068332,6,4,4.0,10,0.4
220068985,4,5,4.0,9,0.4444444444444444
220093955,1,8,1.0,9,0.1111111111111111
220099872,1,9,1.0,10,0.1
220120749,6,14,6.0,20,0.3
220147008,9,1,1.0,10,0.1
220147218,5,5,5.0,10,0.5
220164000,1,9,1.0,10,0.1
220164013,6,3,3.0,9,0.3333333333333333
220182137,2,8,2.0,10,0.2
220185441,1,9,1.0,10,0.1
220193551,3,7,3.0,10,0.3
220197480,4,5,4.0,9,0.4444444444444444
220198313,8,1,1.0,9,0.1111111111111111
220199436,17,1,1.0,18,0.05555555555555555
220199520,6,14,6.0,20,0.3
220200759,8,2,2.0,10,0.2
220201198,1,9,1.0,10,0.1
220202640,2,8,2.0,10,0.2
220208790,1,9,1.0,10,0.1
220215517,8,2,2.0,10,0.2
220240310,1,7,1.0,8,0.125
220258171,8,2,2.0,10,0.2
220258908,1,9,1.0,10,0.1
220258934,5,5,5.0,10,0.5
220261181,1,9,1.0,10,0.1
220269978,6,4,4.0,10,0.4
220270085,3,7,3.0,10,0.3
220271009,4,6,4.0,10,0.4
220273848,2,8,2.0,10,0.2
220274852,4,4,4.0,8,0.5
220275361,5,4,4.0,9,0.4444444444444444
220275888,3,6,3.0,9,0.3333333333333333
220315247,6,4,4.0,10,0.4
220332429,1,19,1.0,20,0.05
220352051,5,3,3.0,8,0.375
220356350,2,7,2.0,9,0.2222222222222222
220359276,9,1,1.0,10,0.1
220359653,6,4,4.0,10,0.4
220359888,2,8,2.0,10,0.2
220372985,1,27,1.0,28,0.03571428571428571
220374297,6,3,3.0,9,0.3333333333333333
220374863,4,5,4.0,9,0.4444444444444444
220375046,8,1,1.0,9,0.1111111111111111
220380252,6,4,4.0,10,0.4
220395006,1,18,1.0,19,0.05263157894736842
220395794,1,9,1.0,10,0.1
220413212,9,1,1.0,10,0.1
220413951,1,7,1.0,8,0.125
220441194,3,6,3.0,9,0.3333333333333333
220441348,3,7,3.0,10,0.3
220441693,1,9,1.0,10,0.1
220460430,1,8,1.0,9,0.1111111111111111
220469534,2,7,2.0,9,0.2222222222222222
220478450,1,9,1.0,10,0.1
220498233,3,7,3.0,10,0.3
220504053,1,9,1.0,10,0.1
220507537,2,7,2.0,9,0.2222222222222222
220517119,3,6,3.0,9,0.3333333333333333
220519226,1,8,1.0,9,0.1111111111111111
220525933,1,18,1.0,19,0.05263157894736842
220548216,7,2,2.0,9,0.2222222222222222
220580286,1,9,1.0,10,0.1
220605304,1,8,1.0,9,0.1111111111111111
220613560,1,8,1.0,9,0.1111111111111111
220617741,1,8,1.0,9,0.1111111111111111
220636489,4,6,4.0,10,0.4
220637327,5,5,5.0,10,0.5
220644017,8,1,1.0,9,0.1111111111111111
220647737,5,5,5.0,10,0.5
220649316,5,5,5.0,10,0.5
220653532,2,8,2.0,10,0.2
220690441,1,9,1.0,10,0.1
220692540,3,7,3.0,10,0.3
220692960,1,8,1.0,9,0.1111111111111111
220696273,2,16,2.0,18,0.1111111111111111
220699978,6,3,3.0,9,0.3333333333333333
220704682,1,9,1.0,10,0.1
220707537,1,8,1.0,9,0.1111111111111111
220717436,8,1,1.0,9,0.1111111111111111
220719737,3,16,3.0,19,0.15789473684210525
220742258,1,17,1.0,18,0.05555555555555555
220752559,25,4,4.0,29,0.13793103448275862
220755552,1,19,1.0,20,0.05
220756094,1,9,1.0,10,0.1
220766133,2,15,2.0,17,0.11764705882352941
220796294,2,7,2.0,9,0.2222222222222222
220797624,4,5,4.0,9,0.4444444444444444
220819130,26,2,2.0,28,0.07142857142857142
220828380,2,6,2.0,8,0.25
220831364,1,7,1.0,8,0.125
220858360,8,1,1.0,9,0.1111111111111111
220858829,4,6,4.0,10,0.4
220859293,1,8,1.0,9,0.1111111111111111
220864462,1,27,1.0,28,0.03571428571428571
220867709,1,8,1.0,9,0.1111111111111111
220872268,6,4,4.0,10,0.4
220876066,7,3,3.0,10,0.3
220878259,23,1,1.0,24,0.041666666666666664
220893756,1,7,1.0,8,0.125
220895082,1,7,1.0,8,0.125
220914520,1,8,1.0,9,0.1111111111111111
220914593,3,7,3.0,10,0.3
220917124,2,8,2.0,10,0.2
220918023,1,9,1.0,10,0.1
220920575,1,7,1.0,8,0.125
220921375,5,5,5.0,10,0.5
220931451,25,2,2.0,27,0.07407407407407407
220931850,5,4,4.0,9,0.4444444444444444
220932079,1,8,1.0,9,0.1111111111111111
220953323,3,16,3.0,19,0.15789473684210525
220984426,2,8,2.0,10,0.2
220985944,4,4,4.0,8,0.5
220993222,11,19,11.0,30,0.36666666666666664
220995414,3,6,3.0,9,0.3333333333333333
220997503,5,5,5.0,10,0.5
220999040,1,9,1.0,10,0.1
221002603,1,18,1.0,19,0.05263157894736842
221018064,1,19,1.0,20,0.05
221021990,2,8,2.0,10,0.2
221022661,2,8,2.0,10,0.2
221023057,4,6,4.0,10,0.4
221034663,1,9,1.0,10,0.1
221073246,5,4,4.0,9,0.4444444444444444
221073767,2,8,2.0,10,0.2
221074866,4,5,4.0,9,0.4444444444444444
221103883,2,8,2.0,10,0.2
221106321,4,6,4.0,10,0.4
221134103,1,19,1.0,20,0.05
221156152,1,19,1.0,20,0.05
221184191,1,8,1.0,9,0.1111111111111111
221201668,7,3,3.0,10,0.3
221226502,1,9,1.0,10,0.1
221239963,1,9,1.0,10,0.1
221265899,7,2,2.0,9,0.2222222222222222
221266435,4,6,4.0,10,0.4
221267552,3,7,3.0,10,0.3
221277392,5,5,5.0,10,0.5
221277998,9,1,1.0,10,0.1
221283436,4,5,4.0,9,0.4444444444444444
221286185,1,9,1.0,10,0.1
221286976,3,5,3.0,8,0.375
221289858,4,6,4.0,10,0.4
221296283,7,3,3.0,10,0.3
221318129,3,17,3.0,20,0.15
221343453,1,9,1.0,10,0.1
221361674,5,14,5.0,19,0.2631578947368421
221368339,1,9,1.0,10,0.1
221380365,1,19,1.0,20,0.05
221389504,7,3,3.0,10,0.3
221431264,1,9,1.0,10,0.1
221442872,1,8,1.0,9,0.1111111111111111
221488309,7,3,3.0,10,0.3
221490313,4,5,4.0,9,0.4444444444444444
221505406,1,9,1.0,10,0.1
221518394,1,9,1.0,10,0.1
221525508,4,6,4.0,10,0.4
221556234,4,6,4.0,10,0.4
221583297,7,3,3.0,10,0.3
221583669,6,2,2.0,8,0.25
221587013,2,7,2.0,9,0.2222222222222222
221587193,2,8,2.0,10,0.2
221587575,3,7,3.0,10,0.3
221597405,4,6,4.0,10,0.4
221663226,5,5,5.0,10,0.5
221674087,7,3,3.0,10,0.3
221677754,1,9,1.0,10,0.1
221686575,6,4,4.0,10,0.4
221686793,2,7,2.0,9,0.2222222222222222
221690090,2,7,2.0,9,0.2222222222222222
221725993,2,7,2.0,9,0.2222222222222222
221727752,6,4,4.0,10,0.4
221731545,3,6,3.0,9,0.3333333333333333
221733781,1,9,1.0,10,0.1
221734986,3,6,3.0,9,0.3333333333333333
221739027,1,28,1.0,29,0.034482758620689655
221741949,1,7,1.0,8,0.125
221742165,13,14,13.0,27,0.48148148148148145
221745055,4,6,4.0,10,0.4
221750295,1,9,1.0,10,0.1
221751937,3,23,3.0,26,0.11538461538461539
221789043,1,7,1.0,8,0.125
221805670,2,17,2.0,19,0.10526315789473684
221836723,1,19,1.0,20,0.05
221880251,1,8,1.0,9,0.1111111111111111
221889048,3,7,3.0,10,0.3
221916907,1,27,1.0,28,0.03571428571428571
221919760,1,7,1.0,8,0.125
221923012,9,19,9.0,28,0.32142857142857145
221924967,2,8,2.0,10,0.2
221940165,7,12,7.0,19,0.3684210526315789
221948563,1,9,1.0,10,0.1
221962468,1,8,1.0,9,0.1111111111111111
221969038,1,18,1.0,19,0.05263157894736842
221976292,2,18,2.0,20,0.1
221991829,1,8,1.0,9,0.1111111111111111
222010585,1,9,1.0,10,0.1
222011015,1,9,1.0,10,0.1
222011165,1,8,1.0,9,0.1111111111111111
222021434,1,15,1.0,16,0.0625
222042698,7,21,7.0,28,0.25
222045712,8,2,2.0,10,0.2
222046298,3,23,3.0,26,0.11538461538461539
222056953,2,7,2.0,9,0.2222222222222222
222100736,1,17,1.0,18,0.05555555555555555
222122788,9,1,1.0,10,0.1
222128827,14,6,6.0,20,0.3
222131687,1,7,1.0,8,0.125
222131730,6,3,3.0,9,0.3333333333333333
222132941,2,8,2.0,10,0.2
222146296,2,8,2.0,10,0.2
222175267,1,9,1.0,10,0.1
222202070,2,7,2.0,9,0.2222222222222222
222225004,3,6,3.0,9,0.3333333333333333
222229241,1,8,1.0,9,0.1111111111111111
222235076,3,16,3.0,19,0.15789473684210525
222235904,1,9,1.0,10,0.1
222241319,2,8,2.0,10,0.2
222258587,1,8,1.0,9,0.1111111111111111
222261825,2,7,2.0,9,0.2222222222222222
222262078,2,8,2.0,10,0.2
222295096,1,26,1.0,27,0.037037037037037035
222303446,1,9,1.0,10,0.1
222303870,1,9,1.0,10,0.1
222317175,2,7,2.0,9,0.2222222222222222
222323280,1,9,1.0,10,0.1
222324343,3,6,3.0,9,0.3333333333333333
222326102,1,18,1.0,19,0.05263157894736842
222330814,3,6,3.0,9,0.3333333333333333
222331877,3,24,3.0,27,0.1111111111111111
222332052,1,9,1.0,10,0.1
222333933,4,5,4.0,9,0.4444444444444444
222339400,2,7,2.0,9,0.2222222222222222
222340305,1,8,1.0,9,0.1111111111111111
222340788,1,8,1.0,9,0.1111111111111111
222344006,4,4,4.0,8,0.5
222347770,1,8,1.0,9,0.1111111111111111
222350596,1,8,1.0,9,0.1111111111111111
222360732,1,9,1.0,10,0.1
222362567,5,4,4.0,9,0.4444444444444444
222401808,2,8,2.0,10,0.2
222410275,1,9,1.0,10,0.1
222432993,1,9,1.0,10,0.1
222433327,3,7,3.0,10,0.3
222433641,1,9,1.0,10,0.1
222435554,5,4,4.0,9,0.4444444444444444
222470113,2,17,2.0,19,0.10526315789473684
222471079,1,9,1.0,10,0.1
222478764,1,8,1.0,9,0.1111111111111111
222487926,3,6,3.0,9,0.3333333333333333
222490682,1,9,1.0,10,0.1
222490901,2,7,2.0,9,0.2222222222222222
222491362,1,9,1.0,10,0.1
222491928,1,9,1.0,10,0.1
222495934,3,26,3.0,29,0.10344827586206896
222500914,3,17,3.0,20,0.15
222501615,1,8,1.0,9,0.1111111111111111
222509082,3,6,3.0,9,0.3333333333333333
222511167,5,4,4.0,9,0.4444444444444444
222514151,6,3,3.0,9,0.3333333333333333
222519260,8,2,2.0,10,0.2
222519607,3,7,3.0,10,0.3
222525770,1,8,1.0,9,0.1111111111111111
222526222,1,9,1.0,10,0.1
222527427,2,8,2.0,10,0.2
222532226,2,7,2.0,9,0.2222222222222222
222532480,9,1,1.0,10,0.1
222532816,5,5,5.0,10,0.5
222534073,1,8,1.0,9,0.1111111111111111
222536023,1,9,1.0,10,0.1
222540066,1,9,1.0,10,0.1
222540837,1,8,1.0,9,0.1111111111111111
222541666,6,3,3.0,9,0.3333333333333333
222541903,1,27,1.0,28,0.03571428571428571
222542821,6,4,4.0,10,0.4
222544929,3,6,3.0,9,0.3333333333333333
222548651,3,7,3.0,10,0.3
222549099,3,25,3.0,28,0.10714285714285714
222630261,1,17,1.0,18,0.05555555555555555
222630333,1,9,1.0,10,0.1
222651116,1,8,1.0,9,0.1111111111111111
222661503,1,19,1.0,20,0.05
222688200,5,5,5.0,10,0.5
222703029,6,3,3.0,9,0.3333333333333333
222719903,1,8,1.0,9,0.1111111111111111
222724838,4,6,4.0,10,0.4
222743846,2,8,2.0,10,0.2
222751880,4,5,4.0,9,0.4444444444444444
222752496,3,7,3.0,10,0.3
222760023,2,8,2.0,10,0.2
222792027,3,16,3.0,19,0.15789473684210525
222801196,2,8,2.0,10,0.2
222808322,1,8,1.0,9,0.1111111111111111
222815396,1,9,1.0,10,0.1
222826107,2,18,2.0,20,0.1
222854406,6,3,3.0,9,0.3333333333333333
222854796,10,19,10.0,29,0.3448275862068966
222855728,2,8,2.0,10,0.2
222905107,5,5,5.0,10,0.5
222909051,1,9,1.0,10,0.1
222913025,1,9,1.0,10,0.1
222922399,9,1,1.0,10,0.1
222927958,1,8,1.0,9,0.1111111111111111
222930741,6,3,3.0,9,0.3333333333333333
222931172,8,1,1.0,9,0.1111111111111111
222931616,5,4,4.0,9,0.4444444444444444
222931884,2,6,2.0,8,0.25
222932125,3,7,3.0,10,0.3
222934670,7,3,3.0,10,0.3
222936819,5,4,4.0,9,0.4444444444444444
222938425,11,7,7.0,18,0.3888888888888889
222968757,5,5,5.0,10,0.5
222969625,2,8,2.0,10,0.2
222969678,3,7,3.0,10,0.3
222969730,4,5,4.0,9,0.4444444444444444
222980212,18,11,11.0,29,0.3793103448275862
222986464,4,15,4.0,19,0.21052631578947367
222987885,1,7,1.0,8,0.125
222990826,9,1,1.0,10,0.1
223074634,1,9,1.0,10,0.1
223080164,1,19,1.0,20,0.05
223080335,1,8,1.0,9,0.1111111111111111
223114941,1,29,1.0,30,0.03333333333333333
223141419,1,8,1.0,9,0.1111111111111111
223144031,28,1,1.0,29,0.034482758620689655
223153623,3,7,3.0,10,0.3
223182148,4,5,4.0,9,0.4444444444444444
223189171,3,7,3.0,10,0.3
223213775,3,7,3.0,10,0.3
223214984,1,19,1.0,20,0.05
223215007,2,8,2.0,10,0.2
223216365,2,7,2.0,9,0.2222222222222222
223255659,9,1,1.0,10,0.1
223257239,3,6,3.0,9,0.3333333333333333
223259017,2,7,2.0,9,0.2222222222222222
223268843,7,2,2.0,9,0.2222222222222222
223269222,9,1,1.0,10,0.1
223284309,7,21,7.0,28,0.25
223299535,2,8,2.0,10,0.2
223306105,2,7,2.0,9,0.2222222222222222
223308543,1,9,1.0,10,0.1
223378393,1,17,1.0,18,0.05555555555555555
223383894,2,7,2.0,9,0.2222222222222222
223387343,2,7,2.0,9,0.2222222222222222
223398030,1,8,1.0,9,0.1111111111111111
223399780,4,5,4.0,9,0.4444444444444444
223400169,1,9,1.0,10,0.1
223400779,7,2,2.0,9,0.2222222222222222
223409194,1,9,1.0,10,0.1
223415690,1,9,1.0,10,0.1
223425857,3,15,3.0,18,0.16666666666666666
223427457,1,9,1.0,10,0.1
223429249,8,1,1.0,9,0.1111111111111111
223456402,4,6,4.0,10,0.4
223460813,1,9,1.0,10,0.1
223461868,1,9,1.0,10,0.1
223474315,6,4,4.0,10,0.4
223493630,1,18,1.0,19,0.05263157894736842
223493667,4,6,4.0,10,0.4
223536662,1,8,1.0,9,0.1111111111111111
223559723,1,9,1.0,10,0.1
223581138,2,8,2.0,10,0.2
223582888,1,9,1.0,10,0.1
223605642,2,6,2.0,8,0.25
223609228,1,8,1.0,9,0.1111111111111111
223624896,1,8,1.0,9,0.1111111111111111
223624958,1,9,1.0,10,0.1
223629424,1,8,1.0,9,0.1111111111111111
223630712,4,6,4.0,10,0.4
223642000,1,17,1.0,18,0.05555555555555555
223645227,1,26,1.0,27,0.037037037037037035
223666611,2,27,2.0,29,0.06896551724137931
223691709,5,5,5.0,10,0.5
223721650,1,8,1.0,9,0.1111111111111111
223736409,4,6,4.0,10,0.4
223759491,8,1,1.0,9,0.1111111111111111
223762257,4,5,4.0,9,0.4444444444444444
223764407,4,4,4.0,8,0.5
223770811,1,9,1.0,10,0.1
223777826,1,9,1.0,10,0.1
223798294,1,8,1.0,9,0.1111111111111111
223801738,1,9,1.0,10,0.1
223802649,1,9,1.0,10,0.1
223813843,26,2,2.0,28,0.07142857142857142
223814034,5,5,5.0,10,0.5
223814813,7,1,1.0,8,0.125
223814862,8,1,1.0,9,0.1111111111111111
223814922,7,2,2.0,9,0.2222222222222222
223814996,8,1,1.0,9,0.1111111111111111
223815056,8,1,1.0,9,0.1111111111111111
223823419,6,4,4.0,10,0.4
223823825,1,8,1.0,9,0.1111111111111111
223824157,1,8,1.0,9,0.1111111111111111
223825594,1,19,1.0,20,0.05
223825888,3,17,3.0,20,0.15
223827599,6,3,3.0,9,0.3333333333333333
223830877,4,6,4.0,10,0.4
223831880,2,8,2.0,10,0.2
223835375,1,8,1.0,9,0.1111111111111111
223836027,1,9,1.0,10,0.1
223836822,2,18,2.0,20,0.1
223838205,2,17,2.0,19,0.10526315789473684
223844444,2,16,2.0,18,0.1111111111111111
223852021,3,6,3.0,9,0.3333333333333333
223860463,1,18,1.0,19,0.05263157894736842
223893272,2,8,2.0,10,0.2
223909481,1,9,1.0,10,0.1
223929929,6,4,4.0,10,0.4
223937572,1,8,1.0,9,0.1111111111111111
223952785,2,8,2.0,10,0.2
223970395,2,7,2.0,9,0.2222222222222222
223972348,26,3,3.0,29,0.10344827586206896
223991077,1,9,1.0,10,0.1
223994989,2,8,2.0,10,0.2
224016528,1,17,1.0,18,0.05555555555555555
224026368,12,7,7.0,19,0.3684210526315789
224035105,1,8,1.0,9,0.1111111111111111
224038121,1,9,1.0,10,0.1
224042494,1,7,1.0,8,0.125
224043726,1,18,1.0,19,0.05263157894736842
224062525,1,9,1.0,10,0.1
224067440,3,7,3.0,10,0.3
224068193,1,9,1.0,10,0.1
224095297,1,19,1.0,20,0.05
224112292,2,18,2.0,20,0.1
224115907,1,9,1.0,10,0.1
224125667,1,8,1.0,9,0.1111111111111111
224128874,1,18,1.0,19,0.05263157894736842
224129052,15,12,12.0,27,0.4444444444444444
224132488,1,9,1.0,10,0.1
224153176,4,5,4.0,9,0.4444444444444444
224155780,3,6,3.0,9,0.3333333333333333
224187317,1,18,1.0,19,0.05263157894736842
224220771,2,7,2.0,9,0.2222222222222222
224231937,2,7,2.0,9,0.2222222222222222
224236164,2,8,2.0,10,0.2
224252330,1,28,1.0,29,0.034482758620689655
224254849,1,9,1.0,10,0.1
224257218,2,8,2.0,10,0.2
224258818,2,8,2.0,10,0.2
224259164,1,9,1.0,10,0.1
224264691,1,16,1.0,17,0.058823529411764705
224271542,2,8,2.0,10,0.2
224283864,3,13,3.0,16,0.1875
224287121,1,9,1.0,10,0.1
224287970,8,2,2.0,10,0.2
224287981,6,3,3.0,9,0.3333333333333333
224287991,1,9,1.0,10,0.1
224295935,2,8,2.0,10,0.2
224297691,7,3,3.0,10,0.3
224303335,8,2,2.0,10,0.2
224308418,2,7,2.0,9,0.2222222222222222
224352096,16,10,10.0,26,0.38461538461538464
224357766,2,26,2.0,28,0.07142857142857142
224373877,1,7,1.0,8,0.125
224382867,11,9,9.0,20,0.45
224392888,1,9,1.0,10,0.1
224410378,23,6,6.0,29,0.20689655172413793
224433617,1,8,1.0,9,0.1111111111111111
224437008,2,8,2.0,10,0.2
224452905,9,1,1.0,10,0.1
224455507,8,2,2.0,10,0.2
224455684,8,1,1.0,9,0.1111111111111111
224456079,9,1,1.0,10,0.1
224456274,5,5,5.0,10,0.5
224456376,8,2,2.0,10,0.2
224459118,9,10,9.0,19,0.47368421052631576
224459667,1,8,1.0,9,0.1111111111111111
224460548,1,17,1.0,18,0.05555555555555555
224480164,1,9,1.0,10,0.1
224502691,2,7,2.0,9,0.2222222222222222
224503648,6,4,4.0,10,0.4
224504245,5,5,5.0,10,0.5
224504399,8,2,2.0,10,0.2
224505517,2,7,2.0,9,0.2222222222222222
224507440,4,5,4.0,9,0.4444444444444444
224509080,2,6,2.0,8,0.25
224545935,1,19,1.0,20,0.05
224584095,1,8,1.0,9,0.1111111111111111
224588253,4,6,4.0,10,0.4
224588632,1,9,1.0,10,0.1
224609822,7,3,3.0,10,0.3
224610236,5,5,5.0,10,0.5
224626361,10,9,9.0,19,0.47368421052631576
224634700,2,8,2.0,10,0.2
224638255,1,9,1.0,10,0.1
224649021,6,4,4.0,10,0.4
224651393,3,6,3.0,9,0.3333333333333333
224651465,4,14,4.0,18,0.2222222222222222
224656740,3,7,3.0,10,0.3
224668884,1,7,1.0,8,0.125
224674943,3,7,3.0,10,0.3
224676519,1,8,1.0,9,0.1111111111111111
224699812,1,8,1.0,9,0.1111111111111111
224711206,2,7,2.0,9,0.2222222222222222
224729185,9,1,1.0,10,0.1
224729278,1,19,1.0,20,0.05
224777679,8,1,1.0,9,0.1111111111111111
224801904,1,7,1.0,8,0.125
224809347,2,7,2.0,9,0.2222222222222222
224816539,1,18,1.0,19,0.05263157894736842
224822212,1,9,1.0,10,0.1
224822497,1,9,1.0,10,0.1
224853163,1,9,1.0,10,0.1
224855631,4,15,4.0,19,0.21052631578947367
224866272,1,9,1.0,10,0.1
224870279,1,9,1.0,10,0.1
224886858,2,8,2.0,10,0.2
224900429,4,4,4.0,8,0.5
224909016,1,18,1.0,19,0.05263157894736842
224912674,8,2,2.0,10,0.2
224912718,6,3,3.0,9,0.3333333333333333
224914614,1,7,1.0,8,0.125
224916328,2,16,2.0,18,0.1111111111111111
224923635,2,8,2.0,10,0.2
224927457,7,3,3.0,10,0.3
224927892,6,4,4.0,10,0.4
224927956,9,1,1.0,10,0.1
224928600,5,5,5.0,10,0.5
224929701,4,4,4.0,8,0.5
224936123,26,1,1.0,27,0.037037037037037035
224938891,7,1,1.0,8,0.125
224976423,6,3,3.0,9,0.3333333333333333
224976966,8,2,2.0,10,0.2
224977051,23,5,5.0,28,0.17857142857142858
224978168,7,2,2.0,9,0.2222222222222222
224979526,8,2,2.0,10,0.2
224979771,3,6,3.0,9,0.3333333333333333
225000436,1,8,1.0,9,0.1111111111111111
225013621,2,8,2.0,10,0.2
225036161,8,2,2.0,10,0.2
225073963,7,3,3.0,10,0.3
225074687,2,7,2.0,9,0.2222222222222222
225085135,2,18,2.0,20,0.1
225089750,16,13,13.0,29,0.4482758620689655
225097387,9,1,1.0,10,0.1
225099488,2,28,2.0,30,0.06666666666666667
225100098,1,9,1.0,10,0.1
225100629,1,8,1.0,9,0.1111111111111111
225103029,3,7,3.0,10,0.3
225109020,10,9,9.0,19,0.47368421052631576
225114001,1,9,1.0,10,0.1
225117175,1,27,1.0,28,0.03571428571428571
225119252,1,9,1.0,10,0.1
225121063,1,8,1.0,9,0.1111111111111111
225170243,1,9,1.0,10,0.1
225170841,8,2,2.0,10,0.2
225171140,5,3,3.0,8,0.375
225173314,14,5,5.0,19,0.2631578947368421
225180932,3,7,3.0,10,0.3
225192300,2,15,2.0,17,0.11764705882352941
225195703,1,8,1.0,9,0.1111111111111111
225237024,2,8,2.0,10,0.2
225237410,6,2,2.0,8,0.25
225244022,7,3,3.0,10,0.3
225250450,4,6,4.0,10,0.4
225262547,4,5,4.0,9,0.4444444444444444
225265473,2,8,2.0,10,0.2
225270863,2,8,2.0,10,0.2
225284444,1,19,1.0,20,0.05
225334327,8,2,2.0,10,0.2
225334411,7,2,2.0,9,0.2222222222222222
225336287,8,2,2.0,10,0.2
225340435,11,17,11.0,28,0.39285714285714285
225344554,7,3,3.0,10,0.3
225348199,2,7,2.0,9,0.2222222222222222
225358032,4,6,4.0,10,0.4
225381658,1,8,1.0,9,0.1111111111111111
225419544,1,9,1.0,10,0.1
225432640,1,9,1.0,10,0.1
225434470,4,6,4.0,10,0.4
225437574,3,24,3.0,27,0.1111111111111111
225440291,1,25,1.0,26,0.038461538461538464
225440908,28,1,1.0,29,0.034482758620689655
225441963,3,5,3.0,8,0.375
225446537,2,8,2.0,10,0.2
225451319,4,4,4.0,8,0.5
225471042,5,5,5.0,10,0.5
225472367,1,9,1.0,10,0.1
225474133,5,5,5.0,10,0.5
225499428,2,8,2.0,10,0.2
225517957,1,8,1.0,9,0.1111111111111111
225520866,2,8,2.0,10,0.2
225522865,5,4,4.0,9,0.4444444444444444
225523530,8,2,2.0,10,0.2
225523671,9,1,1.0,10,0.1
225528660,6,2,2.0,8,0.25
225582122,1,9,1.0,10,0.1
225587273,1,8,1.0,9,0.1111111111111111
225588734,5,23,5.0,28,0.17857142857142858
225596069,11,13,11.0,24,0.4583333333333333
225605404,7,3,3.0,10,0.3
225606731,4,5,4.0,9,0.4444444444444444
225622929,3,16,3.0,19,0.15789473684210525
225635254,3,7,3.0,10,0.3
225644233,4,6,4.0,10,0.4
225645520,5,5,5.0,10,0.5
225652779,1,19,1.0,20,0.05
225657521,9,1,1.0,10,0.1
225657962,2,6,2.0,8,0.25
225658487,1,8,1.0,9,0.1111111111111111
225662016,6,3,3.0,9,0.3333333333333333
225664021,1,9,1.0,10,0.1
225673088,2,7,2.0,9,0.2222222222222222
225678376,2,16,2.0,18,0.1111111111111111
225681031,1,8,1.0,9,0.1111111111111111
225692658,2,7,2.0,9,0.2222222222222222
225695895,1,19,1.0,20,0.05
225707810,1,8,1.0,9,0.1111111111111111
225716247,2,18,2.0,20,0.1
225742542,2,8,2.0,10,0.2
225749461,2,8,2.0,10,0.2
225752445,1,9,1.0,10,0.1
225759436,3,5,3.0,8,0.375
225792539,3,6,3.0,9,0.3333333333333333
225820002,1,7,1.0,8,0.125
225821163,3,6,3.0,9,0.3333333333333333
225853183,7,1,1.0,8,0.125
225856443,1,9,1.0,10,0.1
225870971,1,8,1.0,9,0.1111111111111111
225874457,1,9,1.0,10,0.1
225875558,1,9,1.0,10,0.1
225939438,8,1,1.0,9,0.1111111111111111
225949893,6,3,3.0,9,0.3333333333333333
225971930,8,2,2.0,10,0.2
226009326,1,9,1.0,10,0.1
226017019,2,8,2.0,10,0.2
226031261,1,9,1.0,10,0.1
226054357,4,6,4.0,10,0.4
226055336,3,7,3.0,10,0.3
226056407,1,7,1.0,8,0.125
226057914,1,9,1.0,10,0.1
226066112,25,4,4.0,29,0.13793103448275862
226153363,6,2,2.0,8,0.25
226157558,1,7,1.0,8,0.125
226168587,7,3,3.0,10,0.3
226186441,3,5,3.0,8,0.375
226189886,2,8,2.0,10,0.2
226214931,1,9,1.0,10,0.1
226232354,14,13,13.0,27,0.48148148148148145
226242584,2,26,2.0,28,0.07142857142857142
226259222,14,14,14.0,28,0.5
226271706,3,7,3.0,10,0.3
226274321,1,9,1.0,10,0.1
226286007,1,9,1.0,10,0.1
226299632,3,26,3.0,29,0.10344827586206896
226305483,9,19,9.0,28,0.32142857142857145
226312194,2,16,2.0,18,0.1111111111111111
226317246,1,8,1.0,9,0.1111111111111111
226322438,4,6,4.0,10,0.4
226349955,1,8,1.0,9,0.1111111111111111
226377891,25,1,1.0,26,0.038461538461538464
226443699,1,9,1.0,10,0.1
226446794,3,7,3.0,10,0.3
226446964,8,21,8.0,29,0.27586206896551724
226450218,8,12,8.0,20,0.4
226460366,8,2,2.0,10,0.2
226466054,2,7,2.0,9,0.2222222222222222
226474377,3,6,3.0,9,0.3333333333333333
226483716,3,5,3.0,8,0.375
226518628,3,17,3.0,20,0.15
226521461,4,6,4.0,10,0.4
226550035,6,4,4.0,10,0.4
226555892,3,7,3.0,10,0.3
226562988,3,7,3.0,10,0.3
226566874,6,4,4.0,10,0.4
226576296,3,7,3.0,10,0.3
226592040,27,1,1.0,28,0.03571428571428571
226600333,6,3,3.0,9,0.3333333333333333
226609916,1,9,1.0,10,0.1
226610254,1,9,1.0,10,0.1
226613467,2,8,2.0,10,0.2
226615339,4,5,4.0,9,0.4444444444444444
226616065,8,1,1.0,9,0.1111111111111111
226616283,8,1,1.0,9,0.1111111111111111
226616494,5,4,4.0,9,0.4444444444444444
226619127,8,20,8.0,28,0.2857142857142857
226642332,2,8,2.0,10,0.2
226650187,1,9,1.0,10,0.1
226650475,1,9,1.0,10,0.1
226662250,1,8,1.0,9,0.1111111111111111
226672670,2,6,2.0,8,0.25
226674919,1,9,1.0,10,0.1
226675633,3,6,3.0,9,0.3333333333333333
226694101,1,8,1.0,9,0.1111111111111111
226698270,2,8,2.0,10,0.2
226698624,2,7,2.0,9,0.2222222222222222
226699358,1,9,1.0,10,0.1
226713180,9,1,1.0,10,0.1
226719672,4,5,4.0,9,0.4444444444444444
226727259,4,5,4.0,9,0.4444444444444444
226728725,6,4,4.0,10,0.4
226729551,1,8,1.0,9,0.1111111111111111
226743610,2,7,2.0,9,0.2222222222222222
226754711,2,8,2.0,10,0.2
226758845,1,9,1.0,10,0.1
226762344,1,9,1.0,10,0.1
226773237,2,7,2.0,9,0.2222222222222222
226809107,1,8,1.0,9,0.1111111111111111
226809147,1,9,1.0,10,0.1
226812943,4,5,4.0,9,0.4444444444444444
226815098,2,7,2.0,9,0.2222222222222222
226815825,1,8,1.0,9,0.1111111111111111
226816293,11,19,11.0,30,0.36666666666666664
226818429,2,8,2.0,10,0.2
226818797,3,7,3.0,10,0.3
226822203,2,8,2.0,10,0.2
226838255,7,2,2.0,9,0.2222222222222222
226847976,7,2,2.0,9,0.2222222222222222
226865922,1,9,1.0,10,0.1
226877239,4,6,4.0,10,0.4
226886731,1,8,1.0,9,0.1111111111111111
226891416,1,8,1.0,9,0.1111111111111111
226892565,1,9,1.0,10,0.1
226919998,1,7,1.0,8,0.125
226943971,27,2,2.0,29,0.06896551724137931
226961319,1,9,1.0,10,0.1
226968820,2,7,2.0,9,0.2222222222222222
226991084,2,8,2.0,10,0.2
226994722,1,9,1.0,10,0.1
227006737,1,17,1.0,18,0.05555555555555555
227048040,1,9,1.0,10,0.1
227049056,8,2,2.0,10,0.2
227050603,6,4,4.0,10,0.4
227051230,3,7,3.0,10,0.3
227053023,2,8,2.0,10,0.2
227056858,5,5,5.0,10,0.5
227064518,2,6,2.0,8,0.25
227071218,1,9,1.0,10,0.1
227073174,5,5,5.0,10,0.5
227075517,2,18,2.0,20,0.1
227076189,6,2,2.0,8,0.25
227080872,1,9,1.0,10,0.1
227083201,2,8,2.0,10,0.2
227128025,1,8,1.0,9,0.1111111111111111
227136960,1,7,1.0,8,0.125
227151657,1,7,1.0,8,0.125
227162318,1,8,1.0,9,0.1111111111111111
227188966,16,4,4.0,20,0.2
227191204,4,5,4.0,9,0.4444444444444444
227191681,5,5,5.0,10,0.5
227217049,1,8,1.0,9,0.1111111111111111
227222821,4,5,4.0,9,0.4444444444444444
227223032,4,6,4.0,10,0.4
227224387,1,27,1.0,28,0.03571428571428571
227225569,2,26,2.0,28,0.07142857142857142
227237346,3,17,3.0,20,0.15
227241945,1,8,1.0,9,0.1111111111111111
227245464,4,6,4.0,10,0.4
227247122,1,29,1.0,30,0.03333333333333333
227253698,7,3,3.0,10,0.3
227259504,2,7,2.0,9,0.2222222222222222
227263356,2,7,2.0,9,0.2222222222222222
227265049,8,2,2.0,10,0.2
227279407,1,9,1.0,10,0.1
227281856,2,8,2.0,10,0.2
227285102,1,9,1.0,10,0.1
227290022,1,9,1.0,10,0.1
227290199,1,9,1.0,10,0.1
227290848,1,9,1.0,10,0.1
227295807,2,8,2.0,10,0.2
227298691,8,2,2.0,10,0.2
227298862,5,4,4.0,9,0.4444444444444444
227301278,1,9,1.0,10,0.1
227314526,1,9,1.0,10,0.1
227319460,1,9,1.0,10,0.1
227325080,1,9,1.0,10,0.1
227327046,3,7,3.0,10,0.3
227333964,1,8,1.0,9,0.1111111111111111
227341010,8,2,2.0,10,0.2
227347854,6,3,3.0,9,0.3333333333333333
227359039,1,8,1.0,9,0.1111111111111111
227362690,12,15,12.0,27,0.4444444444444444
227368980,2,7,2.0,9,0.2222222222222222
227370244,2,8,2.0,10,0.2
227373690,1,9,1.0,10,0.1
227396358,24,12,12.0,36,0.3333333333333333
227402579,1,8,1.0,9,0.1111111111111111
227402728,1,7,1.0,8,0.125
227414826,2,8,2.0,10,0.2
227421037,1,19,1.0,20,0.05
227439122,1,9,1.0,10,0.1
227439634,8,2,2.0,10,0.2
227442344,9,1,1.0,10,0.1
227447025,1,9,1.0,10,0.1
227456103,2,8,2.0,10,0.2
227456644,1,9,1.0,10,0.1
227457431,4,5,4.0,9,0.4444444444444444
227477634,8,1,1.0,9,0.1111111111111111
227483572,1,9,1.0,10,0.1
227523266,1,9,1.0,10,0.1
227525828,1,9,1.0,10,0.1
227532864,8,2,2.0,10,0.2
227535034,9,1,1.0,10,0.1
227542304,4,16,4.0,20,0.2
227547414,9,1,1.0,10,0.1
227574058,21,7,7.0,28,0.25
227579118,2,8,2.0,10,0.2
227579532,1,8,1.0,9,0.1111111111111111
227581452,4,25,4.0,29,0.13793103448275862
227597612,5,3,3.0,8,0.375
227613247,1,9,1.0,10,0.1
227628576,1,9,1.0,10,0.1
227657702,1,8,1.0,9,0.1111111111111111
227668942,1,9,1.0,10,0.1
227698991,1,7,1.0,8,0.125
227707035,2,8,2.0,10,0.2
227707073,2,8,2.0,10,0.2
227734186,1,8,1.0,9,0.1111111111111111
227734906,2,8,2.0,10,0.2
227737858,1,9,1.0,10,0.1
227749030,1,9,1.0,10,0.1
227766698,1,9,1.0,10,0.1
227768148,3,7,3.0,10,0.3
227780905,7,3,3.0,10,0.3
227818034,6,3,3.0,9,0.3333333333333333
227820157,3,17,3.0,20,0.15
227823498,16,4,4.0,20,0.2
227824117,6,4,4.0,10,0.4
227824457,9,1,1.0,10,0.1
227824742,6,4,4.0,10,0.4
227827040,1,9,1.0,10,0.1
227838805,2,6,2.0,8,0.25
227840905,1,18,1.0,19,0.05263157894736842
227862311,1,9,1.0,10,0.1
227869313,1,9,1.0,10,0.1
227869770,1,9,1.0,10,0.1
227870734,4,6,4.0,10,0.4
227870932,4,6,4.0,10,0.4
227873555,3,7,3.0,10,0.3
227878281,1,28,1.0,29,0.034482758620689655
227918363,1,8,1.0,9,0.1111111111111111
227922177,4,6,4.0,10,0.4
227924303,8,1,1.0,9,0.1111111111111111
227925049,7,21,7.0,28,0.25
227926508,3,6,3.0,9,0.3333333333333333
227942333,1,9,1.0,10,0.1
227968516,2,8,2.0,10,0.2
227990065,2,8,2.0,10,0.2
228023256,1,8,1.0,9,0.1111111111111111
228043638,3,7,3.0,10,0.3
228047896,3,7,3.0,10,0.3
228056357,6,4,4.0,10,0.4
228059795,2,7,2.0,9,0.2222222222222222
228075970,1,27,1.0,28,0.03571428571428571
228089024,1,8,1.0,9,0.1111111111111111
228097271,1,7,1.0,8,0.125
228116548,1,9,1.0,10,0.1
228118895,4,6,4.0,10,0.4
228123244,3,6,3.0,9,0.3333333333333333
228154056,7,3,3.0,10,0.3
228173156,3,17,3.0,20,0.15
228182341,1,8,1.0,9,0.1111111111111111
228196067,2,8,2.0,10,0.2
228197978,2,6,2.0,8,0.25
228209598,1,9,1.0,10,0.1
228217020,1,8,1.0,9,0.1111111111111111
228231408,1,7,1.0,8,0.125
228234899,4,6,4.0,10,0.4
228235958,5,4,4.0,9,0.4444444444444444
228236191,5,5,5.0,10,0.5
228239223,1,9,1.0,10,0.1
228242180,1,18,1.0,19,0.05263157894736842
228244543,1,7,1.0,8,0.125
228245165,5,13,5.0,18,0.2777777777777778
228247240,7,20,7.0,27,0.25925925925925924
228249970,2,8,2.0,10,0.2
228267830,4,16,4.0,20,0.2
228269857,5,4,4.0,9,0.4444444444444444
228275540,3,16,3.0,19,0.15789473684210525
228279367,3,26,3.0,29,0.10344827586206896
228281087,1,8,1.0,9,0.1111111111111111
228286329,2,8,2.0,10,0.2
228290179,2,8,2.0,10,0.2
228292576,5,5,5.0,10,0.5
228296380,1,9,1.0,10,0.1
228300611,6,3,3.0,9,0.3333333333333333
228301424,4,4,4.0,8,0.5
228304651,24,5,5.0,29,0.1724137931034483
228310859,2,7,2.0,9,0.2222222222222222
228323332,1,9,1.0,10,0.1
228328113,4,6,4.0,10,0.4
228336551,6,4,4.0,10,0.4
228336754,3,7,3.0,10,0.3
228340114,3,6,3.0,9,0.3333333333333333
228344398,4,4,4.0,8,0.5
228350044,1,8,1.0,9,0.1111111111111111
228359605,1,9,1.0,10,0.1
228364751,3,6,3.0,9,0.3333333333333333
228386391,5,5,5.0,10,0.5
228394659,1,8,1.0,9,0.1111111111111111
228414593,2,8,2.0,10,0.2
228423466,2,8,2.0,10,0.2
228429703,7,3,3.0,10,0.3
228431687,2,6,2.0,8,0.25
228462783,12,15,12.0,27,0.4444444444444444
228467606,8,1,1.0,9,0.1111111111111111
228467847,6,4,4.0,10,0.4
228469682,4,6,4.0,10,0.4
228469799,6,3,3.0,9,0.3333333333333333
228470560,7,3,3.0,10,0.3
228501856,4,16,4.0,20,0.2
228501996,6,3,3.0,9,0.3333333333333333
228526301,1,9,1.0,10,0.1
228527300,1,19,1.0,20,0.05
228527926,9,1,1.0,10,0.1
228528143,1,9,1.0,10,0.1
228530553,3,7,3.0,10,0.3
228531621,5,5,5.0,10,0.5
228532530,1,25,1.0,26,0.038461538461538464
228540666,2,18,2.0,20,0.1
228567789,4,6,4.0,10,0.4
228576862,1,17,1.0,18,0.05555555555555555
228578381,2,8,2.0,10,0.2
228618704,3,7,3.0,10,0.3
228641817,2,7,2.0,9,0.2222222222222222
228651717,5,4,4.0,9,0.4444444444444444
228671989,5,5,5.0,10,0.5
228675823,6,3,3.0,9,0.3333333333333333
228675891,1,8,1.0,9,0.1111111111111111
228688955,1,9,1.0,10,0.1
228695391,2,8,2.0,10,0.2
228698065,1,9,1.0,10,0.1
228716331,4,6,4.0,10,0.4
228779761,7,19,7.0,26,0.2692307692307692
228818802,1,9,1.0,10,0.1
228819615,2,8,2.0,10,0.2
228826230,1,9,1.0,10,0.1
228827283,6,14,6.0,20,0.3
228827785,2,8,2.0,10,0.2
228829400,3,5,3.0,8,0.375
228832270,1,9,1.0,10,0.1
228835276,3,7,3.0,10,0.3
228841488,1,7,1.0,8,0.125
228864103,2,6,2.0,8,0.25
228867227,1,17,1.0,18,0.05555555555555555
228889315,3,6,3.0,9,0.3333333333333333
228921446,3,6,3.0,9,0.3333333333333333
228932020,4,4,4.0,8,0.5
228937586,2,8,2.0,10,0.2
228963116,7,2,2.0,9,0.2222222222222222
228966212,3,7,3.0,10,0.3
228966868,8,2,2.0,10,0.2
228966926,8,2,2.0,10,0.2
228967021,6,3,3.0,9,0.3333333333333333
228967130,6,3,3.0,9,0.3333333333333333
228967249,5,5,5.0,10,0.5
228968204,4,5,4.0,9,0.4444444444444444
228968497,6,4,4.0,10,0.4
228969303,4,4,4.0,8,0.5
228977397,27,1,1.0,28,0.03571428571428571
228979495,1,9,1.0,10,0.1
228985181,2,24,2.0,26,0.07692307692307693
228986087,1,8,1.0,9,0.1111111111111111
228997539,1,8,1.0,9,0.1111111111111111
229000457,1,8,1.0,9,0.1111111111111111
229028406,2,7,2.0,9,0.2222222222222222
229028822,2,8,2.0,10,0.2
229048970,1,9,1.0,10,0.1
229050462,3,7,3.0,10,0.3
229054277,1,8,1.0,9,0.1111111111111111
229064713,7,23,7.0,30,0.23333333333333334
229075689,4,6,4.0,10,0.4
229116957,2,8,2.0,10,0.2
229118361,3,7,3.0,10,0.3
229138626,1,9,1.0,10,0.1
229146142,2,8,2.0,10,0.2
229160678,1,9,1.0,10,0.1
229161725,1,9,1.0,10,0.1
229180206,1,9,1.0,10,0.1
229181312,7,3,3.0,10,0.3
229181749,5,5,5.0,10,0.5
229198640,2,7,2.0,9,0.2222222222222222
229204090,1,9,1.0,10,0.1
229206601,2,8,2.0,10,0.2
229207154,4,26,4.0,30,0.13333333333333333
229213234,1,8,1.0,9,0.1111111111111111
229217899,4,6,4.0,10,0.4
229224829,3,7,3.0,10,0.3
229233132,2,6,2.0,8,0.25
229245893,18,1,1.0,19,0.05263157894736842
229274746,1,9,1.0,10,0.1
229275406,3,7,3.0,10,0.3
229290843,1,9,1.0,10,0.1
229302155,2,8,2.0,10,0.2
229324669,6,3,3.0,9,0.3333333333333333
229333687,5,3,3.0,8,0.375
229341225,1,9,1.0,10,0.1
229344794,9,1,1.0,10,0.1
229345543,7,3,3.0,10,0.3
229346513,17,9,9.0,26,0.34615384615384615
229347892,3,7,3.0,10,0.3
229348252,2,8,2.0,10,0.2
229350522,3,7,3.0,10,0.3
229395426,1,9,1.0,10,0.1
229400674,4,6,4.0,10,0.4
229407441,1,9,1.0,10,0.1
229421996,1,19,1.0,20,0.05
229430578,5,5,5.0,10,0.5
229432665,1,9,1.0,10,0.1
229448598,16,13,13.0,29,0.4482758620689655
229452184,1,9,1.0,10,0.1
229457932,1,8,1.0,9,0.1111111111111111
229495859,9,1,1.0,10,0.1
229504234,1,9,1.0,10,0.1
229513253,3,7,3.0,10,0.3
229536419,5,5,5.0,10,0.5
229536715,6,3,3.0,9,0.3333333333333333
229536924,4,5,4.0,9,0.4444444444444444
229538315,5,5,5.0,10,0.5
229574957,1,9,1.0,10,0.1
229576416,7,19,7.0,26,0.2692307692307692
229615598,8,1,1.0,9,0.1111111111111111
229634686,1,9,1.0,10,0.1
229635424,1,8,1.0,9,0.1111111111111111
229639361,9,1,1.0,10,0.1
229639724,5,4,4.0,9,0.4444444444444444
229675425,1,9,1.0,10,0.1
229678068,1,8,1.0,9,0.1111111111111111
229682521,1,7,1.0,8,0.125
229691486,4,16,4.0,20,0.2
229714269,9,1,1.0,10,0.1
229738369,2,8,2.0,10,0.2
229753581,6,4,4.0,10,0.4
229760273,2,6,2.0,8,0.25
229765822,7,23,7.0,30,0.23333333333333334
229788723,1,9,1.0,10,0.1
229791225,20,9,9.0,29,0.3103448275862069
229794784,2,7,2.0,9,0.2222222222222222
229797196,1,9,1.0,10,0.1
229797796,2,7,2.0,9,0.2222222222222222
229797927,4,6,4.0,10,0.4
229798640,1,9,1.0,10,0.1
229813741,7,3,3.0,10,0.3
229832322,1,17,1.0,18,0.05555555555555555
229838396,2,8,2.0,10,0.2
229843368,3,16,3.0,19,0.15789473684210525
229846207,1,8,1.0,9,0.1111111111111111
229857984,1,8,1.0,9,0.1111111111111111
229864823,4,6,4.0,10,0.4
229878310,4,6,4.0,10,0.4
229878321,9,9,9.0,18,0.5
229878626,1,9,1.0,10,0.1
229879151,3,7,3.0,10,0.3
229880229,3,6,3.0,9,0.3333333333333333
229881114,2,26,2.0,28,0.07142857142857142
229884827,4,4,4.0,8,0.5
229891630,1,9,1.0,10,0.1
229895557,1,8,1.0,9,0.1111111111111111
229897536,1,8,1.0,9,0.1111111111111111
229898922,1,9,1.0,10,0.1
229906773,1,9,1.0,10,0.1
229916638,2,8,2.0,10,0.2
229946278,3,7,3.0,10,0.3
229949329,1,27,1.0,28,0.03571428571428571
229954689,2,27,2.0,29,0.06896551724137931
229955415,7,3,3.0,10,0.3
229955781,1,7,1.0,8,0.125
229970377,5,5,5.0,10,0.5
230019075,1,9,1.0,10,0.1
230025074,3,6,3.0,9,0.3333333333333333
230029446,3,15,3.0,18,0.16666666666666666
230041460,1,8,1.0,9,0.1111111111111111
230046699,1,7,1.0,8,0.125
230047393,1,8,1.0,9,0.1111111111111111
230116652,7,2,2.0,9,0.2222222222222222
230134699,1,8,1.0,9,0.1111111111111111
230153183,1,19,1.0,20,0.05
230153565,4,6,4.0,10,0.4
230154537,4,4,4.0,8,0.5
230177568,1,8,1.0,9,0.1111111111111111
230180984,2,18,2.0,20,0.1
230181948,1,9,1.0,10,0.1
230219041,1,8,1.0,9,0.1111111111111111
230228997,4,4,4.0,8,0.5
230232394,2,8,2.0,10,0.2
230234718,4,6,4.0,10,0.4
230235307,1,8,1.0,9,0.1111111111111111
230244766,2,8,2.0,10,0.2
230254576,4,14,4.0,18,0.2222222222222222
230259750,7,3,3.0,10,0.3
230284047,2,8,2.0,10,0.2
230295428,5,5,5.0,10,0.5
230295777,8,1,1.0,9,0.1111111111111111
230296129,3,7,3.0,10,0.3
230297788,3,7,3.0,10,0.3
230298314,6,4,4.0,10,0.4
230318437,1,9,1.0,10,0.1
230327357,4,4,4.0,8,0.5
230336576,1,8,1.0,9,0.1111111111111111
230353963,1,9,1.0,10,0.1
230358620,2,8,2.0,10,0.2
230360888,1,18,1.0,19,0.05263157894736842
230367072,2,8,2.0,10,0.2
230385104,1,9,1.0,10,0.1
230391219,1,8,1.0,9,0.1111111111111111
230391622,3,7,3.0,10,0.3
230404460,1,8,1.0,9,0.1111111111111111
230422524,3,16,3.0,19,0.15789473684210525
230423185,1,8,1.0,9,0.1111111111111111
230425016,1,9,1.0,10,0.1
230436699,11,19,11.0,30,0.36666666666666664
230457161,1,9,1.0,10,0.1
230457941,2,7,2.0,9,0.2222222222222222
230470008,9,1,1.0,10,0.1
230472153,9,1,1.0,10,0.1
230476939,1,9,1.0,10,0.1
230485730,8,22,8.0,30,0.26666666666666666
230490222,1,9,1.0,10,0.1
230533134,3,26,3.0,29,0.10344827586206896
230534096,1,9,1.0,10,0.1
230538022,4,5,4.0,9,0.4444444444444444
230546482,19,9,9.0,28,0.32142857142857145
230547107,2,7,2.0,9,0.2222222222222222
230549674,1,8,1.0,9,0.1111111111111111
230550271,4,6,4.0,10,0.4
230592043,1,9,1.0,10,0.1
230592721,5,5,5.0,10,0.5
230593031,8,2,2.0,10,0.2
230602201,3,17,3.0,20,0.15
230612160,1,9,1.0,10,0.1
230614292,4,6,4.0,10,0.4
230621966,4,6,4.0,10,0.4
230623015,4,6,4.0,10,0.4
230623537,1,9,1.0,10,0.1
230652352,1,8,1.0,9,0.1111111111111111
230659242,1,8,1.0,9,0.1111111111111111
230662842,4,24,4.0,28,0.14285714285714285
230662996,1,9,1.0,10,0.1
230683030,5,24,5.0,29,0.1724137931034483
230699488,1,9,1.0,10,0.1
230699713,1,9,1.0,10,0.1
230701342,2,6,2.0,8,0.25
230705082,3,7,3.0,10,0.3
230708942,1,8,1.0,9,0.1111111111111111
230719875,8,1,1.0,9,0.1111111111111111
230723384,9,1,1.0,10,0.1
230729536,1,9,1.0,10,0.1
230731909,6,4,4.0,10,0.4
230733122,20,7,7.0,27,0.25925925925925924
230776455,1,8,1.0,9,0.1111111111111111
230777419,3,7,3.0,10,0.3
230778637,3,26,3.0,29,0.10344827586206896
230779862,4,4,4.0,8,0.5
230780314,7,2,2.0,9,0.2222222222222222
230780706,1,8,1.0,9,0.1111111111111111
230781868,3,6,3.0,9,0.3333333333333333
230784578,1,9,1.0,10,0.1
230803091,18,10,10.0,28,0.35714285714285715
230805818,1,9,1.0,10,0.1
230812480,2,8,2.0,10,0.2
230813469,2,27,2.0,29,0.06896551724137931
230814726,2,7,2.0,9,0.2222222222222222
230830513,21,7,7.0,28,0.25
230832253,6,4,4.0,10,0.4
230834119,2,8,2.0,10,0.2
230839642,3,6,3.0,9,0.3333333333333333
230840933,1,18,1.0,19,0.05263157894736842
230849809,1,7,1.0,8,0.125
230864435,2,7,2.0,9,0.2222222222222222
230898925,3,6,3.0,9,0.3333333333333333
230918470,1,9,1.0,10,0.1
230926239,9,1,1.0,10,0.1
230959057,1,9,1.0,10,0.1
230967576,3,15,3.0,18,0.16666666666666666
230975505,1,15,1.0,16,0.0625
230995269,3,7,3.0,10,0.3
230998917,1,8,1.0,9,0.1111111111111111
230999563,1,27,1.0,28,0.03571428571428571
231002163,1,8,1.0,9,0.1111111111111111
231100824,2,8,2.0,10,0.2
231105235,2,7,2.0,9,0.2222222222222222
231105301,1,8,1.0,9,0.1111111111111111
231114493,1,8,1.0,9,0.1111111111111111
231126965,2,15,2.0,17,0.11764705882352941
231160900,1,9,1.0,10,0.1
231209610,2,7,2.0,9,0.2222222222222222
231217648,4,4,4.0,8,0.5
231227596,3,6,3.0,9,0.3333333333333333
231232254,1,16,1.0,17,0.058823529411764705
231232266,3,7,3.0,10,0.3
231242316,2,6,2.0,8,0.25
231245733,1,7,1.0,8,0.125
231249135,1,9,1.0,10,0.1
231250015,1,8,1.0,9,0.1111111111111111
231281373,1,19,1.0,20,0.05
231305242,1,9,1.0,10,0.1
231306864,3,7,3.0,10,0.3
231311942,2,7,2.0,9,0.2222222222222222
231312325,1,8,1.0,9,0.1111111111111111
231312630,1,9,1.0,10,0.1
231325498,2,8,2.0,10,0.2
231330353,3,5,3.0,8,0.375
231342162,6,4,4.0,10,0.4
231342246,2,7,2.0,9,0.2222222222222222
231342439,3,7,3.0,10,0.3
231353478,2,8,2.0,10,0.2
231382183,1,9,1.0,10,0.1
231384601,3,7,3.0,10,0.3
231386177,1,7,1.0,8,0.125
231396312,4,5,4.0,9,0.4444444444444444
231405716,1,7,1.0,8,0.125
231420889,1,17,1.0,18,0.05555555555555555
231430240,5,23,5.0,28,0.17857142857142858
231431276,2,8,2.0,10,0.2
231434449,3,7,3.0,10,0.3
231434939,2,7,2.0,9,0.2222222222222222
231435215,6,4,4.0,10,0.4
231435284,2,7,2.0,9,0.2222222222222222
231436296,1,9,1.0,10,0.1
231437137,14,14,14.0,28,0.5
231437292,6,22,6.0,28,0.21428571428571427
231437729,3,6,3.0,9,0.3333333333333333
231438567,2,8,2.0,10,0.2
231483667,1,9,1.0,10,0.1
231484670,1,17,1.0,18,0.05555555555555555
231514899,1,7,1.0,8,0.125
231532033,2,8,2.0,10,0.2
231533685,6,3,3.0,9,0.3333333333333333
231533926,7,3,3.0,10,0.3
231560063,5,14,5.0,19,0.2631578947368421
231591185,1,16,1.0,17,0.058823529411764705
231594660,18,1,1.0,19,0.05263157894736842
231626561,1,8,1.0,9,0.1111111111111111
231646683,2,16,2.0,18,0.1111111111111111
231655275,1,9,1.0,10,0.1
231666197,7,2,2.0,9,0.2222222222222222
231667895,8,2,2.0,10,0.2
231686914,3,7,3.0,10,0.3
231694478,1,8,1.0,9,0.1111111111111111
231699767,8,1,1.0,9,0.1111111111111111
231711950,1,8,1.0,9,0.1111111111111111
231716785,5,15,5.0,20,0.25
231741716,7,3,3.0,10,0.3
231757949,3,7,3.0,10,0.3
231781561,9,1,1.0,10,0.1
231792677,1,8,1.0,9,0.1111111111111111
231793728,1,9,1.0,10,0.1
231794438,2,7,2.0,9,0.2222222222222222
231816638,1,8,1.0,9,0.1111111111111111
231818123,7,2,2.0,9,0.2222222222222222
231825078,1,9,1.0,10,0.1
231850200,2,8,2.0,10,0.2
231857297,4,4,4.0,8,0.5
231876350,4,6,4.0,10,0.4
231895054,3,6,3.0,9,0.3333333333333333
231901336,1,8,1.0,9,0.1111111111111111
231919145,3,7,3.0,10,0.3
231923209,1,9,1.0,10,0.1
231928143,1,9,1.0,10,0.1
231933498,3,7,3.0,10,0.3
231941307,1,7,1.0,8,0.125
231941621,1,9,1.0,10,0.1
231952257,1,9,1.0,10,0.1
231952654,5,3,3.0,8,0.375
231955004,2,7,2.0,9,0.2222222222222222
231955764,9,1,1.0,10,0.1
231956117,4,6,4.0,10,0.4
231958558,2,7,2.0,9,0.2222222222222222
231973648,3,17,3.0,20,0.15
231977376,2,7,2.0,9,0.2222222222222222
231991915,2,18,2.0,20,0.1
232009276,7,12,7.0,19,0.3684210526315789
232025925,6,3,3.0,9,0.3333333333333333
232053192,7,3,3.0,10,0.3
232053675,4,6,4.0,10,0.4
232062219,13,7,7.0,20,0.35
232065863,4,5,4.0,9,0.4444444444444444
232067592,2,8,2.0,10,0.2
232075542,2,8,2.0,10,0.2
232084182,5,5,5.0,10,0.5
232087805,4,4,4.0,8,0.5
232096217,1,18,1.0,19,0.05263157894736842
232097255,3,27,3.0,30,0.1
232098041,2,8,2.0,10,0.2
232098589,2,8,2.0,10,0.2
232106508,1,17,1.0,18,0.05555555555555555
232109114,1,18,1.0,19,0.05263157894736842
232128778,4,15,4.0,19,0.21052631578947367
232130447,3,7,3.0,10,0.3
232136430,1,19,1.0,20,0.05
232137565,2,8,2.0,10,0.2
232157767,1,15,1.0,16,0.0625
232168124,1,19,1.0,20,0.05
232174401,21,8,8.0,29,0.27586206896551724
232217210,1,9,1.0,10,0.1
232229832,9,1,1.0,10,0.1
232230893,1,18,1.0,19,0.05263157894736842
232230978,1,17,1.0,18,0.05555555555555555
232239343,1,8,1.0,9,0.1111111111111111
232240427,3,6,3.0,9,0.3333333333333333
232241235,1,7,1.0,8,0.125
232242293,3,22,3.0,25,0.12
232243374,3,6,3.0,9,0.3333333333333333
232252187,1,9,1.0,10,0.1
232262405,1,9,1.0,10,0.1
232263488,1,9,1.0,10,0.1
232264705,1,9,1.0,10,0.1
232277929,5,5,5.0,10,0.5
232279001,9,1,1.0,10,0.1
232293317,5,13,5.0,18,0.2777777777777778
232311818,1,8,1.0,9,0.1111111111111111
232315690,1,8,1.0,9,0.1111111111111111
232315880,3,7,3.0,10,0.3
232319814,1,8,1.0,9,0.1111111111111111
232347482,9,1,1.0,10,0.1
232347660,3,7,3.0,10,0.3
232348775,3,7,3.0,10,0.3
232351527,6,4,4.0,10,0.4
232389738,2,25,2.0,27,0.07407407407407407
232409240,7,3,3.0,10,0.3
232430983,7,3,3.0,10,0.3
232439452,27,2,2.0,29,0.06896551724137931
232440924,1,9,1.0,10,0.1
232456318,7,2,2.0,9,0.2222222222222222
232456491,4,4,4.0,8,0.5
232457543,7,3,3.0,10,0.3
232459192,7,2,2.0,9,0.2222222222222222
232464578,1,9,1.0,10,0.1
232468251,2,8,2.0,10,0.2
232471556,1,9,1.0,10,0.1
232485260,3,6,3.0,9,0.3333333333333333
232488450,2,8,2.0,10,0.2
232489426,2,8,2.0,10,0.2
232493625,1,8,1.0,9,0.1111111111111111
232511118,2,8,2.0,10,0.2
232546459,1,9,1.0,10,0.1
232548975,1,9,1.0,10,0.1
232580820,26,2,2.0,28,0.07142857142857142
232585790,2,6,2.0,8,0.25
232629676,6,4,4.0,10,0.4
232687326,1,9,1.0,10,0.1
232702724,1,9,1.0,10,0.1
232711551,1,29,1.0,30,0.03333333333333333
232720382,8,1,1.0,9,0.1111111111111111
232728725,1,7,1.0,8,0.125
232740784,2,15,2.0,17,0.11764705882352941
232743259,3,7,3.0,10,0.3
232774292,1,9,1.0,10,0.1
232774368,9,1,1.0,10,0.1
232775885,1,18,1.0,19,0.05263157894736842
232776058,1,9,1.0,10,0.1
232783028,8,2,2.0,10,0.2
232784845,2,8,2.0,10,0.2
232797554,5,5,5.0,10,0.5
232805356,1,9,1.0,10,0.1
232807163,1,8,1.0,9,0.1111111111111111
232812610,4,5,4.0,9,0.4444444444444444
232876710,1,8,1.0,9,0.1111111111111111
232879337,2,8,2.0,10,0.2
232884300,1,18,1.0,19,0.05263157894736842
232888292,6,4,4.0,10,0.4
232888722,2,8,2.0,10,0.2
232900356,3,6,3.0,9,0.3333333333333333
232901190,1,7,1.0,8,0.125
232912346,1,7,1.0,8,0.125
232926616,2,8,2.0,10,0.2
232930328,3,6,3.0,9,0.3333333333333333
232931536,1,7,1.0,8,0.125
232939266,27,2,2.0,29,0.06896551724137931
232941217,3,5,3.0,8,0.375
232943257,3,6,3.0,9,0.3333333333333333
232945566,5,5,5.0,10,0.5
232948744,6,4,4.0,10,0.4
232948946,3,7,3.0,10,0.3
232978347,3,6,3.0,9,0.3333333333333333
232989649,1,8,1.0,9,0.1111111111111111
233039518,1,17,1.0,18,0.05555555555555555
233047667,1,9,1.0,10,0.1
233111360,4,6,4.0,10,0.4
233159745,2,8,2.0,10,0.2
233200636,21,5,5.0,26,0.19230769230769232
233215295,3,7,3.0,10,0.3
233232263,1,9,1.0,10,0.1
233235602,2,8,2.0,10,0.2
233245363,6,4,4.0,10,0.4
233246925,3,5,3.0,8,0.375
233248076,2,6,2.0,8,0.25
233252201,8,2,2.0,10,0.2
233261749,3,5,3.0,8,0.375
233263791,8,2,2.0,10,0.2
233270046,1,18,1.0,19,0.05263157894736842
233334024,10,20,10.0,30,0.3333333333333333
233366489,1,8,1.0,9,0.1111111111111111
233381318,10,19,10.0,29,0.3448275862068966
233419533,3,25,3.0,28,0.10714285714285714
233419965,2,8,2.0,10,0.2
233447434,2,6,2.0,8,0.25
233468224,3,7,3.0,10,0.3
233494179,2,8,2.0,10,0.2
233521248,1,9,1.0,10,0.1
233541722,1,9,1.0,10,0.1
233563182,5,15,5.0,20,0.25
233565595,1,18,1.0,19,0.05263157894736842
233567116,2,8,2.0,10,0.2
233574914,7,3,3.0,10,0.3
233575400,1,8,1.0,9,0.1111111111111111
233577351,2,17,2.0,19,0.10526315789473684
233577373,1,9,1.0,10,0.1
233580855,2,26,2.0,28,0.07142857142857142
233581608,3,7,3.0,10,0.3
233583640,3,7,3.0,10,0.3
233611368,7,11,7.0,18,0.3888888888888889
233635338,11,17,11.0,28,0.39285714285714285
233652858,1,8,1.0,9,0.1111111111111111
233653809,1,8,1.0,9,0.1111111111111111
233678721,5,5,5.0,10,0.5
233684889,1,7,1.0,8,0.125
233690468,4,5,4.0,9,0.4444444444444444
233693899,4,14,4.0,18,0.2222222222222222
233753526,7,3,3.0,10,0.3
233755653,1,9,1.0,10,0.1
233787298,1,9,1.0,10,0.1
233796390,1,9,1.0,10,0.1
233798054,1,9,1.0,10,0.1
233805089,4,5,4.0,9,0.4444444444444444
233822986,7,2,2.0,9,0.2222222222222222
233823043,2,7,2.0,9,0.2222222222222222
233828214,2,7,2.0,9,0.2222222222222222
233862894,5,5,5.0,10,0.5
233864474,6,4,4.0,10,0.4
233873560,7,3,3.0,10,0.3
233927723,1,8,1.0,9,0.1111111111111111
233928744,7,3,3.0,10,0.3
233931636,1,18,1.0,19,0.05263157894736842
233950319,3,6,3.0,9,0.3333333333333333
233952131,1,7,1.0,8,0.125
233983113,1,8,1.0,9,0.1111111111111111
233983624,1,19,1.0,20,0.05
233989290,1,9,1.0,10,0.1
234008396,6,4,4.0,10,0.4
234052018,1,8,1.0,9,0.1111111111111111
234058802,3,6,3.0,9,0.3333333333333333
234060109,7,22,7.0,29,0.2413793103448276
234119690,5,14,5.0,19,0.2631578947368421
234124074,1,25,1.0,26,0.038461538461538464
234124195,1,9,1.0,10,0.1
234125728,2,26,2.0,28,0.07142857142857142
234125816,1,9,1.0,10,0.1
234126977,4,6,4.0,10,0.4
234142903,1,9,1.0,10,0.1
234154506,2,8,2.0,10,0.2
234158990,6,4,4.0,10,0.4
234176393,1,9,1.0,10,0.1
234179918,4,5,4.0,9,0.4444444444444444
234183537,4,23,4.0,27,0.14814814814814814
234187151,3,6,3.0,9,0.3333333333333333
234200418,1,9,1.0,10,0.1
234208556,2,8,2.0,10,0.2
234228211,1,9,1.0,10,0.1
234237328,1,8,1.0,9,0.1111111111111111
234240421,3,7,3.0,10,0.3
234246461,2,7,2.0,9,0.2222222222222222
234257579,9,1,1.0,10,0.1
234257731,9,20,9.0,29,0.3103448275862069
234294372,4,6,4.0,10,0.4
234301945,1,7,1.0,8,0.125
234302336,4,6,4.0,10,0.4
234303939,5,24,5.0,29,0.1724137931034483
234304176,1,9,1.0,10,0.1
234313457,1,9,1.0,10,0.1
234315545,3,6,3.0,9,0.3333333333333333
234370995,2,27,2.0,29,0.06896551724137931
234371393,3,7,3.0,10,0.3
234377158,25,2,2.0,27,0.07407407407407407
234377364,3,6,3.0,9,0.3333333333333333
234379007,2,8,2.0,10,0.2
234383868,1,8,1.0,9,0.1111111111111111
234384608,1,19,1.0,20,0.05
234391758,1,8,1.0,9,0.1111111111111111
234392105,1,9,1.0,10,0.1
234396164,1,7,1.0,8,0.125
234447890,1,9,1.0,10,0.1
234449647,15,4,4.0,19,0.21052631578947367
234449778,1,8,1.0,9,0.1111111111111111
234452974,1,16,1.0,17,0.058823529411764705
234452995,1,9,1.0,10,0.1
234453543,6,2,2.0,8,0.25
234455204,1,7,1.0,8,0.125
234462672,6,14,6.0,20,0.3
234464942,2,7,2.0,9,0.2222222222222222
234471788,1,9,1.0,10,0.1
234479060,14,15,14.0,29,0.4827586206896552
234484978,1,19,1.0,20,0.05
234485486,4,6,4.0,10,0.4
234485615,3,7,3.0,10,0.3
234548434,1,8,1.0,9,0.1111111111111111
234550234,1,8,1.0,9,0.1111111111111111
234588652,5,5,5.0,10,0.5
234593878,2,8,2.0,10,0.2
234597945,1,9,1.0,10,0.1
234609282,1,9,1.0,10,0.1
234609877,1,7,1.0,8,0.125
234619288,1,9,1.0,10,0.1
234666142,9,1,1.0,10,0.1
234671952,1,17,1.0,18,0.05555555555555555
234674409,2,6,2.0,8,0.25
234691801,1,8,1.0,9,0.1111111111111111
234702353,7,3,3.0,10,0.3
234748552,1,19,1.0,20,0.05
234750070,3,17,3.0,20,0.15
234763773,2,8,2.0,10,0.2
234786304,1,8,1.0,9,0.1111111111111111
234790665,1,8,1.0,9,0.1111111111111111
234798500,5,15,5.0,20,0.25
234801485,3,7,3.0,10,0.3
234806087,1,9,1.0,10,0.1
234807195,2,8,2.0,10,0.2
234844762,1,8,1.0,9,0.1111111111111111
234848233,2,17,2.0,19,0.10526315789473684
234849069,1,9,1.0,10,0.1
234851565,7,2,2.0,9,0.2222222222222222
234857045,1,9,1.0,10,0.1
234863929,1,8,1.0,9,0.1111111111111111
234883410,6,4,4.0,10,0.4
234902504,1,9,1.0,10,0.1
234941160,1,17,1.0,18,0.05555555555555555
234947990,2,8,2.0,10,0.2
234948341,4,6,4.0,10,0.4
234949146,1,19,1.0,20,0.05
234967265,2,6,2.0,8,0.25
234967331,1,9,1.0,10,0.1
234968614,5,5,5.0,10,0.5
234989011,1,8,1.0,9,0.1111111111111111
234989088,1,9,1.0,10,0.1
234989752,1,9,1.0,10,0.1
234992870,6,4,4.0,10,0.4
234997755,3,16,3.0,19,0.15789473684210525
235004846,7,3,3.0,10,0.3
235009501,2,7,2.0,9,0.2222222222222222
235010787,2,8,2.0,10,0.2
235011439,4,6,4.0,10,0.4
235011857,2,8,2.0,10,0.2
235013564,3,26,3.0,29,0.10344827586206896
235018712,1,8,1.0,9,0.1111111111111111
235020788,3,7,3.0,10,0.3
235026227,1,18,1.0,19,0.05263157894736842
235031191,1,18,1.0,19,0.05263157894736842
235036488,1,9,1.0,10,0.1
235039166,1,19,1.0,20,0.05
235046038,1,18,1.0,19,0.05263157894736842
235052595,2,7,2.0,9,0.2222222222222222
235070014,2,7,2.0,9,0.2222222222222222
235073852,2,8,2.0,10,0.2
235080085,2,17,2.0,19,0.10526315789473684
235082004,3,6,3.0,9,0.3333333333333333
235087942,6,22,6.0,28,0.21428571428571427
235107563,2,8,2.0,10,0.2
235110292,1,9,1.0,10,0.1
235111360,2,8,2.0,10,0.2
235111876,2,7,2.0,9,0.2222222222222222
235118555,1,9,1.0,10,0.1
235133478,2,8,2.0,10,0.2
235135059,1,9,1.0,10,0.1
235135182,8,22,8.0,30,0.26666666666666666
235139996,1,9,1.0,10,0.1
235164451,1,8,1.0,9,0.1111111111111111
235168380,3,6,3.0,9,0.3333333333333333
235170724,8,20,8.0,28,0.2857142857142857
235181568,2,8,2.0,10,0.2
235182084,1,9,1.0,10,0.1
235183454,2,18,2.0,20,0.1
235214927,2,8,2.0,10,0.2
235217175,1,8,1.0,9,0.1111111111111111
235218656,6,3,3.0,9,0.3333333333333333
235218737,3,7,3.0,10,0.3
235219002,3,6,3.0,9,0.3333333333333333
235220442,2,7,2.0,9,0.2222222222222222
235221755,1,9,1.0,10,0.1
235223416,1,9,1.0,10,0.1
235230292,4,5,4.0,9,0.4444444444444444
235231932,3,7,3.0,10,0.3
235232233,1,8,1.0,9,0.1111111111111111
235261630,4,6,4.0,10,0.4
235263177,1,27,1.0,28,0.03571428571428571
235264535,4,5,4.0,9,0.4444444444444444
235265852,2,8,2.0,10,0.2
235267250,2,8,2.0,10,0.2
235285653,2,7,2.0,9,0.2222222222222222
235288082,1,9,1.0,10,0.1
235302951,2,7,2.0,9,0.2222222222222222
235305225,3,7,3.0,10,0.3
235364235,5,5,5.0,10,0.5
235376095,1,19,1.0,20,0.05
235411801,1,18,1.0,19,0.05263157894736842
235413624,1,9,1.0,10,0.1
235422053,1,17,1.0,18,0.05555555555555555
235441965,4,6,4.0,10,0.4
235463495,2,6,2.0,8,0.25
235519834,2,8,2.0,10,0.2
235542010,2,8,2.0,10,0.2
235542816,2,7,2.0,9,0.2222222222222222
235586334,4,6,4.0,10,0.4
235608510,1,9,1.0,10,0.1
235613859,1,17,1.0,18,0.05555555555555555
235615519,1,9,1.0,10,0.1
235617184,2,8,2.0,10,0.2
235622961,3,17,3.0,20,0.15
235646857,7,3,3.0,10,0.3
235684842,6,4,4.0,10,0.4
235690050,1,9,1.0,10,0.1
235737865,2,7,2.0,9,0.2222222222222222
235771319,1,8,1.0,9,0.1111111111111111
235777479,1,8,1.0,9,0.1111111111111111
235787056,3,7,3.0,10,0.3
235814317,3,16,3.0,19,0.15789473684210525
235817771,2,8,2.0,10,0.2
235826001,7,3,3.0,10,0.3
235826242,1,9,1.0,10,0.1
235836466,1,27,1.0,28,0.03571428571428571
235844765,19,8,8.0,27,0.2962962962962963
235860217,1,15,1.0,16,0.0625
235869803,1,9,1.0,10,0.1
235877320,26,3,3.0,29,0.10344827586206896
235878254,7,3,3.0,10,0.3
235878445,9,1,1.0,10,0.1
235880078,7,21,7.0,28,0.25
235887627,6,4,4.0,10,0.4
235887999,7,3,3.0,10,0.3
235890547,2,8,2.0,10,0.2
235891656,2,16,2.0,18,0.1111111111111111
235896686,8,2,2.0,10,0.2
235906434,4,5,4.0,9,0.4444444444444444
235909822,1,9,1.0,10,0.1
235920932,3,5,3.0,8,0.375
235922983,1,9,1.0,10,0.1
235941430,3,13,3.0,16,0.1875
235942848,7,2,2.0,9,0.2222222222222222
235944934,1,8,1.0,9,0.1111111111111111
235952857,3,7,3.0,10,0.3
235953980,3,7,3.0,10,0.3
235972593,2,8,2.0,10,0.2
235978034,6,3,3.0,9,0.3333333333333333
236021706,1,8,1.0,9,0.1111111111111111
236056349,1,19,1.0,20,0.05
236057928,1,17,1.0,18,0.05555555555555555
236058040,3,6,3.0,9,0.3333333333333333
236062100,7,3,3.0,10,0.3
236065135,2,8,2.0,10,0.2
236075282,1,9,1.0,10,0.1
236079512,1,9,1.0,10,0.1
236127092,7,3,3.0,10,0.3
236127317,7,2,2.0,9,0.2222222222222222
236164339,2,18,2.0,20,0.1
236199806,3,5,3.0,8,0.375
236237288,1,9,1.0,10,0.1
236267409,1,8,1.0,9,0.1111111111111111
236311828,1,9,1.0,10,0.1
236315446,3,6,3.0,9,0.3333333333333333
236346128,2,8,2.0,10,0.2
236351602,9,1,1.0,10,0.1
236375231,2,6,2.0,8,0.25
236389626,3,5,3.0,8,0.375
236409678,1,18,1.0,19,0.05263157894736842
236449768,12,8,8.0,20,0.4
236451207,18,10,10.0,28,0.35714285714285715
236454913,1,7,1.0,8,0.125
236462043,2,8,2.0,10,0.2
236470807,2,16,2.0,18,0.1111111111111111
236485489,1,9,1.0,10,0.1
236492073,3,7,3.0,10,0.3
236494797,2,15,2.0,17,0.11764705882352941
236502601,19,9,9.0,28,0.32142857142857145
236509284,2,8,2.0,10,0.2
236525764,3,7,3.0,10,0.3
236527723,6,13,6.0,19,0.3157894736842105
236531156,27,2,2.0,29,0.06896551724137931
236539448,1,9,1.0,10,0.1
236562574,2,17,2.0,19,0.10526315789473684
236577309,3,7,3.0,10,0.3
236596064,5,5,5.0,10,0.5
236597043,2,8,2.0,10,0.2
236597403,3,6,3.0,9,0.3333333333333333
236597586,2,7,2.0,9,0.2222222222222222
236638557,1,8,1.0,9,0.1111111111111111
236655919,2,8,2.0,10,0.2
236659039,1,9,1.0,10,0.1
236659877,1,9,1.0,10,0.1
236662044,2,6,2.0,8,0.25
236686039,1,9,1.0,10,0.1
236686165,1,8,1.0,9,0.1111111111111111
236691284,2,18,2.0,20,0.1
236701084,1,8,1.0,9,0.1111111111111111
236708603,9,1,1.0,10,0.1
236763945,1,27,1.0,28,0.03571428571428571
236790955,1,9,1.0,10,0.1
236792744,25,2,2.0,27,0.07407407407407407
236815387,7,1,1.0,8,0.125
236835786,1,9,1.0,10,0.1
236837309,2,8,2.0,10,0.2
236837493,2,8,2.0,10,0.2
236873283,6,3,3.0,9,0.3333333333333333
236891576,17,3,3.0,20,0.15
236924985,1,9,1.0,10,0.1
236937377,3,7,3.0,10,0.3
236942723,9,11,9.0,20,0.45
236971249,1,9,1.0,10,0.1
236994192,2,8,2.0,10,0.2
236996792,9,1,1.0,10,0.1
236997805,6,4,4.0,10,0.4
237004336,1,9,1.0,10,0.1
237007938,6,4,4.0,10,0.4
237010169,3,7,3.0,10,0.3
237011208,8,2,2.0,10,0.2
237011718,3,7,3.0,10,0.3
237019800,4,16,4.0,20,0.2
237024761,1,9,1.0,10,0.1
237039681,2,8,2.0,10,0.2
237044402,1,17,1.0,18,0.05555555555555555
237070526,3,16,3.0,19,0.15789473684210525
237073357,6,4,4.0,10,0.4
237084381,1,9,1.0,10,0.1
237105598,2,8,2.0,10,0.2
237113660,1,9,1.0,10,0.1
237114918,3,6,3.0,9,0.3333333333333333
237126865,5,4,4.0,9,0.4444444444444444
237127125,2,8,2.0,10,0.2
237128244,1,8,1.0,9,0.1111111111111111
237132407,2,7,2.0,9,0.2222222222222222
237186597,1,7,1.0,8,0.125
237213664,2,18,2.0,20,0.1
237244867,3,7,3.0,10,0.3
237249486,7,3,3.0,10,0.3
237268801,2,8,2.0,10,0.2
237269465,6,3,3.0,9,0.3333333333333333
237295877,12,18,12.0,30,0.4
237298254,2,7,2.0,9,0.2222222222222222
237310594,2,15,2.0,17,0.11764705882352941
237325369,6,4,4.0,10,0.4
237325855,20,10,10.0,30,0.3333333333333333
237356371,20,9,9.0,29,0.3103448275862069
237357010,3,7,3.0,10,0.3
237372503,6,2,2.0,8,0.25
237378853,1,9,1.0,10,0.1
237400115,3,7,3.0,10,0.3
237400297,1,9,1.0,10,0.1
237401685,8,2,2.0,10,0.2
237408104,1,9,1.0,10,0.1
237411727,1,7,1.0,8,0.125
237426982,5,4,4.0,9,0.4444444444444444
237429384,2,7,2.0,9,0.2222222222222222
237429819,2,8,2.0,10,0.2
237435125,1,8,1.0,9,0.1111111111111111
237435360,1,9,1.0,10,0.1
237447918,1,9,1.0,10,0.1
237461658,1,9,1.0,10,0.1
237472386,1,9,1.0,10,0.1
237498864,6,3,3.0,9,0.3333333333333333
237499179,4,5,4.0,9,0.4444444444444444
237500155,1,7,1.0,8,0.125
237504944,2,7,2.0,9,0.2222222222222222
237534779,1,9,1.0,10,0.1
237535341,2,7,2.0,9,0.2222222222222222
237536795,21,8,8.0,29,0.27586206896551724
237541210,7,3,3.0,10,0.3
237572943,5,5,5.0,10,0.5
237579295,4,6,4.0,10,0.4
237584330,2,8,2.0,10,0.2
237585055,1,9,1.0,10,0.1
237592434,1,37,1.0,38,0.02631578947368421
237607484,1,8,1.0,9,0.1111111111111111
237616502,4,5,4.0,9,0.4444444444444444
237617796,3,17,3.0,20,0.15
237622461,2,8,2.0,10,0.2
237630762,2,8,2.0,10,0.2
237633742,1,9,1.0,10,0.1
237636927,4,6,4.0,10,0.4
237641774,1,9,1.0,10,0.1
237646380,1,9,1.0,10,0.1
237649418,1,8,1.0,9,0.1111111111111111
237675234,1,16,1.0,17,0.058823529411764705
237678805,5,22,5.0,27,0.18518518518518517
237682125,1,9,1.0,10,0.1
237702963,7,2,2.0,9,0.2222222222222222
237703644,7,1,1.0,8,0.125
237716348,19,11,11.0,30,0.36666666666666664
237752073,1,9,1.0,10,0.1
237793766,2,8,2.0,10,0.2
237809288,2,8,2.0,10,0.2
237815404,1,7,1.0,8,0.125
237828977,1,17,1.0,18,0.05555555555555555
237832443,4,5,4.0,9,0.4444444444444444
237834487,23,5,5.0,28,0.17857142857142858
237859579,2,8,2.0,10,0.2
237870527,3,6,3.0,9,0.3333333333333333
237870927,3,6,3.0,9,0.3333333333333333
237872925,5,4,4.0,9,0.4444444444444444
237873848,4,6,4.0,10,0.4
237893229,1,9,1.0,10,0.1
237933414,1,9,1.0,10,0.1
237949294,3,7,3.0,10,0.3
237960124,1,18,1.0,19,0.05263157894736842
237963298,1,18,1.0,19,0.05263157894736842
237964921,3,6,3.0,9,0.3333333333333333
237966496,1,9,1.0,10,0.1
237971344,3,6,3.0,9,0.3333333333333333
237971591,1,8,1.0,9,0.1111111111111111
237972228,7,3,3.0,10,0.3
237989905,9,1,1.0,10,0.1
237990365,17,11,11.0,28,0.39285714285714285
237990435,4,4,4.0,8,0.5
237995338,5,5,5.0,10,0.5
237996195,5,3,3.0,8,0.375
237996417,2,7,2.0,9,0.2222222222222222
237998771,28,2,2.0,30,0.06666666666666667
238016648,2,8,2.0,10,0.2
238018646,1,17,1.0,18,0.05555555555555555
238043573,3,15,3.0,18,0.16666666666666666
238051082,8,1,1.0,9,0.1111111111111111
238051292,1,16,1.0,17,0.058823529411764705
238067417,7,2,2.0,9,0.2222222222222222
238091364,5,4,4.0,9,0.4444444444444444
238093378,2,8,2.0,10,0.2
238097142,1,17,1.0,18,0.05555555555555555
238100089,9,1,1.0,10,0.1
238102074,4,5,4.0,9,0.4444444444444444
238102400,4,5,4.0,9,0.4444444444444444
238130789,3,7,3.0,10,0.3
238135679,3,24,3.0,27,0.1111111111111111
238136415,3,5,3.0,8,0.375
238137774,2,8,2.0,10,0.2
238140974,2,6,2.0,8,0.25
238158543,3,7,3.0,10,0.3
238168379,3,7,3.0,10,0.3
238171113,2,8,2.0,10,0.2
238190354,2,8,2.0,10,0.2
238198036,1,9,1.0,10,0.1
238243208,2,8,2.0,10,0.2
238254144,2,7,2.0,9,0.2222222222222222
238254959,1,9,1.0,10,0.1
238255465,7,21,7.0,28,0.25
238256765,3,6,3.0,9,0.3333333333333333
238267056,1,19,1.0,20,0.05
238283602,2,7,2.0,9,0.2222222222222222
238283858,1,7,1.0,8,0.125
238298727,3,6,3.0,9,0.3333333333333333
238300606,5,5,5.0,10,0.5
238306413,2,8,2.0,10,0.2
238316490,3,6,3.0,9,0.3333333333333333
238328868,1,9,1.0,10,0.1
238348225,1,18,1.0,19,0.05263157894736842
238392655,1,8,1.0,9,0.1111111111111111
238406036,15,13,13.0,28,0.4642857142857143
238407088,3,7,3.0,10,0.3
238410023,5,24,5.0,29,0.1724137931034483
238415263,2,7,2.0,9,0.2222222222222222
238415976,1,9,1.0,10,0.1
238417542,1,8,1.0,9,0.1111111111111111
238421615,1,9,1.0,10,0.1
238437419,1,9,1.0,10,0.1
238467758,3,6,3.0,9,0.3333333333333333
238470029,6,3,3.0,9,0.3333333333333333
238470698,1,9,1.0,10,0.1
238472678,3,7,3.0,10,0.3
238483414,28,1,1.0,29,0.034482758620689655
238484248,1,9,1.0,10,0.1
238487808,1,9,1.0,10,0.1
238490462,1,18,1.0,19,0.05263157894736842
238505660,1,9,1.0,10,0.1
238507179,3,17,3.0,20,0.15
238507932,7,22,7.0,29,0.2413793103448276
238509345,1,9,1.0,10,0.1
238510425,15,11,11.0,26,0.4230769230769231
238516625,1,9,1.0,10,0.1
238517098,1,9,1.0,10,0.1
238518155,1,7,1.0,8,0.125
238526063,1,9,1.0,10,0.1
238530135,4,6,4.0,10,0.4
238530230,1,19,1.0,20,0.05
238534102,8,2,2.0,10,0.2
238552680,1,9,1.0,10,0.1
238642904,1,7,1.0,8,0.125
238646586,4,6,4.0,10,0.4
238654886,1,9,1.0,10,0.1
238655616,2,8,2.0,10,0.2
238666993,5,5,5.0,10,0.5
238668821,4,6,4.0,10,0.4
238675161,1,9,1.0,10,0.1
238701181,1,9,1.0,10,0.1
238709383,3,7,3.0,10,0.3
238722099,3,26,3.0,29,0.10344827586206896
238737144,1,8,1.0,9,0.1111111111111111
238748980,1,16,1.0,17,0.058823529411764705
238788996,1,8,1.0,9,0.1111111111111111
238795921,8,1,1.0,9,0.1111111111111111
238813364,2,6,2.0,8,0.25
238815202,1,8,1.0,9,0.1111111111111111
238816010,3,27,3.0,30,0.1
238816621,1,9,1.0,10,0.1
238833785,1,8,1.0,9,0.1111111111111111
238839400,1,29,1.0,30,0.03333333333333333
238843005,2,17,2.0,19,0.10526315789473684
238856550,1,18,1.0,19,0.05263157894736842
238859220,3,7,3.0,10,0.3
238860992,6,3,3.0,9,0.3333333333333333
238861056,2,8,2.0,10,0.2
238861533,2,7,2.0,9,0.2222222222222222
238893943,1,9,1.0,10,0.1
238898348,4,5,4.0,9,0.4444444444444444
238901732,3,7,3.0,10,0.3
238926778,1,8,1.0,9,0.1111111111111111
238946242,6,4,4.0,10,0.4
238955349,1,18,1.0,19,0.05263157894736842
238981670,1,8,1.0,9,0.1111111111111111
238983414,1,18,1.0,19,0.05263157894736842
238987509,3,6,3.0,9,0.3333333333333333
238988407,5,4,4.0,9,0.4444444444444444
238995036,1,9,1.0,10,0.1
239006203,2,8,2.0,10,0.2
239013447,3,7,3.0,10,0.3
239014441,4,6,4.0,10,0.4
239018106,19,11,11.0,30,0.36666666666666664
239020207,2,8,2.0,10,0.2
239023162,1,7,1.0,8,0.125
239046788,2,8,2.0,10,0.2
239056561,3,7,3.0,10,0.3
239057101,4,5,4.0,9,0.4444444444444444
239058050,6,4,4.0,10,0.4
239068927,5,4,4.0,9,0.4444444444444444
239089076,3,7,3.0,10,0.3
239130126,1,16,1.0,17,0.058823529411764705
239145273,8,2,2.0,10,0.2
239155740,2,8,2.0,10,0.2
239170549,1,9,1.0,10,0.1
239171113,2,6,2.0,8,0.25
239171820,1,8,1.0,9,0.1111111111111111
239173555,2,7,2.0,9,0.2222222222222222
239174404,5,24,5.0,29,0.1724137931034483
239177168,23,7,7.0,30,0.23333333333333334
239208616,3,7,3.0,10,0.3
239259481,2,7,2.0,9,0.2222222222222222
239287727,1,8,1.0,9,0.1111111111111111
239346678,28,1,1.0,29,0.034482758620689655
239364186,2,15,2.0,17,0.11764705882352941
239373439,4,6,4.0,10,0.4
239384254,1,9,1.0,10,0.1
239386344,8,2,2.0,10,0.2
239387019,8,2,2.0,10,0.2
239389461,8,21,8.0,29,0.27586206896551724
239410200,22,6,6.0,28,0.21428571428571427
239420542,8,1,1.0,9,0.1111111111111111
239429709,4,6,4.0,10,0.4
239458915,1,8,1.0,9,0.1111111111111111
239504766,8,2,2.0,10,0.2
239506219,1,9,1.0,10,0.1
239508443,7,3,3.0,10,0.3
239513186,7,1,1.0,8,0.125
239547656,2,8,2.0,10,0.2
239568074,5,13,5.0,18,0.2777777777777778
239600258,2,8,2.0,10,0.2
239600879,1,7,1.0,8,0.125
239604263,2,8,2.0,10,0.2
239623421,1,18,1.0,19,0.05263157894736842
239628111,7,3,3.0,10,0.3
239650528,1,18,1.0,19,0.05263157894736842
239658420,1,19,1.0,20,0.05
239675557,1,17,1.0,18,0.05555555555555555
239691325,1,9,1.0,10,0.1
239691469,1,8,1.0,9,0.1111111111111111
239707092,5,4,4.0,9,0.4444444444444444
239750954,1,9,1.0,10,0.1
239789311,3,7,3.0,10,0.3
239796329,2,8,2.0,10,0.2
239852360,1,13,1.0,14,0.07142857142857142
239868608,4,15,4.0,19,0.21052631578947367
239888841,8,1,1.0,9,0.1111111111111111
239899730,12,15,12.0,27,0.4444444444444444
239899921,1,9,1.0,10,0.1
239900809,1,9,1.0,10,0.1
239903129,3,6,3.0,9,0.3333333333333333
239909521,1,9,1.0,10,0.1
239912087,1,9,1.0,10,0.1
239918758,1,9,1.0,10,0.1
239920146,1,8,1.0,9,0.1111111111111111
239921955,3,7,3.0,10,0.3
239922129,1,8,1.0,9,0.1111111111111111
239922216,3,7,3.0,10,0.3
239927040,2,17,2.0,19,0.10526315789473684
239945921,1,19,1.0,20,0.05
239967805,2,18,2.0,20,0.1
239995248,2,8,2.0,10,0.2
240030607,4,15,4.0,19,0.21052631578947367
240030739,2,8,2.0,10,0.2
240071486,2,6,2.0,8,0.25
240091005,1,18,1.0,19,0.05263157894736842
240091314,2,7,2.0,9,0.2222222222222222
240116819,6,4,4.0,10,0.4
240125039,2,7,2.0,9,0.2222222222222222
240126490,1,9,1.0,10,0.1
240126782,1,9,1.0,10,0.1
240127231,2,8,2.0,10,0.2
240127303,1,27,1.0,28,0.03571428571428571
240145057,1,19,1.0,20,0.05
240170856,1,9,1.0,10,0.1
240175721,1,8,1.0,9,0.1111111111111111
240217806,1,9,1.0,10,0.1
240217981,5,5,5.0,10,0.5
240220793,3,7,3.0,10,0.3
240224486,2,6,2.0,8,0.25
240235983,6,4,4.0,10,0.4
240247213,6,3,3.0,9,0.3333333333333333
240268486,3,5,3.0,8,0.375
240269500,8,1,1.0,9,0.1111111111111111
240271408,8,2,2.0,10,0.2
240271737,6,3,3.0,9,0.3333333333333333
240273184,7,3,3.0,10,0.3
240276851,18,12,12.0,30,0.4
240282732,1,9,1.0,10,0.1
240311720,7,3,3.0,10,0.3
240332013,4,6,4.0,10,0.4
240354783,1,9,1.0,10,0.1
240358626,8,2,2.0,10,0.2
240361576,21,4,4.0,25,0.16
240364167,14,2,2.0,16,0.125
240376836,2,8,2.0,10,0.2
240377271,2,8,2.0,10,0.2
240387963,1,18,1.0,19,0.05263157894736842
240392964,1,8,1.0,9,0.1111111111111111
240399054,2,6,2.0,8,0.25
240431744,2,7,2.0,9,0.2222222222222222
240472165,1,18,1.0,19,0.05263157894736842
240483455,3,7,3.0,10,0.3
240514897,7,3,3.0,10,0.3
240524638,1,28,1.0,29,0.034482758620689655
240534406,1,9,1.0,10,0.1
240557564,1,9,1.0,10,0.1
240588649,9,1,1.0,10,0.1
240588765,9,1,1.0,10,0.1
240592525,4,6,4.0,10,0.4
240598154,2,28,2.0,30,0.06666666666666667
240600364,2,7,2.0,9,0.2222222222222222
240603461,1,7,1.0,8,0.125
240614758,8,12,8.0,20,0.4
240616459,1,7,1.0,8,0.125
240620368,1,19,1.0,20,0.05
240620896,3,7,3.0,10,0.3
240633599,1,9,1.0,10,0.1
240634200,1,9,1.0,10,0.1
240639487,2,26,2.0,28,0.07142857142857142
240660105,8,1,1.0,9,0.1111111111111111
240667500,1,19,1.0,20,0.05
240670996,1,9,1.0,10,0.1
240674024,2,8,2.0,10,0.2
240679860,6,2,2.0,8,0.25
240684933,1,9,1.0,10,0.1
240686816,2,17,2.0,19,0.10526315789473684
240690393,1,7,1.0,8,0.125
240738273,2,8,2.0,10,0.2
240740330,1,19,1.0,20,0.05
240771927,1,9,1.0,10,0.1
240786909,8,2,2.0,10,0.2
240793848,4,6,4.0,10,0.4
240802170,6,4,4.0,10,0.4
240804975,1,9,1.0,10,0.1
240813008,4,6,4.0,10,0.4
240814057,1,8,1.0,9,0.1111111111111111
240815099,3,7,3.0,10,0.3
240834834,1,18,1.0,19,0.05263157894736842
240839851,1,7,1.0,8,0.125
240860445,1,8,1.0,9,0.1111111111111111
240862781,1,8,1.0,9,0.1111111111111111
240897402,1,9,1.0,10,0.1
240956002,5,5,5.0,10,0.5
240962457,2,7,2.0,9,0.2222222222222222
240964615,2,27,2.0,29,0.06896551724137931
240964706,1,28,1.0,29,0.034482758620689655
240965849,3,7,3.0,10,0.3
241001370,1,18,1.0,19,0.05263157894736842
241067578,2,6,2.0,8,0.25
241069668,1,9,1.0,10,0.1
241088395,1,8,1.0,9,0.1111111111111111
241099767,7,2,2.0,9,0.2222222222222222
241131131,7,12,7.0,19,0.3684210526315789
241131342,3,7,3.0,10,0.3
241133122,9,1,1.0,10,0.1
241134234,8,2,2.0,10,0.2
241135548,2,18,2.0,20,0.1
241136241,2,8,2.0,10,0.2
241152581,15,11,11.0,26,0.4230769230769231
241162225,3,6,3.0,9,0.3333333333333333
241204783,1,18,1.0,19,0.05263157894736842
241218005,1,8,1.0,9,0.1111111111111111
241238125,1,8,1.0,9,0.1111111111111111
241249815,5,4,4.0,9,0.4444444444444444
241249935,4,6,4.0,10,0.4
241250506,9,1,1.0,10,0.1
241250620,9,1,1.0,10,0.1
241252633,4,24,4.0,28,0.14285714285714285
241256756,4,16,4.0,20,0.2
241295362,9,1,1.0,10,0.1
241297393,2,8,2.0,10,0.2
241313168,9,9,9.0,18,0.5
241313396,3,5,3.0,8,0.375
241335920,6,4,4.0,10,0.4
241345262,6,3,3.0,9,0.3333333333333333
241378256,1,19,1.0,20,0.05
241404976,24,6,6.0,30,0.2
241418650,8,2,2.0,10,0.2
241419377,1,9,1.0,10,0.1
241470095,1,9,1.0,10,0.1
241470276,2,8,2.0,10,0.2
241501093,2,7,2.0,9,0.2222222222222222
241509038,1,9,1.0,10,0.1
241512692,5,5,5.0,10,0.5
241514925,6,3,3.0,9,0.3333333333333333
241537163,12,8,8.0,20,0.4
241552424,1,9,1.0,10,0.1
241589850,2,8,2.0,10,0.2
241632683,1,17,1.0,18,0.05555555555555555
241650688,1,7,1.0,8,0.125
241652124,3,7,3.0,10,0.3
241656713,2,8,2.0,10,0.2
241656915,2,8,2.0,10,0.2
241657757,4,5,4.0,9,0.4444444444444444
241667147,9,1,1.0,10,0.1
241680303,1,9,1.0,10,0.1
241681590,8,2,2.0,10,0.2
241682068,9,1,1.0,10,0.1
241686507,3,17,3.0,20,0.15
241695491,2,8,2.0,10,0.2
241696679,5,15,5.0,20,0.25
241723105,17,1,1.0,18,0.05555555555555555
241740267,1,9,1.0,10,0.1
241746462,6,4,4.0,10,0.4
241747124,1,8,1.0,9,0.1111111111111111
241748883,13,16,13.0,29,0.4482758620689655
241752599,1,19,1.0,20,0.05
241772859,1,8,1.0,9,0.1111111111111111
241775902,1,8,1.0,9,0.1111111111111111
241788791,8,2,2.0,10,0.2
241789112,8,1,1.0,9,0.1111111111111111
241807832,1,7,1.0,8,0.125
241817048,1,9,1.0,10,0.1
241836185,1,19,1.0,20,0.05
241838218,9,1,1.0,10,0.1
241838386,26,1,1.0,27,0.037037037037037035
241842179,1,8,1.0,9,0.1111111111111111
241842693,1,9,1.0,10,0.1
241855768,1,9,1.0,10,0.1
241856096,1,9,1.0,10,0.1
241902051,1,9,1.0,10,0.1
241911031,3,7,3.0,10,0.3
241911138,1,7,1.0,8,0.125
241920658,2,8,2.0,10,0.2
241927157,7,3,3.0,10,0.3
241938556,1,9,1.0,10,0.1
241951514,4,6,4.0,10,0.4
241952827,3,16,3.0,19,0.15789473684210525
241965335,1,9,1.0,10,0.1
241976019,1,19,1.0,20,0.05
241978163,1,17,1.0,18,0.05555555555555555
241979164,1,9,1.0,10,0.1
241981243,1,9,1.0,10,0.1
242017975,1,8,1.0,9,0.1111111111111111
242018942,1,8,1.0,9,0.1111111111111111
242029371,1,8,1.0,9,0.1111111111111111
242045765,2,7,2.0,9,0.2222222222222222
242047871,1,19,1.0,20,0.05
242060663,3,5,3.0,8,0.375
242068564,1,18,1.0,19,0.05263157894736842
242070135,1,8,1.0,9,0.1111111111111111
242070777,1,8,1.0,9,0.1111111111111111
242077714,1,9,1.0,10,0.1
242086277,1,9,1.0,10,0.1
242089125,5,5,5.0,10,0.5
242090239,1,8,1.0,9,0.1111111111111111
242092010,1,9,1.0,10,0.1
242119404,8,1,1.0,9,0.1111111111111111
242123125,9,1,1.0,10,0.1
242127766,1,16,1.0,17,0.058823529411764705
242163671,1,8,1.0,9,0.1111111111111111
242167991,3,17,3.0,20,0.15
242169745,7,2,2.0,9,0.2222222222222222
242181244,1,17,1.0,18,0.05555555555555555
242198069,2,7,2.0,9,0.2222222222222222
242204019,7,2,2.0,9,0.2222222222222222
242220769,1,9,1.0,10,0.1
242223893,23,4,4.0,27,0.14814814814814814
242241357,1,9,1.0,10,0.1
242264480,2,16,2.0,18,0.1111111111111111
242272906,12,18,12.0,30,0.4
242273210,1,9,1.0,10,0.1
242281276,1,9,1.0,10,0.1
242299050,2,7,2.0,9,0.2222222222222222
242302152,1,8,1.0,9,0.1111111111111111
242374090,18,8,8.0,26,0.3076923076923077
242374200,2,7,2.0,9,0.2222222222222222
242401896,2,8,2.0,10,0.2
242416250,1,8,1.0,9,0.1111111111111111
242462076,1,9,1.0,10,0.1
242470982,9,1,1.0,10,0.1
242498631,7,3,3.0,10,0.3
242502678,1,8,1.0,9,0.1111111111111111
242507568,1,9,1.0,10,0.1
242524246,14,12,12.0,26,0.46153846153846156
242527132,1,18,1.0,19,0.05263157894736842
242532867,1,9,1.0,10,0.1
242543148,3,6,3.0,9,0.3333333333333333
242543572,5,4,4.0,9,0.4444444444444444
242543855,3,7,3.0,10,0.3
242564141,24,4,4.0,28,0.14285714285714285
242567740,9,1,1.0,10,0.1
242578795,1,9,1.0,10,0.1
242579366,1,9,1.0,10,0.1
242591780,3,5,3.0,8,0.375
242591983,1,8,1.0,9,0.1111111111111111
242593059,23,6,6.0,29,0.20689655172413793
242593583,7,23,7.0,30,0.23333333333333334
242594162,3,6,3.0,9,0.3333333333333333
242600940,5,5,5.0,10,0.5
242601783,5,5,5.0,10,0.5
242631134,1,9,1.0,10,0.1
242660126,2,8,2.0,10,0.2
242669723,5,5,5.0,10,0.5
242675042,26,4,4.0,30,0.13333333333333333
242687849,6,3,3.0,9,0.3333333333333333
242688362,2,7,2.0,9,0.2222222222222222
242689736,1,8,1.0,9,0.1111111111111111
242699854,1,8,1.0,9,0.1111111111111111
242701002,4,6,4.0,10,0.4
242733943,5,14,5.0,19,0.2631578947368421
242743994,26,2,2.0,28,0.07142857142857142
242750548,2,8,2.0,10,0.2
242776044,4,6,4.0,10,0.4
242778093,3,7,3.0,10,0.3
242825222,2,8,2.0,10,0.2
242854020,1,9,1.0,10,0.1
242877568,4,5,4.0,9,0.4444444444444444
242894248,2,8,2.0,10,0.2
242895981,1,7,1.0,8,0.125
242897299,6,20,6.0,26,0.23076923076923078
242898412,1,9,1.0,10,0.1
242907927,12,7,7.0,19,0.3684210526315789
242912129,1,9,1.0,10,0.1
242929003,1,8,1.0,9,0.1111111111111111
242933911,5,5,5.0,10,0.5
242983951,1,9,1.0,10,0.1
242985919,1,9,1.0,10,0.1
242987192,2,18,2.0,20,0.1
243010485,1,8,1.0,9,0.1111111111111111
243023172,1,17,1.0,18,0.05555555555555555
243024809,1,9,1.0,10,0.1
243028323,4,5,4.0,9,0.4444444444444444
243030996,2,8,2.0,10,0.2
243050517,1,17,1.0,18,0.05555555555555555
243055014,13,7,7.0,20,0.35
243060929,2,7,2.0,9,0.2222222222222222
243075987,1,8,1.0,9,0.1111111111111111
243118660,8,1,1.0,9,0.1111111111111111
243160859,25,4,4.0,29,0.13793103448275862
243179106,2,7,2.0,9,0.2222222222222222
243179499,4,5,4.0,9,0.4444444444444444
243189183,1,9,1.0,10,0.1
243194456,4,6,4.0,10,0.4
243195501,1,8,1.0,9,0.1111111111111111
243201118,3,6,3.0,9,0.3333333333333333
243210653,4,5,4.0,9,0.4444444444444444
243217360,5,5,5.0,10,0.5
243228988,2,8,2.0,10,0.2
243231871,6,2,2.0,8,0.25
243233269,7,3,3.0,10,0.3
243237489,4,14,4.0,18,0.2222222222222222
243237892,2,8,2.0,10,0.2
243241867,1,9,1.0,10,0.1
243242119,5,24,5.0,29,0.1724137931034483
243256139,1,9,1.0,10,0.1
243256439,9,11,9.0,20,0.45
243287763,1,18,1.0,19,0.05263157894736842
243303058,4,6,4.0,10,0.4
243338402,2,8,2.0,10,0.2
243345163,1,18,1.0,19,0.05263157894736842
243349839,5,5,5.0,10,0.5
243350147,6,4,4.0,10,0.4
243369709,1,8,1.0,9,0.1111111111111111
243399741,2,8,2.0,10,0.2
243422779,4,5,4.0,9,0.4444444444444444
243443551,6,4,4.0,10,0.4
243465464,1,16,1.0,17,0.058823529411764705
243465701,2,7,2.0,9,0.2222222222222222
243473478,1,7,1.0,8,0.125
243473635,2,7,2.0,9,0.2222222222222222
243476364,2,7,2.0,9,0.2222222222222222
243486021,2,18,2.0,20,0.1
243486088,1,9,1.0,10,0.1
243488495,4,6,4.0,10,0.4
243490749,7,2,2.0,9,0.2222222222222222
243495729,8,2,2.0,10,0.2
243539463,3,7,3.0,10,0.3
243546283,2,17,2.0,19,0.10526315789473684
243551311,1,9,1.0,10,0.1
243561233,1,8,1.0,9,0.1111111111111111
243564005,7,2,2.0,9,0.2222222222222222
243572437,1,8,1.0,9,0.1111111111111111
243576965,4,6,4.0,10,0.4
243581271,1,9,1.0,10,0.1
243588252,1,8,1.0,9,0.1111111111111111
243592293,1,16,1.0,17,0.058823529411764705
243594604,5,5,5.0,10,0.5
243672435,1,9,1.0,10,0.1
243672619,5,4,4.0,9,0.4444444444444444
243673653,1,9,1.0,10,0.1
243675567,2,7,2.0,9,0.2222222222222222
243702841,1,9,1.0,10,0.1
243730136,1,8,1.0,9,0.1111111111111111
243738448,5,4,4.0,9,0.4444444444444444
243767206,6,3,3.0,9,0.3333333333333333
243775267,1,8,1.0,9,0.1111111111111111
243840520,5,5,5.0,10,0.5
243882024,3,15,3.0,18,0.16666666666666666
243946684,5,5,5.0,10,0.5
243948145,9,1,1.0,10,0.1
243958722,2,6,2.0,8,0.25
243960923,1,8,1.0,9,0.1111111111111111
243995194,2,8,2.0,10,0.2
244001166,1,8,1.0,9,0.1111111111111111
244006352,9,1,1.0,10,0.1
244034645,1,8,1.0,9,0.1111111111111111
244038697,4,6,4.0,10,0.4
244051408,2,7,2.0,9,0.2222222222222222
244090861,2,28,2.0,30,0.06666666666666667
244153863,7,3,3.0,10,0.3
244154703,4,5,4.0,9,0.4444444444444444
244175178,6,2,2.0,8,0.25
244175990,9,1,1.0,10,0.1
244192318,7,3,3.0,10,0.3
244201424,4,5,4.0,9,0.4444444444444444
244202481,1,9,1.0,10,0.1
244214301,1,8,1.0,9,0.1111111111111111
244214539,1,8,1.0,9,0.1111111111111111
244226718,6,4,4.0,10,0.4
244236300,1,18,1.0,19,0.05263157894736842
244244315,2,7,2.0,9,0.2222222222222222
244268340,1,9,1.0,10,0.1
244274078,8,2,2.0,10,0.2
244325978,1,19,1.0,20,0.05
244378766,5,5,5.0,10,0.5
244381007,3,7,3.0,10,0.3
244381502,2,7,2.0,9,0.2222222222222222
244381798,3,7,3.0,10,0.3
244400473,7,3,3.0,10,0.3
244407478,5,5,5.0,10,0.5
244407932,19,9,9.0,28,0.32142857142857145
244408233,1,9,1.0,10,0.1
244408583,1,9,1.0,10,0.1
244468336,2,8,2.0,10,0.2
244469215,1,7,1.0,8,0.125
244482621,3,7,3.0,10,0.3
244482685,8,1,1.0,9,0.1111111111111111
244488787,22,1,1.0,23,0.043478260869565216
244501676,1,8,1.0,9,0.1111111111111111
244501921,1,9,1.0,10,0.1
244511272,1,18,1.0,19,0.05263157894736842
244511780,2,7,2.0,9,0.2222222222222222
244517858,1,9,1.0,10,0.1
244533464,1,9,1.0,10,0.1
244541292,2,8,2.0,10,0.2
244541550,1,8,1.0,9,0.1111111111111111
244556999,1,7,1.0,8,0.125
244586952,1,7,1.0,8,0.125
244595987,5,5,5.0,10,0.5
244598482,7,3,3.0,10,0.3
244609023,5,5,5.0,10,0.5
244620791,2,8,2.0,10,0.2
244630923,3,7,3.0,10,0.3
244632187,4,6,4.0,10,0.4
244632561,2,8,2.0,10,0.2
244633160,3,7,3.0,10,0.3
244649197,1,9,1.0,10,0.1
244663646,2,8,2.0,10,0.2
244667712,1,8,1.0,9,0.1111111111111111
244709160,3,5,3.0,8,0.375
244713566,6,2,2.0,8,0.25
244713671,3,6,3.0,9,0.3333333333333333
244718863,22,7,7.0,29,0.2413793103448276
244726585,2,8,2.0,10,0.2
244778025,8,11,8.0,19,0.42105263157894735
244782038,2,6,2.0,8,0.25
244798394,1,18,1.0,19,0.05263157894736842
244803901,6,2,2.0,8,0.25
244830450,1,8,1.0,9,0.1111111111111111
244830591,1,9,1.0,10,0.1
244833687,2,6,2.0,8,0.25
244834572,11,15,11.0,26,0.4230769230769231
244834590,6,4,4.0,10,0.4
244834788,6,4,4.0,10,0.4
244837969,2,15,2.0,17,0.11764705882352941
244839681,3,7,3.0,10,0.3
244846206,8,2,2.0,10,0.2
244847752,1,8,1.0,9,0.1111111111111111
244859946,2,6,2.0,8,0.25
244889581,1,18,1.0,19,0.05263157894736842
244892270,1,18,1.0,19,0.05263157894736842
244892444,9,18,9.0,27,0.3333333333333333
244946789,1,9,1.0,10,0.1
244948994,3,17,3.0,20,0.15
244960095,2,7,2.0,9,0.2222222222222222
244963821,1,9,1.0,10,0.1
244965550,3,7,3.0,10,0.3
244967187,2,8,2.0,10,0.2
244976154,6,13,6.0,19,0.3157894736842105
244976339,4,5,4.0,9,0.4444444444444444
244993215,1,9,1.0,10,0.1
244993884,1,9,1.0,10,0.1
244998859,8,1,1.0,9,0.1111111111111111
245010510,2,8,2.0,10,0.2
245011233,2,8,2.0,10,0.2
245012593,5,4,4.0,9,0.4444444444444444
245012894,1,9,1.0,10,0.1
245013002,6,4,4.0,10,0.4
245013255,7,2,2.0,9,0.2222222222222222
245014710,7,1,1.0,8,0.125
245022768,9,19,9.0,28,0.32142857142857145
245040805,2,8,2.0,10,0.2
245040958,6,4,4.0,10,0.4
245045081,2,18,2.0,20,0.1
245046939,1,18,1.0,19,0.05263157894736842
245094690,6,3,3.0,9,0.3333333333333333
245101840,1,9,1.0,10,0.1
245104222,2,6,2.0,8,0.25
245112186,1,8,1.0,9,0.1111111111111111
245113354,3,16,3.0,19,0.15789473684210525
245116180,3,6,3.0,9,0.3333333333333333
245119990,8,1,1.0,9,0.1111111111111111
245120464,1,9,1.0,10,0.1
245121139,3,6,3.0,9,0.3333333333333333
245143216,2,7,2.0,9,0.2222222222222222
245143615,4,6,4.0,10,0.4
245156366,1,17,1.0,18,0.05555555555555555
245171568,5,4,4.0,9,0.4444444444444444
245177782,1,9,1.0,10,0.1
245180041,1,9,1.0,10,0.1
245247008,3,7,3.0,10,0.3
245269667,5,4,4.0,9,0.4444444444444444
245316364,3,6,3.0,9,0.3333333333333333
245324676,4,6,4.0,10,0.4
245326230,1,9,1.0,10,0.1
245326834,1,28,1.0,29,0.034482758620689655
245329139,1,19,1.0,20,0.05
245342962,3,7,3.0,10,0.3
245352981,1,9,1.0,10,0.1
245361420,1,19,1.0,20,0.05
245380597,7,1,1.0,8,0.125
245384367,4,15,4.0,19,0.21052631578947367
245384624,1,8,1.0,9,0.1111111111111111
245394234,1,19,1.0,20,0.05
245408315,9,1,1.0,10,0.1
245408997,9,1,1.0,10,0.1
245429786,1,17,1.0,18,0.05555555555555555
245437954,1,9,1.0,10,0.1
245455198,1,18,1.0,19,0.05263157894736842
245462767,1,9,1.0,10,0.1
245465666,4,5,4.0,9,0.4444444444444444
245465857,1,19,1.0,20,0.05
245473951,1,9,1.0,10,0.1
245498631,1,9,1.0,10,0.1
245507813,3,16,3.0,19,0.15789473684210525
245518062,2,7,2.0,9,0.2222222222222222
245522701,1,8,1.0,9,0.1111111111111111
245526113,3,6,3.0,9,0.3333333333333333
245527819,2,7,2.0,9,0.2222222222222222
245530864,3,7,3.0,10,0.3
245531366,2,6,2.0,8,0.25
245533100,1,9,1.0,10,0.1
245536014,1,7,1.0,8,0.125
245539022,3,6,3.0,9,0.3333333333333333
245544689,12,17,12.0,29,0.41379310344827586
245551369,7,20,7.0,27,0.25925925925925924
245559163,5,5,5.0,10,0.5
245569618,1,19,1.0,20,0.05
245574189,3,6,3.0,9,0.3333333333333333
245584829,2,7,2.0,9,0.2222222222222222
245662713,1,8,1.0,9,0.1111111111111111
245663260,1,9,1.0,10,0.1
245664007,8,1,1.0,9,0.1111111111111111
245693478,1,9,1.0,10,0.1
245702333,6,4,4.0,10,0.4
245715724,1,8,1.0,9,0.1111111111111111
245717692,1,9,1.0,10,0.1
245731123,2,8,2.0,10,0.2
245737821,2,8,2.0,10,0.2
245738020,1,9,1.0,10,0.1
245738806,1,8,1.0,9,0.1111111111111111
245739367,5,5,5.0,10,0.5
245762589,1,18,1.0,19,0.05263157894736842
245821363,1,8,1.0,9,0.1111111111111111
245822535,4,6,4.0,10,0.4
245823547,1,7,1.0,8,0.125
245865101,1,9,1.0,10,0.1
245873503,1,9,1.0,10,0.1
245873888,7,1,1.0,8,0.125
245876749,7,12,7.0,19,0.3684210526315789
245886759,1,8,1.0,9,0.1111111111111111
245886926,2,8,2.0,10,0.2
245889635,1,9,1.0,10,0.1
245893657,2,8,2.0,10,0.2
245897456,2,8,2.0,10,0.2
245905876,5,5,5.0,10,0.5
245917454,1,9,1.0,10,0.1
245931819,3,7,3.0,10,0.3
245936755,7,3,3.0,10,0.3
245936940,4,4,4.0,8,0.5
245940953,4,4,4.0,8,0.5
245941306,2,8,2.0,10,0.2
245943878,3,7,3.0,10,0.3
245945483,1,9,1.0,10,0.1
245946067,4,4,4.0,8,0.5
245946719,2,7,2.0,9,0.2222222222222222
245949402,1,9,1.0,10,0.1
245973429,3,7,3.0,10,0.3
245978130,1,7,1.0,8,0.125
246024351,7,3,3.0,10,0.3
246035433,5,5,5.0,10,0.5
246044556,2,6,2.0,8,0.25
246045837,4,5,4.0,9,0.4444444444444444
246046151,5,23,5.0,28,0.17857142857142858
246095531,3,7,3.0,10,0.3
246095681,1,9,1.0,10,0.1
246109144,4,6,4.0,10,0.4
246163491,3,7,3.0,10,0.3
246173530,3,7,3.0,10,0.3
246180862,1,9,1.0,10,0.1
246188155,1,9,1.0,10,0.1
246194531,7,21,7.0,28,0.25
246197580,4,6,4.0,10,0.4
246203160,1,27,1.0,28,0.03571428571428571
246205606,1,9,1.0,10,0.1
246209844,2,18,2.0,20,0.1
246212008,1,9,1.0,10,0.1
246217973,4,5,4.0,9,0.4444444444444444
246218369,6,2,2.0,8,0.25
246223486,1,17,1.0,18,0.05555555555555555
246225512,1,8,1.0,9,0.1111111111111111
246225873,8,1,1.0,9,0.1111111111111111
246229079,1,9,1.0,10,0.1
246238447,1,9,1.0,10,0.1
246241835,8,2,2.0,10,0.2
246251064,6,3,3.0,9,0.3333333333333333
246271585,2,16,2.0,18,0.1111111111111111
246311016,1,17,1.0,18,0.05555555555555555
246317784,2,14,2.0,16,0.125
246374566,4,12,4.0,16,0.25
246413116,7,2,2.0,9,0.2222222222222222
246437913,6,4,4.0,10,0.4
246438365,7,3,3.0,10,0.3
246460482,4,5,4.0,9,0.4444444444444444
246463944,1,19,1.0,20,0.05
246478853,1,19,1.0,20,0.05
246489709,1,9,1.0,10,0.1
246490426,1,9,1.0,10,0.1
246497297,3,15,3.0,18,0.16666666666666666
246521278,5,3,3.0,8,0.375
246545388,1,9,1.0,10,0.1
246573122,1,18,1.0,19,0.05263157894736842
246579191,3,6,3.0,9,0.3333333333333333
246579475,1,9,1.0,10,0.1
246588669,1,27,1.0,28,0.03571428571428571
246590060,1,27,1.0,28,0.03571428571428571
246592373,5,4,4.0,9,0.4444444444444444
246594518,4,16,4.0,20,0.2
246618280,8,1,1.0,9,0.1111111111111111
246628650,1,28,1.0,29,0.034482758620689655
246638724,2,8,2.0,10,0.2
246643899,1,9,1.0,10,0.1
246663660,2,8,2.0,10,0.2
246689860,8,2,2.0,10,0.2
246701640,3,16,3.0,19,0.15789473684210525
246720663,4,5,4.0,9,0.4444444444444444
246748880,1,9,1.0,10,0.1
246751620,1,9,1.0,10,0.1
246757906,1,9,1.0,10,0.1
246762769,1,9,1.0,10,0.1
246764333,8,21,8.0,29,0.27586206896551724
246765011,5,4,4.0,9,0.4444444444444444
246765600,6,4,4.0,10,0.4
246765795,6,3,3.0,9,0.3333333333333333
246778765,15,11,11.0,26,0.4230769230769231
246779386,8,1,1.0,9,0.1111111111111111
246779898,9,1,1.0,10,0.1
246788217,1,8,1.0,9,0.1111111111111111
246793639,1,8,1.0,9,0.1111111111111111
246794210,1,19,1.0,20,0.05
246805363,1,25,1.0,26,0.038461538461538464
246807504,7,3,3.0,10,0.3
246816318,2,8,2.0,10,0.2
246845727,8,18,8.0,26,0.3076923076923077
246847635,4,16,4.0,20,0.2
246854657,1,8,1.0,9,0.1111111111111111
246865121,1,9,1.0,10,0.1
246884411,14,13,13.0,27,0.48148148148148145
246914651,3,7,3.0,10,0.3
246926721,2,7,2.0,9,0.2222222222222222
246938792,1,9,1.0,10,0.1
246998580,1,9,1.0,10,0.1
247001620,5,5,5.0,10,0.5
247003781,1,9,1.0,10,0.1
247051362,2,7,2.0,9,0.2222222222222222
247068698,2,8,2.0,10,0.2
247069229,1,9,1.0,10,0.1
247079541,18,11,11.0,29,0.3793103448275862
247079880,6,4,4.0,10,0.4
247080015,7,3,3.0,10,0.3
247094537,3,7,3.0,10,0.3
247111149,8,2,2.0,10,0.2
247118050,1,9,1.0,10,0.1
247133404,1,8,1.0,9,0.1111111111111111
247143010,3,7,3.0,10,0.3
247143102,1,8,1.0,9,0.1111111111111111
247180446,1,9,1.0,10,0.1
247193647,1,9,1.0,10,0.1
247196593,1,9,1.0,10,0.1
247198643,3,7,3.0,10,0.3
247204997,1,9,1.0,10,0.1
247207821,1,9,1.0,10,0.1
247225533,9,1,1.0,10,0.1
247226327,2,8,2.0,10,0.2
247227457,3,6,3.0,9,0.3333333333333333
247229160,6,4,4.0,10,0.4
247230177,5,4,4.0,9,0.4444444444444444
247231629,4,25,4.0,29,0.13793103448275862
247238059,1,8,1.0,9,0.1111111111111111
247241127,6,3,3.0,9,0.3333333333333333
247248420,2,17,2.0,19,0.10526315789473684
247256808,14,15,14.0,29,0.4827586206896552
247267016,1,27,1.0,28,0.03571428571428571
247285209,3,17,3.0,20,0.15
247298997,9,10,9.0,19,0.47368421052631576
247316665,1,8,1.0,9,0.1111111111111111
247317887,1,7,1.0,8,0.125
247329632,3,6,3.0,9,0.3333333333333333
247343993,1,9,1.0,10,0.1
247344301,4,6,4.0,10,0.4
247380602,1,17,1.0,18,0.05555555555555555
247385172,3,7,3.0,10,0.3
247440282,1,8,1.0,9,0.1111111111111111
247465713,1,9,1.0,10,0.1
247477112,1,7,1.0,8,0.125
247501937,1,9,1.0,10,0.1
247511378,4,4,4.0,8,0.5
247511571,5,5,5.0,10,0.5
247511765,9,1,1.0,10,0.1
247511943,5,4,4.0,9,0.4444444444444444
247535635,5,13,5.0,18,0.2777777777777778
247542245,1,9,1.0,10,0.1
247548055,3,16,3.0,19,0.15789473684210525
247548668,1,9,1.0,10,0.1
247557115,2,7,2.0,9,0.2222222222222222
247562294,5,4,4.0,9,0.4444444444444444
247567827,9,1,1.0,10,0.1
247567915,7,3,3.0,10,0.3
247588917,23,7,7.0,30,0.23333333333333334
247646994,6,4,4.0,10,0.4
247651616,4,5,4.0,9,0.4444444444444444
247682770,4,4,4.0,8,0.5
247684060,12,17,12.0,29,0.41379310344827586
247684721,1,8,1.0,9,0.1111111111111111
247687630,1,9,1.0,10,0.1
247707962,2,7,2.0,9,0.2222222222222222
247747809,7,1,1.0,8,0.125
247795696,1,19,1.0,20,0.05
247827959,1,19,1.0,20,0.05
247848229,1,8,1.0,9,0.1111111111111111
247894443,9,10,9.0,19,0.47368421052631576
247911528,9,1,1.0,10,0.1
247976098,14,3,3.0,17,0.17647058823529413
248006827,2,8,2.0,10,0.2
248036618,4,5,4.0,9,0.4444444444444444
248041010,4,6,4.0,10,0.4
248041911,27,1,1.0,28,0.03571428571428571
248042765,9,1,1.0,10,0.1
248051177,1,7,1.0,8,0.125
248066872,3,27,3.0,30,0.1
248067702,4,6,4.0,10,0.4
248068472,1,8,1.0,9,0.1111111111111111
248069192,1,8,1.0,9,0.1111111111111111
248070593,3,5,3.0,8,0.375
248085901,1,9,1.0,10,0.1
248090251,2,15,2.0,17,0.11764705882352941
248107476,8,2,2.0,10,0.2
248113490,7,19,7.0,26,0.2692307692307692
248148433,1,18,1.0,19,0.05263157894736842
248165250,1,9,1.0,10,0.1
248191853,2,17,2.0,19,0.10526315789473684
248221130,1,9,1.0,10,0.1
248259355,1,9,1.0,10,0.1
248271189,1,9,1.0,10,0.1
248278033,4,6,4.0,10,0.4
248293189,2,7,2.0,9,0.2222222222222222
248293915,2,8,2.0,10,0.2
248296860,3,5,3.0,8,0.375
248309820,1,8,1.0,9,0.1111111111111111
248310115,1,9,1.0,10,0.1
248310867,3,7,3.0,10,0.3
248355316,5,5,5.0,10,0.5
248357979,6,12,6.0,18,0.3333333333333333
248360594,1,8,1.0,9,0.1111111111111111
248365699,6,3,3.0,9,0.3333333333333333
248382450,6,13,6.0,19,0.3157894736842105
248438171,1,9,1.0,10,0.1
248453720,4,6,4.0,10,0.4
248453830,2,8,2.0,10,0.2
248454489,1,9,1.0,10,0.1
248466244,2,8,2.0,10,0.2
248476310,4,5,4.0,9,0.4444444444444444
248488078,2,18,2.0,20,0.1
248488290,5,4,4.0,9,0.4444444444444444
248488671,2,7,2.0,9,0.2222222222222222
248492898,2,8,2.0,10,0.2
248509493,4,15,4.0,19,0.21052631578947367
248516182,1,18,1.0,19,0.05263157894736842
248538142,4,14,4.0,18,0.2222222222222222
248541285,7,2,2.0,9,0.2222222222222222
248552182,5,5,5.0,10,0.5
248558228,6,3,3.0,9,0.3333333333333333
248563045,7,21,7.0,28,0.25
248568393,1,7,1.0,8,0.125
248572041,2,15,2.0,17,0.11764705882352941
248581407,7,1,1.0,8,0.125
248581590,7,3,3.0,10,0.3
248584858,1,9,1.0,10,0.1
248601356,2,18,2.0,20,0.1
248633283,1,7,1.0,8,0.125
248634219,1,7,1.0,8,0.125
248644250,2,6,2.0,8,0.25
248644994,1,9,1.0,10,0.1
248651182,8,1,1.0,9,0.1111111111111111
248659588,1,7,1.0,8,0.125
248666319,1,9,1.0,10,0.1
248668300,1,18,1.0,19,0.05263157894736842
248686278,6,4,4.0,10,0.4
248693463,1,8,1.0,9,0.1111111111111111
248702015,9,1,1.0,10,0.1
248702144,7,1,1.0,8,0.125
248710957,1,18,1.0,19,0.05263157894736842
248711917,3,7,3.0,10,0.3
248718840,2,8,2.0,10,0.2
248725493,1,17,1.0,18,0.05555555555555555
248731764,1,9,1.0,10,0.1
248736948,1,18,1.0,19,0.05263157894736842
248775843,1,8,1.0,9,0.1111111111111111
248776104,8,12,8.0,20,0.4
248788854,4,5,4.0,9,0.4444444444444444
248789206,7,3,3.0,10,0.3
248805388,2,18,2.0,20,0.1
248818354,1,8,1.0,9,0.1111111111111111
248823403,1,8,1.0,9,0.1111111111111111
248867267,22,5,5.0,27,0.18518518518518517
248886665,3,6,3.0,9,0.3333333333333333
248895465,7,3,3.0,10,0.3
248919466,4,16,4.0,20,0.2
248941077,1,8,1.0,9,0.1111111111111111
248942840,3,26,3.0,29,0.10344827586206896
248944814,8,2,2.0,10,0.2
248945902,2,8,2.0,10,0.2
248946224,8,2,2.0,10,0.2
248946576,8,1,1.0,9,0.1111111111111111
248947895,4,6,4.0,10,0.4
248948486,8,1,1.0,9,0.1111111111111111
248949991,1,8,1.0,9,0.1111111111111111
248950323,3,6,3.0,9,0.3333333333333333
248958168,2,16,2.0,18,0.1111111111111111
248960864,5,5,5.0,10,0.5
248961033,9,1,1.0,10,0.1
248969429,1,9,1.0,10,0.1
248977170,6,4,4.0,10,0.4
248977312,7,3,3.0,10,0.3
248984888,2,7,2.0,9,0.2222222222222222
248992423,1,9,1.0,10,0.1
248994476,2,7,2.0,9,0.2222222222222222
249012230,10,9,9.0,19,0.47368421052631576
249014966,20,2,2.0,22,0.09090909090909091
249018975,7,1,1.0,8,0.125
249025286,3,6,3.0,9,0.3333333333333333
249026589,1,9,1.0,10,0.1
249031869,2,7,2.0,9,0.2222222222222222
249044190,1,8,1.0,9,0.1111111111111111
249046983,1,8,1.0,9,0.1111111111111111
249077277,4,5,4.0,9,0.4444444444444444
249077956,8,1,1.0,9,0.1111111111111111
249117193,1,27,1.0,28,0.03571428571428571
249119766,7,2,2.0,9,0.2222222222222222
249120088,1,9,1.0,10,0.1
249122426,1,8,1.0,9,0.1111111111111111
249135853,1,27,1.0,28,0.03571428571428571
249136254,7,1,1.0,8,0.125
249145643,2,8,2.0,10,0.2
249161309,1,9,1.0,10,0.1
249175694,1,9,1.0,10,0.1
249184987,3,7,3.0,10,0.3
249190216,2,8,2.0,10,0.2
249207344,5,5,5.0,10,0.5
249209976,8,1,1.0,9,0.1111111111111111
249220940,2,7,2.0,9,0.2222222222222222
249222159,1,8,1.0,9,0.1111111111111111
249222495,1,8,1.0,9,0.1111111111111111
249227158,1,9,1.0,10,0.1
249233149,1,8,1.0,9,0.1111111111111111
249252584,1,8,1.0,9,0.1111111111111111
249259455,1,8,1.0,9,0.1111111111111111
249266749,1,9,1.0,10,0.1
249298132,1,7,1.0,8,0.125
249309455,1,9,1.0,10,0.1
249311540,1,9,1.0,10,0.1
249312324,3,15,3.0,18,0.16666666666666666
249313708,1,9,1.0,10,0.1
249325790,1,9,1.0,10,0.1
249330946,9,1,1.0,10,0.1
249332256,1,8,1.0,9,0.1111111111111111
249333560,3,6,3.0,9,0.3333333333333333
249351217,2,8,2.0,10,0.2
249363126,2,18,2.0,20,0.1
249376777,2,8,2.0,10,0.2
249391083,2,6,2.0,8,0.25
249435340,7,22,7.0,29,0.2413793103448276
249438640,9,1,1.0,10,0.1
249456639,3,26,3.0,29,0.10344827586206896
249470531,2,7,2.0,9,0.2222222222222222
249513386,1,9,1.0,10,0.1
249522607,1,9,1.0,10,0.1
249529156,1,19,1.0,20,0.05
249541247,1,9,1.0,10,0.1
249548275,1,19,1.0,20,0.05
249570757,1,9,1.0,10,0.1
249606461,3,6,3.0,9,0.3333333333333333
249624938,2,7,2.0,9,0.2222222222222222
249630877,1,18,1.0,19,0.05263157894736842
249647129,9,1,1.0,10,0.1
249647909,1,9,1.0,10,0.1
249666122,1,9,1.0,10,0.1
249666646,7,3,3.0,10,0.3
249683284,1,9,1.0,10,0.1
249685749,1,9,1.0,10,0.1
249690117,1,9,1.0,10,0.1
249691877,2,8,2.0,10,0.2
249696099,9,1,1.0,10,0.1
249696656,1,8,1.0,9,0.1111111111111111
249698868,5,5,5.0,10,0.5
249699784,1,9,1.0,10,0.1
249723120,1,8,1.0,9,0.1111111111111111
249725516,4,6,4.0,10,0.4
249729569,4,6,4.0,10,0.4
249730405,5,5,5.0,10,0.5
249746713,1,9,1.0,10,0.1
249760519,2,17,2.0,19,0.10526315789473684
249766435,1,8,1.0,9,0.1111111111111111
249767959,1,9,1.0,10,0.1
249782331,1,9,1.0,10,0.1
249786041,1,9,1.0,10,0.1
249817236,3,5,3.0,8,0.375
249831357,1,16,1.0,17,0.058823529411764705
249840564,6,3,3.0,9,0.3333333333333333
249870095,1,9,1.0,10,0.1
249954868,1,9,1.0,10,0.1
249955402,1,9,1.0,10,0.1
249958908,2,6,2.0,8,0.25
249984957,1,18,1.0,19,0.05263157894736842
249994086,7,2,2.0,9,0.2222222222222222
249996353,1,9,1.0,10,0.1
250006975,16,12,12.0,28,0.42857142857142855
250007449,8,1,1.0,9,0.1111111111111111
250021322,4,6,4.0,10,0.4
250045598,1,9,1.0,10,0.1
250072163,2,8,2.0,10,0.2
250089613,3,15,3.0,18,0.16666666666666666
250113618,1,9,1.0,10,0.1
250135547,1,8,1.0,9,0.1111111111111111
250138600,9,1,1.0,10,0.1
250140216,8,2,2.0,10,0.2
250150991,1,9,1.0,10,0.1
250196844,1,9,1.0,10,0.1
250198538,1,9,1.0,10,0.1
250249786,8,1,1.0,9,0.1111111111111111
250271293,1,8,1.0,9,0.1111111111111111
250295587,1,9,1.0,10,0.1
250315383,2,17,2.0,19,0.10526315789473684
250332210,1,9,1.0,10,0.1
250351155,2,8,2.0,10,0.2
250357321,9,1,1.0,10,0.1
250368691,2,8,2.0,10,0.2
250375605,2,8,2.0,10,0.2
250376914,1,7,1.0,8,0.125
250377814,8,2,2.0,10,0.2
250382121,1,19,1.0,20,0.05
250383171,1,9,1.0,10,0.1
250389920,1,8,1.0,9,0.1111111111111111
250401524,4,5,4.0,9,0.4444444444444444
250401944,6,3,3.0,9,0.3333333333333333
250417095,1,17,1.0,18,0.05555555555555555
250447229,5,15,5.0,20,0.25
250473361,1,7,1.0,8,0.125
250479613,3,6,3.0,9,0.3333333333333333
250480046,1,9,1.0,10,0.1
250496952,6,3,3.0,9,0.3333333333333333
250505965,1,9,1.0,10,0.1
250508551,1,19,1.0,20,0.05
250510953,3,6,3.0,9,0.3333333333333333
250511770,2,8,2.0,10,0.2
250512298,3,6,3.0,9,0.3333333333333333
250512930,2,6,2.0,8,0.25
250514365,3,6,3.0,9,0.3333333333333333
250518919,27,1,1.0,28,0.03571428571428571
250522635,2,8,2.0,10,0.2
250523514,2,17,2.0,19,0.10526315789473684
250535299,18,10,10.0,28,0.35714285714285715
250535812,18,10,10.0,28,0.35714285714285715
250535892,3,6,3.0,9,0.3333333333333333
250536167,1,9,1.0,10,0.1
250536403,3,7,3.0,10,0.3
250537782,3,6,3.0,9,0.3333333333333333
250537813,2,7,2.0,9,0.2222222222222222
250538269,2,8,2.0,10,0.2
250542068,2,8,2.0,10,0.2
250542505,6,4,4.0,10,0.4
250612573,1,18,1.0,19,0.05263157894736842
250613042,1,19,1.0,20,0.05
250620674,1,9,1.0,10,0.1
250622866,1,8,1.0,9,0.1111111111111111
250661044,3,7,3.0,10,0.3
250662504,6,4,4.0,10,0.4
250666788,3,7,3.0,10,0.3
250692583,1,7,1.0,8,0.125
250693863,2,8,2.0,10,0.2
250695428,2,26,2.0,28,0.07142857142857142
250706220,7,12,7.0,19,0.3684210526315789
250710129,9,1,1.0,10,0.1
250710779,3,7,3.0,10,0.3
250711506,2,8,2.0,10,0.2
250711659,25,1,1.0,26,0.038461538461538464
250712302,8,1,1.0,9,0.1111111111111111
250714808,1,8,1.0,9,0.1111111111111111
250715614,5,5,5.0,10,0.5
250728295,7,3,3.0,10,0.3
250735580,1,9,1.0,10,0.1
250783088,1,19,1.0,20,0.05
250790154,2,8,2.0,10,0.2
250790410,2,7,2.0,9,0.2222222222222222
250804041,2,8,2.0,10,0.2
250815554,12,8,8.0,20,0.4
250815735,1,8,1.0,9,0.1111111111111111
250834501,2,6,2.0,8,0.25
250853539,1,9,1.0,10,0.1
250854577,5,4,4.0,9,0.4444444444444444
250869815,9,1,1.0,10,0.1
250898221,1,9,1.0,10,0.1
250919370,1,29,1.0,30,0.03333333333333333
250922563,4,6,4.0,10,0.4
250926959,1,28,1.0,29,0.034482758620689655
250936690,2,25,2.0,27,0.07407407407407407
250938016,1,9,1.0,10,0.1
250941504,10,20,10.0,30,0.3333333333333333
250942014,1,9,1.0,10,0.1
250951811,2,17,2.0,19,0.10526315789473684
250999764,8,10,8.0,18,0.4444444444444444
251033278,1,18,1.0,19,0.05263157894736842
251037352,4,6,4.0,10,0.4
251042041,2,8,2.0,10,0.2
251049111,1,9,1.0,10,0.1
251053947,1,9,1.0,10,0.1
251055224,8,1,1.0,9,0.1111111111111111
251055942,4,16,4.0,20,0.2
251056147,6,3,3.0,9,0.3333333333333333
251056285,6,3,3.0,9,0.3333333333333333
251056592,8,1,1.0,9,0.1111111111111111
251056611,1,9,1.0,10,0.1
251058972,1,8,1.0,9,0.1111111111111111
251076539,2,8,2.0,10,0.2
251088057,6,4,4.0,10,0.4
251093507,7,2,2.0,9,0.2222222222222222
251095208,4,6,4.0,10,0.4
251134774,5,12,5.0,17,0.29411764705882354
251145712,1,9,1.0,10,0.1
251151260,1,18,1.0,19,0.05263157894736842
251157636,2,15,2.0,17,0.11764705882352941
251168239,5,3,3.0,8,0.375
251176115,1,17,1.0,18,0.05555555555555555
251188074,1,9,1.0,10,0.1
251197392,1,17,1.0,18,0.05555555555555555
251201152,3,6,3.0,9,0.3333333333333333
251221550,4,6,4.0,10,0.4
251227289,2,7,2.0,9,0.2222222222222222
251249758,1,8,1.0,9,0.1111111111111111
251251658,1,9,1.0,10,0.1
251252643,1,19,1.0,20,0.05
251253832,3,6,3.0,9,0.3333333333333333
251256503,5,5,5.0,10,0.5
251268736,4,5,4.0,9,0.4444444444444444
251294939,1,8,1.0,9,0.1111111111111111
251301964,1,17,1.0,18,0.05555555555555555
251308519,7,3,3.0,10,0.3
251308625,1,9,1.0,10,0.1
251315052,6,3,3.0,9,0.3333333333333333
251320821,1,19,1.0,20,0.05
251358681,2,7,2.0,9,0.2222222222222222
251359214,3,7,3.0,10,0.3
251367210,1,9,1.0,10,0.1
251369466,4,5,4.0,9,0.4444444444444444
251379613,4,6,4.0,10,0.4
251393896,10,18,10.0,28,0.35714285714285715
251394510,3,6,3.0,9,0.3333333333333333
251410646,1,17,1.0,18,0.05555555555555555
251413469,2,7,2.0,9,0.2222222222222222
251418297,26,3,3.0,29,0.10344827586206896
251440869,6,4,4.0,10,0.4
251441998,1,8,1.0,9,0.1111111111111111
251446641,5,5,5.0,10,0.5
251469734,6,4,4.0,10,0.4
251471824,2,8,2.0,10,0.2
251474112,9,1,1.0,10,0.1
251476344,5,4,4.0,9,0.4444444444444444
251478338,1,9,1.0,10,0.1
251479109,6,4,4.0,10,0.4
251479228,1,8,1.0,9,0.1111111111111111
251479265,6,4,4.0,10,0.4
251479990,1,19,1.0,20,0.05
251486067,1,18,1.0,19,0.05263157894736842
251501476,1,8,1.0,9,0.1111111111111111
251501919,5,4,4.0,9,0.4444444444444444
251502476,2,7,2.0,9,0.2222222222222222
251502999,2,7,2.0,9,0.2222222222222222
251503196,2,17,2.0,19,0.10526315789473684
251504657,21,8,8.0,29,0.27586206896551724
251512251,1,9,1.0,10,0.1
251529670,1,9,1.0,10,0.1
251530639,2,7,2.0,9,0.2222222222222222
251543420,15,5,5.0,20,0.25
251543660,4,6,4.0,10,0.4
251548538,4,13,4.0,17,0.23529411764705882
251561930,2,7,2.0,9,0.2222222222222222
251567272,2,6,2.0,8,0.25
251574599,1,9,1.0,10,0.1
251575497,2,17,2.0,19,0.10526315789473684
251582039,1,9,1.0,10,0.1
251626685,2,27,2.0,29,0.06896551724137931
251630059,4,4,4.0,8,0.5
251635206,3,6,3.0,9,0.3333333333333333
251635539,1,9,1.0,10,0.1
251647149,3,7,3.0,10,0.3
251671936,1,9,1.0,10,0.1
251677017,2,8,2.0,10,0.2
251703133,5,4,4.0,9,0.4444444444444444
251705487,1,8,1.0,9,0.1111111111111111
251823359,6,4,4.0,10,0.4
251856016,1,7,1.0,8,0.125
251869268,2,8,2.0,10,0.2
251908199,1,9,1.0,10,0.1
251914928,4,6,4.0,10,0.4
251988235,1,9,1.0,10,0.1
251991617,1,8,1.0,9,0.1111111111111111
251992423,2,6,2.0,8,0.25
252004293,2,8,2.0,10,0.2
252007068,2,28,2.0,30,0.06666666666666667
252007758,1,8,1.0,9,0.1111111111111111
252012847,1,9,1.0,10,0.1
252013157,1,9,1.0,10,0.1
252017862,2,6,2.0,8,0.25
252098300,1,18,1.0,19,0.05263157894736842
252099917,3,7,3.0,10,0.3
252171195,5,3,3.0,8,0.375
252172579,2,7,2.0,9,0.2222222222222222
252205877,7,3,3.0,10,0.3
252222553,1,7,1.0,8,0.125
252222778,1,9,1.0,10,0.1
252245583,2,16,2.0,18,0.1111111111111111
252268731,3,6,3.0,9,0.3333333333333333
252282312,9,1,1.0,10,0.1
252282618,9,1,1.0,10,0.1
252282787,5,4,4.0,9,0.4444444444444444
252288581,1,9,1.0,10,0.1
252327950,2,7,2.0,9,0.2222222222222222
252338299,3,7,3.0,10,0.3
252343096,3,16,3.0,19,0.15789473684210525
252353389,1,17,1.0,18,0.05555555555555555
252356818,1,19,1.0,20,0.05
252360786,2,18,2.0,20,0.1
252364693,4,14,4.0,18,0.2222222222222222
252365330,2,8,2.0,10,0.2
252368087,5,14,5.0,19,0.2631578947368421
252376293,4,6,4.0,10,0.4
252381515,1,9,1.0,10,0.1
252387727,8,2,2.0,10,0.2
252392548,1,9,1.0,10,0.1
252404145,1,16,1.0,17,0.058823529411764705
252408344,3,7,3.0,10,0.3
252415064,4,5,4.0,9,0.4444444444444444
252423099,1,16,1.0,17,0.058823529411764705
252423789,1,9,1.0,10,0.1
252428330,2,8,2.0,10,0.2
252429361,4,23,4.0,27,0.14814814814814814
252450129,4,5,4.0,9,0.4444444444444444
252490985,1,19,1.0,20,0.05
252493489,2,8,2.0,10,0.2
252495034,4,4,4.0,8,0.5
252499850,2,8,2.0,10,0.2
252500736,1,8,1.0,9,0.1111111111111111
252510065,5,3,3.0,8,0.375
252510645,3,6,3.0,9,0.3333333333333333
252510996,3,25,3.0,28,0.10714285714285714
252513213,1,8,1.0,9,0.1111111111111111
252515553,2,7,2.0,9,0.2222222222222222
252516287,8,2,2.0,10,0.2
252516345,7,2,2.0,9,0.2222222222222222
252521502,5,5,5.0,10,0.5
252551926,3,7,3.0,10,0.3
252552079,2,8,2.0,10,0.2
252563370,1,19,1.0,20,0.05
252628919,25,5,5.0,30,0.16666666666666666
252629105,8,1,1.0,9,0.1111111111111111
252642788,9,1,1.0,10,0.1
252644024,5,3,3.0,8,0.375
252675151,5,5,5.0,10,0.5
252680704,7,2,2.0,9,0.2222222222222222
252680934,1,9,1.0,10,0.1
252681772,6,3,3.0,9,0.3333333333333333
252682303,6,3,3.0,9,0.3333333333333333
252689448,1,9,1.0,10,0.1
252698591,9,1,1.0,10,0.1
252718843,1,9,1.0,10,0.1
252726569,1,9,1.0,10,0.1
252734680,2,29,2.0,31,0.06451612903225806
252736107,1,8,1.0,9,0.1111111111111111
252805153,3,6,3.0,9,0.3333333333333333
252818915,2,18,2.0,20,0.1
252831227,6,2,2.0,8,0.25
252846127,6,3,3.0,9,0.3333333333333333
252848570,4,6,4.0,10,0.4
252850122,5,5,5.0,10,0.5
252850682,2,6,2.0,8,0.25
252888106,3,15,3.0,18,0.16666666666666666
252890186,1,19,1.0,20,0.05
252911621,1,8,1.0,9,0.1111111111111111
252924661,1,18,1.0,19,0.05263157894736842
252935656,1,8,1.0,9,0.1111111111111111
252937303,1,8,1.0,9,0.1111111111111111
252950566,1,9,1.0,10,0.1
252961430,1,9,1.0,10,0.1
252970813,1,9,1.0,10,0.1
252974046,1,19,1.0,20,0.05
252981068,6,4,4.0,10,0.4
252991447,3,6,3.0,9,0.3333333333333333
253005697,1,9,1.0,10,0.1
253022530,3,7,3.0,10,0.3
253022659,1,9,1.0,10,0.1
253022774,1,18,1.0,19,0.05263157894736842
253023321,4,5,4.0,9,0.4444444444444444
253034476,1,9,1.0,10,0.1
253039843,4,4,4.0,8,0.5
253041648,4,6,4.0,10,0.4
253050289,1,9,1.0,10,0.1
253101430,5,3,3.0,8,0.375
253101630,8,2,2.0,10,0.2
253129366,2,8,2.0,10,0.2
253131837,1,8,1.0,9,0.1111111111111111
253136385,3,6,3.0,9,0.3333333333333333
253137370,15,11,11.0,26,0.4230769230769231
253137818,8,1,1.0,9,0.1111111111111111
253137963,2,6,2.0,8,0.25
253156251,1,15,1.0,16,0.0625
253187139,8,12,8.0,20,0.4
253187181,2,8,2.0,10,0.2
253188183,5,3,3.0,8,0.375
253188324,1,9,1.0,10,0.1
253191805,2,18,2.0,20,0.1
253244758,2,8,2.0,10,0.2
253276075,3,7,3.0,10,0.3
253301078,4,15,4.0,19,0.21052631578947367
253318187,8,1,1.0,9,0.1111111111111111
253319033,2,7,2.0,9,0.2222222222222222
253341007,3,15,3.0,18,0.16666666666666666
253342852,9,1,1.0,10,0.1
253345252,5,4,4.0,9,0.4444444444444444
253345757,8,2,2.0,10,0.2
253358723,3,7,3.0,10,0.3
253381427,1,18,1.0,19,0.05263157894736842
253403754,1,8,1.0,9,0.1111111111111111
253404679,4,25,4.0,29,0.13793103448275862
253404874,4,6,4.0,10,0.4
253409363,1,9,1.0,10,0.1
253410863,1,18,1.0,19,0.05263157894736842
253419110,4,5,4.0,9,0.4444444444444444
253420730,1,8,1.0,9,0.1111111111111111
253438133,3,7,3.0,10,0.3
253444995,4,5,4.0,9,0.4444444444444444
253446851,1,8,1.0,9,0.1111111111111111
253499989,1,9,1.0,10,0.1
253532639,1,9,1.0,10,0.1
253546983,4,6,4.0,10,0.4
253608075,2,7,2.0,9,0.2222222222222222
253621901,1,9,1.0,10,0.1
253655573,1,19,1.0,20,0.05
253709517,2,8,2.0,10,0.2
253720559,1,9,1.0,10,0.1
253734487,7,2,2.0,9,0.2222222222222222
253754672,1,9,1.0,10,0.1
253782509,3,7,3.0,10,0.3
253971789,2,26,2.0,28,0.07142857142857142
254006192,1,9,1.0,10,0.1
254008891,1,19,1.0,20,0.05
254015894,1,8,1.0,9,0.1111111111111111
254028796,2,7,2.0,9,0.2222222222222222
254029816,1,9,1.0,10,0.1
254068624,1,8,1.0,9,0.1111111111111111
254080435,1,9,1.0,10,0.1
254104320,14,13,13.0,27,0.48148148148148145
254104850,4,6,4.0,10,0.4
254105856,8,2,2.0,10,0.2
254106956,1,9,1.0,10,0.1
254118935,9,1,1.0,10,0.1
254124351,5,4,4.0,9,0.4444444444444444
254181383,9,16,9.0,25,0.36
254188596,1,9,1.0,10,0.1
254217845,2,8,2.0,10,0.2
254246744,1,19,1.0,20,0.05
254342358,1,9,1.0,10,0.1
254350306,8,2,2.0,10,0.2
254371004,8,2,2.0,10,0.2
254372519,6,4,4.0,10,0.4
254374507,2,7,2.0,9,0.2222222222222222
254374870,4,6,4.0,10,0.4
254385338,1,19,1.0,20,0.05
254395428,2,8,2.0,10,0.2
254395848,1,9,1.0,10,0.1
254411967,9,1,1.0,10,0.1
254412459,4,6,4.0,10,0.4
254447926,7,3,3.0,10,0.3
254448479,7,2,2.0,9,0.2222222222222222
254483104,7,3,3.0,10,0.3
254495160,1,16,1.0,17,0.058823529411764705
254506429,9,1,1.0,10,0.1
254506793,6,4,4.0,10,0.4
254512291,2,18,2.0,20,0.1
254537425,1,19,1.0,20,0.05
254554576,7,3,3.0,10,0.3
254556006,1,9,1.0,10,0.1
254607691,3,6,3.0,9,0.3333333333333333
254609477,2,6,2.0,8,0.25
254611662,3,7,3.0,10,0.3
254611783,2,8,2.0,10,0.2
254614632,15,14,14.0,29,0.4827586206896552
254615722,6,4,4.0,10,0.4
254618376,2,6,2.0,8,0.25
254618667,9,1,1.0,10,0.1
254618944,3,6,3.0,9,0.3333333333333333
254619039,4,5,4.0,9,0.4444444444444444
254619686,3,6,3.0,9,0.3333333333333333
254700342,2,8,2.0,10,0.2
254707750,1,9,1.0,10,0.1
254708094,2,8,2.0,10,0.2
254710612,1,8,1.0,9,0.1111111111111111
254713268,1,9,1.0,10,0.1
254714576,2,8,2.0,10,0.2
254719787,4,6,4.0,10,0.4
254721191,1,9,1.0,10,0.1
254738832,1,9,1.0,10,0.1
254746473,1,17,1.0,18,0.05555555555555555
254762086,3,14,3.0,17,0.17647058823529413
254768262,2,18,2.0,20,0.1
254774086,4,5,4.0,9,0.4444444444444444
254783193,1,8,1.0,9,0.1111111111111111
254795014,1,8,1.0,9,0.1111111111111111
254796717,1,19,1.0,20,0.05
254799923,7,3,3.0,10,0.3
254807794,2,6,2.0,8,0.25
254840019,2,8,2.0,10,0.2
254959582,1,8,1.0,9,0.1111111111111111
254989830,2,8,2.0,10,0.2
255001369,3,7,3.0,10,0.3
255006868,2,7,2.0,9,0.2222222222222222
255024332,3,7,3.0,10,0.3
255043816,1,18,1.0,19,0.05263157894736842
255077449,1,19,1.0,20,0.05
255078857,18,1,1.0,19,0.05263157894736842
255101288,3,16,3.0,19,0.15789473684210525
255105511,8,2,2.0,10,0.2
255113301,1,8,1.0,9,0.1111111111111111
255158580,4,23,4.0,27,0.14814814814814814
255158765,3,7,3.0,10,0.3
255159755,5,5,5.0,10,0.5
255160520,2,8,2.0,10,0.2
255174868,1,19,1.0,20,0.05
255219126,5,5,5.0,10,0.5
255232261,3,17,3.0,20,0.15
255233279,2,8,2.0,10,0.2
255256460,1,9,1.0,10,0.1
255271793,1,27,1.0,28,0.03571428571428571
255282717,7,1,1.0,8,0.125
255292944,2,8,2.0,10,0.2
255301797,1,7,1.0,8,0.125
255348907,1,8,1.0,9,0.1111111111111111
255368898,9,1,1.0,10,0.1
255382679,1,9,1.0,10,0.1
255409416,8,11,8.0,19,0.42105263157894735
255421332,3,7,3.0,10,0.3
255432199,1,9,1.0,10,0.1
255433050,2,8,2.0,10,0.2
255434330,1,8,1.0,9,0.1111111111111111
255472122,4,6,4.0,10,0.4
255495735,1,9,1.0,10,0.1
255498860,1,9,1.0,10,0.1
255520129,3,17,3.0,20,0.15
255525769,25,4,4.0,29,0.13793103448275862
255594383,1,9,1.0,10,0.1
255603699,1,9,1.0,10,0.1
255668208,3,7,3.0,10,0.3
255674218,2,8,2.0,10,0.2
255691246,2,8,2.0,10,0.2
255699487,1,9,1.0,10,0.1
255699761,1,9,1.0,10,0.1
255714507,2,18,2.0,20,0.1
255715440,1,9,1.0,10,0.1
255719770,2,7,2.0,9,0.2222222222222222
255720627,1,8,1.0,9,0.1111111111111111
255722082,9,21,9.0,30,0.3
255724673,4,24,4.0,28,0.14285714285714285
255743630,1,9,1.0,10,0.1
255751940,1,9,1.0,10,0.1
255787639,1,17,1.0,18,0.05555555555555555
255801600,2,8,2.0,10,0.2
255801698,1,9,1.0,10,0.1
255802256,3,7,3.0,10,0.3
255802643,18,11,11.0,29,0.3793103448275862
255821700,2,8,2.0,10,0.2
255823618,9,1,1.0,10,0.1
255825190,1,9,1.0,10,0.1
255830882,6,3,3.0,9,0.3333333333333333
255834184,2,6,2.0,8,0.25
255849855,1,9,1.0,10,0.1
255850829,2,8,2.0,10,0.2
255871640,3,7,3.0,10,0.3
255872519,7,3,3.0,10,0.3
255874350,6,4,4.0,10,0.4
255879887,8,2,2.0,10,0.2
255890283,1,9,1.0,10,0.1
255890458,1,9,1.0,10,0.1
255918289,1,8,1.0,9,0.1111111111111111
255943348,1,8,1.0,9,0.1111111111111111
255961762,2,18,2.0,20,0.1
255964011,2,8,2.0,10,0.2
255968398,1,15,1.0,16,0.0625
256000287,5,4,4.0,9,0.4444444444444444
256002329,2,8,2.0,10,0.2
256005274,6,4,4.0,10,0.4
256006547,4,15,4.0,19,0.21052631578947367
256007991,9,1,1.0,10,0.1
256016634,1,7,1.0,8,0.125
256051251,9,1,1.0,10,0.1
256056701,1,9,1.0,10,0.1
256092503,7,2,2.0,9,0.2222222222222222
256095557,3,6,3.0,9,0.3333333333333333
256096762,26,3,3.0,29,0.10344827586206896
256098475,1,9,1.0,10,0.1
256123425,9,7,7.0,16,0.4375
256128013,1,27,1.0,28,0.03571428571428571
256135773,3,6,3.0,9,0.3333333333333333
256142260,2,8,2.0,10,0.2
256148459,2,7,2.0,9,0.2222222222222222
256152491,2,7,2.0,9,0.2222222222222222
256153193,5,5,5.0,10,0.5
256163283,2,17,2.0,19,0.10526315789473684
256164403,2,6,2.0,8,0.25
256166723,4,15,4.0,19,0.21052631578947367
256197717,2,8,2.0,10,0.2
256222198,2,8,2.0,10,0.2
256222588,1,8,1.0,9,0.1111111111111111
256222816,1,8,1.0,9,0.1111111111111111
256223650,5,22,5.0,27,0.18518518518518517
256224336,1,9,1.0,10,0.1
256224525,2,6,2.0,8,0.25
256234166,2,7,2.0,9,0.2222222222222222
256235154,2,16,2.0,18,0.1111111111111111
256236546,7,3,3.0,10,0.3
256236875,6,3,3.0,9,0.3333333333333333
256240957,1,8,1.0,9,0.1111111111111111
256241595,1,9,1.0,10,0.1
256243366,1,9,1.0,10,0.1
256249057,6,3,3.0,9,0.3333333333333333
256250732,4,5,4.0,9,0.4444444444444444
256251077,9,1,1.0,10,0.1
256254116,2,8,2.0,10,0.2
256255519,2,8,2.0,10,0.2
256264750,2,8,2.0,10,0.2
256266491,1,8,1.0,9,0.1111111111111111
256278811,1,9,1.0,10,0.1
256279389,1,8,1.0,9,0.1111111111111111
256280066,2,6,2.0,8,0.25
256285763,3,6,3.0,9,0.3333333333333333
256290854,2,8,2.0,10,0.2
256293531,2,8,2.0,10,0.2
256336848,13,14,13.0,27,0.48148148148148145
256339578,2,8,2.0,10,0.2
256365403,1,9,1.0,10,0.1
256367629,3,7,3.0,10,0.3
256385123,1,9,1.0,10,0.1
256385220,4,6,4.0,10,0.4
256436768,1,8,1.0,9,0.1111111111111111
256437445,2,8,2.0,10,0.2
256439640,4,6,4.0,10,0.4
256454147,2,8,2.0,10,0.2
256485743,4,6,4.0,10,0.4
256486043,2,7,2.0,9,0.2222222222222222
256487494,2,8,2.0,10,0.2
256516153,3,7,3.0,10,0.3
256523631,3,7,3.0,10,0.3
256527849,1,9,1.0,10,0.1
256530692,13,15,13.0,28,0.4642857142857143
256543523,1,18,1.0,19,0.05263157894736842
256552753,7,3,3.0,10,0.3
256567470,2,17,2.0,19,0.10526315789473684
256571900,1,9,1.0,10,0.1
256582509,1,8,1.0,9,0.1111111111111111
256583100,6,4,4.0,10,0.4
256588595,2,16,2.0,18,0.1111111111111111
256598106,1,8,1.0,9,0.1111111111111111
256602137,1,18,1.0,19,0.05263157894736842
256615647,1,19,1.0,20,0.05
256628812,6,4,4.0,10,0.4
256631194,3,7,3.0,10,0.3
256684459,2,8,2.0,10,0.2
256685994,2,8,2.0,10,0.2
256686776,5,22,5.0,27,0.18518518518518517
256687507,3,7,3.0,10,0.3
256701901,3,7,3.0,10,0.3
256708935,1,8,1.0,9,0.1111111111111111
256734661,1,9,1.0,10,0.1
256741290,18,1,1.0,19,0.05263157894736842
256746066,17,9,9.0,26,0.34615384615384615
256746585,8,2,2.0,10,0.2
256747978,6,4,4.0,10,0.4
256756666,2,6,2.0,8,0.25
256762517,7,2,2.0,9,0.2222222222222222
256763022,27,3,3.0,30,0.1
256769132,25,2,2.0,27,0.07407407407407407
256775748,1,17,1.0,18,0.05555555555555555
256779817,3,7,3.0,10,0.3
256779959,2,18,2.0,20,0.1
256790960,1,9,1.0,10,0.1
256796889,2,7,2.0,9,0.2222222222222222
256820317,1,18,1.0,19,0.05263157894736842
256866740,4,6,4.0,10,0.4
256866976,6,4,4.0,10,0.4
256871436,3,17,3.0,20,0.15
256899889,1,8,1.0,9,0.1111111111111111
256930429,2,8,2.0,10,0.2
256935461,2,6,2.0,8,0.25
256936124,8,2,2.0,10,0.2
256937041,1,8,1.0,9,0.1111111111111111
256944152,1,18,1.0,19,0.05263157894736842
256962588,1,9,1.0,10,0.1
256984017,1,9,1.0,10,0.1
256985721,1,7,1.0,8,0.125
256986251,2,7,2.0,9,0.2222222222222222
256986572,1,9,1.0,10,0.1
256987254,3,7,3.0,10,0.3
256992581,1,19,1.0,20,0.05
257007092,13,13,13.0,26,0.5
257009308,8,1,1.0,9,0.1111111111111111
257015425,1,9,1.0,10,0.1
257015491,3,7,3.0,10,0.3
257015552,1,9,1.0,10,0.1
257021192,4,6,4.0,10,0.4
257025259,3,6,3.0,9,0.3333333333333333
257034409,3,7,3.0,10,0.3
257037729,5,25,5.0,30,0.16666666666666666
257043181,1,17,1.0,18,0.05555555555555555
257083397,3,6,3.0,9,0.3333333333333333
257086935,3,7,3.0,10,0.3
257090874,1,17,1.0,18,0.05555555555555555
257100444,8,2,2.0,10,0.2
257100648,7,3,3.0,10,0.3
257101654,1,9,1.0,10,0.1
257154723,5,4,4.0,9,0.4444444444444444
257155275,1,9,1.0,10,0.1
257158338,7,3,3.0,10,0.3
257171737,2,17,2.0,19,0.10526315789473684
257173828,1,19,1.0,20,0.05
257178086,1,9,1.0,10,0.1
257179034,1,9,1.0,10,0.1
257197097,9,1,1.0,10,0.1
257222014,1,9,1.0,10,0.1
257223961,1,9,1.0,10,0.1
257239955,2,7,2.0,9,0.2222222222222222
257243210,2,17,2.0,19,0.10526315789473684
257243679,7,3,3.0,10,0.3
257266068,7,1,1.0,8,0.125
257275867,1,9,1.0,10,0.1
257278906,14,6,6.0,20,0.3
257278943,13,16,13.0,29,0.4482758620689655
257279878,5,5,5.0,10,0.5
257280146,1,9,1.0,10,0.1
257283153,1,8,1.0,9,0.1111111111111111
257298064,1,17,1.0,18,0.05555555555555555
257334202,1,19,1.0,20,0.05
257349196,3,5,3.0,8,0.375
257397822,8,2,2.0,10,0.2
257398077,9,1,1.0,10,0.1
257422675,1,9,1.0,10,0.1
257459463,2,7,2.0,9,0.2222222222222222
257483436,1,9,1.0,10,0.1
257488228,1,8,1.0,9,0.1111111111111111
257502258,1,9,1.0,10,0.1
257503986,2,8,2.0,10,0.2
257507561,7,2,2.0,9,0.2222222222222222
257507658,21,7,7.0,28,0.25
257518092,2,17,2.0,19,0.10526315789473684
257542852,8,1,1.0,9,0.1111111111111111
257546332,1,19,1.0,20,0.05
257549257,9,17,9.0,26,0.34615384615384615
257556871,3,7,3.0,10,0.3
257563223,2,8,2.0,10,0.2
257565543,1,9,1.0,10,0.1
257570931,1,8,1.0,9,0.1111111111111111
257594018,2,8,2.0,10,0.2
257600786,1,9,1.0,10,0.1
257601404,2,8,2.0,10,0.2
257602456,3,27,3.0,30,0.1
257613875,7,2,2.0,9,0.2222222222222222
257657974,1,9,1.0,10,0.1
257719082,1,9,1.0,10,0.1
257730054,1,9,1.0,10,0.1
257738661,4,6,4.0,10,0.4
257740389,2,7,2.0,9,0.2222222222222222
257789988,2,8,2.0,10,0.2
257791503,1,9,1.0,10,0.1
257793020,11,17,11.0,28,0.39285714285714285
257796427,2,8,2.0,10,0.2
257797526,1,7,1.0,8,0.125
257802307,4,24,4.0,28,0.14285714285714285
257802823,3,6,3.0,9,0.3333333333333333
257876765,8,2,2.0,10,0.2
257900248,3,7,3.0,10,0.3
257900394,1,8,1.0,9,0.1111111111111111
257935077,1,9,1.0,10,0.1
257935376,1,28,1.0,29,0.034482758620689655
257980850,1,9,1.0,10,0.1
257982310,2,8,2.0,10,0.2
257983893,5,4,4.0,9,0.4444444444444444
257989359,1,9,1.0,10,0.1
257991439,1,7,1.0,8,0.125
257991546,24,6,6.0,30,0.2
257992678,5,5,5.0,10,0.5
257996685,8,2,2.0,10,0.2
257998671,8,1,1.0,9,0.1111111111111111
258041644,3,7,3.0,10,0.3
258044974,3,7,3.0,10,0.3
258054090,7,1,1.0,8,0.125
258069762,2,16,2.0,18,0.1111111111111111
258080864,6,4,4.0,10,0.4
258080875,4,6,4.0,10,0.4
258086752,2,16,2.0,18,0.1111111111111111
258110441,1,9,1.0,10,0.1
258126170,11,7,7.0,18,0.3888888888888889
258132331,1,17,1.0,18,0.05555555555555555
258147585,2,17,2.0,19,0.10526315789473684
258167113,1,9,1.0,10,0.1
258192288,1,8,1.0,9,0.1111111111111111
258212295,1,19,1.0,20,0.05
258217345,1,9,1.0,10,0.1
258266070,2,8,2.0,10,0.2
258284847,7,2,2.0,9,0.2222222222222222
258285043,8,1,1.0,9,0.1111111111111111
258288129,8,2,2.0,10,0.2
258293793,1,9,1.0,10,0.1
258294713,3,7,3.0,10,0.3
258308633,1,8,1.0,9,0.1111111111111111
258312128,1,9,1.0,10,0.1
258321254,7,12,7.0,19,0.3684210526315789
258325146,5,24,5.0,29,0.1724137931034483
258326628,2,7,2.0,9,0.2222222222222222
258331013,1,9,1.0,10,0.1
258331620,2,8,2.0,10,0.2
258333848,1,7,1.0,8,0.125
258344323,1,8,1.0,9,0.1111111111111111
258375463,1,8,1.0,9,0.1111111111111111
258395072,1,9,1.0,10,0.1
258410429,4,16,4.0,20,0.2
258410976,6,2,2.0,8,0.25
258418531,4,6,4.0,10,0.4
258418815,7,2,2.0,9,0.2222222222222222
258420679,2,18,2.0,20,0.1
258421308,3,24,3.0,27,0.1111111111111111
258422806,1,9,1.0,10,0.1
258439366,1,9,1.0,10,0.1
258465616,10,9,9.0,19,0.47368421052631576
258465726,1,9,1.0,10,0.1
258487848,7,13,7.0,20,0.35
258517006,1,8,1.0,9,0.1111111111111111
258570619,2,6,2.0,8,0.25
258574507,1,19,1.0,20,0.05
258597081,1,9,1.0,10,0.1
258607801,1,7,1.0,8,0.125
258627037,1,8,1.0,9,0.1111111111111111
258637103,4,6,4.0,10,0.4
258642900,1,9,1.0,10,0.1
258655019,3,7,3.0,10,0.3
258660798,1,9,1.0,10,0.1
258661039,3,7,3.0,10,0.3
258692243,3,7,3.0,10,0.3
258696035,7,3,3.0,10,0.3
258696664,2,8,2.0,10,0.2
258697513,14,6,6.0,20,0.3
258698183,7,22,7.0,29,0.2413793103448276
258703940,4,6,4.0,10,0.4
258754938,3,6,3.0,9,0.3333333333333333
258787473,3,7,3.0,10,0.3
258789630,1,9,1.0,10,0.1
258790205,2,8,2.0,10,0.2
258791279,1,15,1.0,16,0.0625
258811506,2,16,2.0,18,0.1111111111111111
258812579,2,8,2.0,10,0.2
258814546,4,5,4.0,9,0.4444444444444444
258841369,1,17,1.0,18,0.05555555555555555
258857897,2,7,2.0,9,0.2222222222222222
258864946,4,6,4.0,10,0.4
258870173,2,17,2.0,19,0.10526315789473684
258878731,5,4,4.0,9,0.4444444444444444
258901182,6,4,4.0,10,0.4
258902959,7,2,2.0,9,0.2222222222222222
258908209,1,9,1.0,10,0.1
258922691,6,3,3.0,9,0.3333333333333333
258923085,7,2,2.0,9,0.2222222222222222
258924462,3,16,3.0,19,0.15789473684210525
258925182,6,22,6.0,28,0.21428571428571427
258965219,1,9,1.0,10,0.1
258984306,6,4,4.0,10,0.4
258998029,6,3,3.0,9,0.3333333333333333
259044642,6,4,4.0,10,0.4
259053963,1,8,1.0,9,0.1111111111111111
259067219,2,6,2.0,8,0.25
259067456,3,6,3.0,9,0.3333333333333333
259089623,1,8,1.0,9,0.1111111111111111
259094760,5,5,5.0,10,0.5
259115923,1,8,1.0,9,0.1111111111111111
259165480,3,7,3.0,10,0.3
259202344,7,3,3.0,10,0.3
259213718,2,18,2.0,20,0.1
259217762,4,6,4.0,10,0.4
259249199,6,4,4.0,10,0.4
259286634,1,8,1.0,9,0.1111111111111111
259327296,1,9,1.0,10,0.1
259327374,3,6,3.0,9,0.3333333333333333
259328384,1,8,1.0,9,0.1111111111111111
259330083,1,9,1.0,10,0.1
259335421,3,6,3.0,9,0.3333333333333333
259337580,1,19,1.0,20,0.05
259338564,9,1,1.0,10,0.1
259341813,8,2,2.0,10,0.2
259342186,8,2,2.0,10,0.2
259353937,2,8,2.0,10,0.2
259358829,2,8,2.0,10,0.2
259367562,22,7,7.0,29,0.2413793103448276
259367665,6,4,4.0,10,0.4
259369336,5,3,3.0,8,0.375
259375941,1,9,1.0,10,0.1
259397430,1,8,1.0,9,0.1111111111111111
259401277,5,14,5.0,19,0.2631578947368421
259445705,1,17,1.0,18,0.05555555555555555
259465314,7,3,3.0,10,0.3
259468161,2,8,2.0,10,0.2
259468195,4,5,4.0,9,0.4444444444444444
259491065,1,8,1.0,9,0.1111111111111111
259517725,6,4,4.0,10,0.4
259518445,2,8,2.0,10,0.2
259547207,2,8,2.0,10,0.2
259572835,2,8,2.0,10,0.2
259592929,1,9,1.0,10,0.1
259627855,4,5,4.0,9,0.4444444444444444
259643919,1,18,1.0,19,0.05263157894736842
259645874,2,7,2.0,9,0.2222222222222222
259674548,1,18,1.0,19,0.05263157894736842
259694182,6,4,4.0,10,0.4
259700560,1,28,1.0,29,0.034482758620689655
259700803,3,25,3.0,28,0.10714285714285714
259700917,1,9,1.0,10,0.1
259710367,21,7,7.0,28,0.25
259710974,7,3,3.0,10,0.3
259717304,9,19,9.0,28,0.32142857142857145
259726810,4,6,4.0,10,0.4
259760138,2,8,2.0,10,0.2
259764159,1,9,1.0,10,0.1
259773735,3,7,3.0,10,0.3
259775397,3,5,3.0,8,0.375
259819562,4,6,4.0,10,0.4
259820981,7,3,3.0,10,0.3
259825263,2,8,2.0,10,0.2
259826045,1,8,1.0,9,0.1111111111111111
259833719,1,9,1.0,10,0.1
259845021,5,5,5.0,10,0.5
259846364,1,9,1.0,10,0.1
259853000,1,8,1.0,9,0.1111111111111111
259860825,7,3,3.0,10,0.3
259871223,7,3,3.0,10,0.3
259874213,5,5,5.0,10,0.5
259889817,3,7,3.0,10,0.3
259909647,2,8,2.0,10,0.2
259920374,6,4,4.0,10,0.4
259924856,1,9,1.0,10,0.1
259928595,2,7,2.0,9,0.2222222222222222
259931811,7,2,2.0,9,0.2222222222222222
259937985,1,8,1.0,9,0.1111111111111111
259943814,8,2,2.0,10,0.2
259945385,1,8,1.0,9,0.1111111111111111
259973416,4,4,4.0,8,0.5
259986283,1,8,1.0,9,0.1111111111111111
259998711,1,9,1.0,10,0.1
259999422,1,8,1.0,9,0.1111111111111111
260001444,1,9,1.0,10,0.1
260001699,7,2,2.0,9,0.2222222222222222
260002894,2,7,2.0,9,0.2222222222222222
260003869,3,7,3.0,10,0.3
260005153,3,7,3.0,10,0.3
260020201,7,2,2.0,9,0.2222222222222222
260031505,1,17,1.0,18,0.05555555555555555
260052571,1,9,1.0,10,0.1
260059693,3,7,3.0,10,0.3
260075690,1,28,1.0,29,0.034482758620689655
260085307,8,2,2.0,10,0.2
260087257,8,2,2.0,10,0.2
260109126,3,25,3.0,28,0.10714285714285714
260109206,8,2,2.0,10,0.2
260109589,9,1,1.0,10,0.1
260109608,1,9,1.0,10,0.1
260125837,3,7,3.0,10,0.3
260126530,1,9,1.0,10,0.1
260128482,2,8,2.0,10,0.2
260137221,1,9,1.0,10,0.1
260145064,6,4,4.0,10,0.4
260145859,9,1,1.0,10,0.1
260146918,1,9,1.0,10,0.1
260147232,27,1,1.0,28,0.03571428571428571
260197068,1,8,1.0,9,0.1111111111111111
260216698,1,9,1.0,10,0.1
260241243,1,8,1.0,9,0.1111111111111111
260244179,6,4,4.0,10,0.4
260262108,5,14,5.0,19,0.2631578947368421
260272356,6,2,2.0,8,0.25
260285697,5,5,5.0,10,0.5
260298586,2,7,2.0,9,0.2222222222222222
260310378,2,8,2.0,10,0.2
260312623,1,9,1.0,10,0.1
260361775,1,9,1.0,10,0.1
260379146,1,19,1.0,20,0.05
260388919,1,7,1.0,8,0.125
260389185,8,2,2.0,10,0.2
260389267,1,7,1.0,8,0.125
260424935,2,7,2.0,9,0.2222222222222222
260451478,1,9,1.0,10,0.1
260481387,9,1,1.0,10,0.1
260482561,13,13,13.0,26,0.5
260483241,2,7,2.0,9,0.2222222222222222
260488879,1,9,1.0,10,0.1
260504070,1,8,1.0,9,0.1111111111111111
260543307,1,9,1.0,10,0.1
260561300,1,9,1.0,10,0.1
260622522,24,6,6.0,30,0.2
260633824,9,1,1.0,10,0.1
260640360,5,4,4.0,9,0.4444444444444444
260669469,3,7,3.0,10,0.3
260671815,2,17,2.0,19,0.10526315789473684
260696748,1,9,1.0,10,0.1
260714870,1,19,1.0,20,0.05
260716240,1,9,1.0,10,0.1
260723624,20,8,8.0,28,0.2857142857142857
260739932,1,9,1.0,10,0.1
260742025,1,9,1.0,10,0.1
260746781,1,17,1.0,18,0.05555555555555555
260767252,6,4,4.0,10,0.4
260784363,1,19,1.0,20,0.05
260788687,3,16,3.0,19,0.15789473684210525
260790162,4,16,4.0,20,0.2
260807245,1,9,1.0,10,0.1
260816496,2,8,2.0,10,0.2
260841704,1,8,1.0,9,0.1111111111111111
260842044,2,7,2.0,9,0.2222222222222222
260900794,5,5,5.0,10,0.5
260944391,3,26,3.0,29,0.10344827586206896
260959462,1,18,1.0,19,0.05263157894736842
260969917,1,8,1.0,9,0.1111111111111111
260987261,2,8,2.0,10,0.2
260992319,6,4,4.0,10,0.4
261003823,3,6,3.0,9,0.3333333333333333
261044943,1,8,1.0,9,0.1111111111111111
261048563,2,8,2.0,10,0.2
261058330,3,7,3.0,10,0.3
261058760,3,7,3.0,10,0.3
261095911,1,9,1.0,10,0.1
261106726,2,7,2.0,9,0.2222222222222222
261112914,1,8,1.0,9,0.1111111111111111
261113122,4,15,4.0,19,0.21052631578947367
261130429,2,8,2.0,10,0.2
261134245,8,2,2.0,10,0.2
261163550,5,5,5.0,10,0.5
261172749,1,7,1.0,8,0.125
261188480,1,9,1.0,10,0.1
261223644,8,2,2.0,10,0.2
261223765,8,2,2.0,10,0.2
261225387,2,8,2.0,10,0.2
261225733,6,23,6.0,29,0.20689655172413793
261232850,2,8,2.0,10,0.2
261249961,1,8,1.0,9,0.1111111111111111
261272668,2,6,2.0,8,0.25
261280198,1,19,1.0,20,0.05
261309998,2,8,2.0,10,0.2
261334463,1,8,1.0,9,0.1111111111111111
261335962,8,1,1.0,9,0.1111111111111111
261346363,1,19,1.0,20,0.05
261355935,1,18,1.0,19,0.05263157894736842
261369759,6,4,4.0,10,0.4
261377056,4,6,4.0,10,0.4
261401542,8,2,2.0,10,0.2
261402320,5,5,5.0,10,0.5
261418693,8,18,8.0,26,0.3076923076923077
261420787,1,8,1.0,9,0.1111111111111111
261421523,6,3,3.0,9,0.3333333333333333
261422061,1,9,1.0,10,0.1
261439299,8,2,2.0,10,0.2
261441335,1,9,1.0,10,0.1
261444286,3,7,3.0,10,0.3
261453033,3,7,3.0,10,0.3
261454368,4,6,4.0,10,0.4
261456168,7,1,1.0,8,0.125
261460037,1,9,1.0,10,0.1
261470026,4,6,4.0,10,0.4
261486963,2,16,2.0,18,0.1111111111111111
261495710,1,9,1.0,10,0.1
261509121,1,18,1.0,19,0.05263157894736842
261513106,4,5,4.0,9,0.4444444444444444
261529120,1,9,1.0,10,0.1
261529412,1,9,1.0,10,0.1
261536607,1,17,1.0,18,0.05555555555555555
261557342,2,7,2.0,9,0.2222222222222222
261623840,1,19,1.0,20,0.05
261625730,2,8,2.0,10,0.2
261627510,2,7,2.0,9,0.2222222222222222
261632280,2,16,2.0,18,0.1111111111111111
261651346,1,8,1.0,9,0.1111111111111111
261652428,3,5,3.0,8,0.375
261711443,1,16,1.0,17,0.058823529411764705
261719631,1,9,1.0,10,0.1
261723287,2,17,2.0,19,0.10526315789473684
261745543,1,19,1.0,20,0.05
261748650,2,7,2.0,9,0.2222222222222222
261756500,5,23,5.0,28,0.17857142857142858
261784296,8,2,2.0,10,0.2
261794426,4,6,4.0,10,0.4
261795271,5,5,5.0,10,0.5
261804296,2,18,2.0,20,0.1
261804967,1,19,1.0,20,0.05
261822320,9,1,1.0,10,0.1
261823442,5,4,4.0,9,0.4444444444444444
261825500,7,21,7.0,28,0.25
261838893,1,9,1.0,10,0.1
261841389,1,8,1.0,9,0.1111111111111111
261845425,6,4,4.0,10,0.4
261861493,5,5,5.0,10,0.5
261883153,2,8,2.0,10,0.2
261886443,5,4,4.0,9,0.4444444444444444
261887167,1,8,1.0,9,0.1111111111111111
261907895,2,6,2.0,8,0.25
261926600,7,2,2.0,9,0.2222222222222222
261987087,1,14,1.0,15,0.06666666666666667
262021053,6,4,4.0,10,0.4
262021360,2,17,2.0,19,0.10526315789473684
262042576,1,9,1.0,10,0.1
262075889,1,18,1.0,19,0.05263157894736842
262104492,6,3,3.0,9,0.3333333333333333
262105237,1,15,1.0,16,0.0625
262141773,1,8,1.0,9,0.1111111111111111
262149453,8,21,8.0,29,0.27586206896551724
262184000,2,7,2.0,9,0.2222222222222222
262206251,1,9,1.0,10,0.1
262271995,4,5,4.0,9,0.4444444444444444
262284875,2,7,2.0,9,0.2222222222222222
262307783,25,3,3.0,28,0.10714285714285714
262354875,2,7,2.0,9,0.2222222222222222
262360416,3,7,3.0,10,0.3
262360693,1,9,1.0,10,0.1
262396559,6,4,4.0,10,0.4
262397255,6,3,3.0,9,0.3333333333333333
262403693,5,4,4.0,9,0.4444444444444444
262406093,3,7,3.0,10,0.3
262421329,1,9,1.0,10,0.1
262427659,1,8,1.0,9,0.1111111111111111
262433690,2,16,2.0,18,0.1111111111111111
262460569,2,7,2.0,9,0.2222222222222222
262461396,5,4,4.0,9,0.4444444444444444
262461877,1,8,1.0,9,0.1111111111111111
262477612,2,8,2.0,10,0.2
262487253,1,8,1.0,9,0.1111111111111111
262494307,4,6,4.0,10,0.4
262495133,2,7,2.0,9,0.2222222222222222
262511546,1,9,1.0,10,0.1
262539306,2,7,2.0,9,0.2222222222222222
262606049,2,7,2.0,9,0.2222222222222222
262611698,25,3,3.0,28,0.10714285714285714
262668453,2,8,2.0,10,0.2
262671876,1,18,1.0,19,0.05263157894736842
262739461,1,9,1.0,10,0.1
262744227,1,9,1.0,10,0.1
262749638,3,6,3.0,9,0.3333333333333333
262750561,6,3,3.0,9,0.3333333333333333
262754452,1,19,1.0,20,0.05
262755854,2,8,2.0,10,0.2
262810629,1,8,1.0,9,0.1111111111111111
262816200,9,1,1.0,10,0.1
262869772,3,6,3.0,9,0.3333333333333333
262885304,17,12,12.0,29,0.41379310344827586
262885915,8,1,1.0,9,0.1111111111111111
262911834,3,6,3.0,9,0.3333333333333333
262912454,2,8,2.0,10,0.2
262975013,2,28,2.0,30,0.06666666666666667
262975628,8,1,1.0,9,0.1111111111111111
262979103,3,6,3.0,9,0.3333333333333333
262979572,7,3,3.0,10,0.3
262981155,9,1,1.0,10,0.1
263021040,3,27,3.0,30,0.1
263036303,2,7,2.0,9,0.2222222222222222
263057079,6,4,4.0,10,0.4
263058923,1,8,1.0,9,0.1111111111111111
263059564,2,8,2.0,10,0.2
263077589,1,9,1.0,10,0.1
263083230,2,26,2.0,28,0.07142857142857142
263099722,1,9,1.0,10,0.1
263120492,6,22,6.0,28,0.21428571428571427
263144389,2,7,2.0,9,0.2222222222222222
263146353,1,25,1.0,26,0.038461538461538464
263149461,1,8,1.0,9,0.1111111111111111
263219144,1,9,1.0,10,0.1
263231376,9,1,1.0,10,0.1
263232380,1,9,1.0,10,0.1
263232659,1,8,1.0,9,0.1111111111111111
263235120,4,6,4.0,10,0.4
263246192,1,8,1.0,9,0.1111111111111111
263253520,6,4,4.0,10,0.4
263267839,1,17,1.0,18,0.05555555555555555
263273100,1,8,1.0,9,0.1111111111111111
263276598,8,1,1.0,9,0.1111111111111111
263300387,1,9,1.0,10,0.1
263315646,1,8,1.0,9,0.1111111111111111
263350554,5,5,5.0,10,0.5
263351300,4,6,4.0,10,0.4
263399005,7,3,3.0,10,0.3
263400045,1,17,1.0,18,0.05555555555555555
263420258,1,9,1.0,10,0.1
263420961,1,9,1.0,10,0.1
263425820,5,5,5.0,10,0.5
263435368,5,24,5.0,29,0.1724137931034483
263445331,8,2,2.0,10,0.2
263450770,5,5,5.0,10,0.5
263451557,5,3,3.0,8,0.375
263483586,1,9,1.0,10,0.1
263499552,1,18,1.0,19,0.05263157894736842
263550912,3,7,3.0,10,0.3
263655432,7,1,1.0,8,0.125
263703831,1,8,1.0,9,0.1111111111111111
263766157,2,7,2.0,9,0.2222222222222222
263771740,1,9,1.0,10,0.1
263775344,8,1,1.0,9,0.1111111111111111
263809989,10,19,10.0,29,0.3448275862068966
263811684,2,8,2.0,10,0.2
263830036,1,8,1.0,9,0.1111111111111111
263846389,3,7,3.0,10,0.3
263856873,1,9,1.0,10,0.1
263884570,1,18,1.0,19,0.05263157894736842
263885503,23,6,6.0,29,0.20689655172413793
263920628,2,8,2.0,10,0.2
263939669,5,4,4.0,9,0.4444444444444444
263939719,1,9,1.0,10,0.1
263958240,1,19,1.0,20,0.05
263972271,9,1,1.0,10,0.1
263991203,1,9,1.0,10,0.1
264010274,4,6,4.0,10,0.4
264012226,1,8,1.0,9,0.1111111111111111
264012248,1,7,1.0,8,0.125
264044591,1,17,1.0,18,0.05555555555555555
264063892,1,9,1.0,10,0.1
264066140,8,1,1.0,9,0.1111111111111111
264084806,1,8,1.0,9,0.1111111111111111
264110930,1,19,1.0,20,0.05
264122496,3,7,3.0,10,0.3
264125007,1,9,1.0,10,0.1
264129868,2,18,2.0,20,0.1
264190315,6,4,4.0,10,0.4
264207896,2,8,2.0,10,0.2
264209984,5,4,4.0,9,0.4444444444444444
264237642,3,14,3.0,17,0.17647058823529413
264247854,1,9,1.0,10,0.1
264264114,2,8,2.0,10,0.2
264264571,9,8,8.0,17,0.47058823529411764
264323237,1,8,1.0,9,0.1111111111111111
264362007,8,11,8.0,19,0.42105263157894735
264368694,2,8,2.0,10,0.2
264371340,3,6,3.0,9,0.3333333333333333
264436388,1,8,1.0,9,0.1111111111111111
264449370,9,1,1.0,10,0.1
264449650,18,2,2.0,20,0.1
264449761,1,19,1.0,20,0.05
264453548,1,8,1.0,9,0.1111111111111111
264454854,1,9,1.0,10,0.1
264467866,3,17,3.0,20,0.15
264505074,2,7,2.0,9,0.2222222222222222
264511362,8,2,2.0,10,0.2
264512227,8,1,1.0,9,0.1111111111111111
264513026,8,2,2.0,10,0.2
264513494,1,9,1.0,10,0.1
264514675,8,1,1.0,9,0.1111111111111111
264515849,2,8,2.0,10,0.2
264524168,2,17,2.0,19,0.10526315789473684
264530848,3,7,3.0,10,0.3
264534203,15,5,5.0,20,0.25
264535329,1,8,1.0,9,0.1111111111111111
264554526,20,9,9.0,29,0.3103448275862069
264563020,1,9,1.0,10,0.1
264565094,1,9,1.0,10,0.1
264565586,9,1,1.0,10,0.1
264566694,3,6,3.0,9,0.3333333333333333
264566926,5,4,4.0,9,0.4444444444444444
264567895,9,1,1.0,10,0.1
264582575,1,8,1.0,9,0.1111111111111111
264592393,2,7,2.0,9,0.2222222222222222
264592522,3,26,3.0,29,0.10344827586206896
264593090,2,6,2.0,8,0.25
264629069,3,7,3.0,10,0.3
264630174,8,2,2.0,10,0.2
264663726,3,7,3.0,10,0.3
264684044,1,9,1.0,10,0.1
264700827,1,8,1.0,9,0.1111111111111111
264716615,2,6,2.0,8,0.25
264717299,2,28,2.0,30,0.06666666666666667
264719733,5,5,5.0,10,0.5
264732082,18,10,10.0,28,0.35714285714285715
264742616,1,18,1.0,19,0.05263157894736842
264746339,9,1,1.0,10,0.1
264755426,2,8,2.0,10,0.2
264768152,2,8,2.0,10,0.2
264780655,2,8,2.0,10,0.2
264785282,6,14,6.0,20,0.3
264788492,1,9,1.0,10,0.1
264790706,1,8,1.0,9,0.1111111111111111
264792825,8,2,2.0,10,0.2
264795912,5,12,5.0,17,0.29411764705882354
264797466,1,9,1.0,10,0.1
264803399,3,7,3.0,10,0.3
264809067,3,7,3.0,10,0.3
264819833,5,4,4.0,9,0.4444444444444444
264833746,1,9,1.0,10,0.1
264837250,4,15,4.0,19,0.21052631578947367
264858613,6,4,4.0,10,0.4
264859744,1,9,1.0,10,0.1
264860252,1,9,1.0,10,0.1
264860405,1,9,1.0,10,0.1
264868585,2,8,2.0,10,0.2
264868885,1,9,1.0,10,0.1
264869331,3,7,3.0,10,0.3
264891315,1,9,1.0,10,0.1
264894818,2,8,2.0,10,0.2
264899564,8,2,2.0,10,0.2
264900469,1,8,1.0,9,0.1111111111111111
264901307,4,5,4.0,9,0.4444444444444444
264909602,1,8,1.0,9,0.1111111111111111
264910584,2,8,2.0,10,0.2
264917736,8,10,8.0,18,0.4444444444444444
264930258,6,4,4.0,10,0.4
264932899,3,7,3.0,10,0.3
264933252,6,4,4.0,10,0.4
264934140,2,6,2.0,8,0.25
264940039,9,1,1.0,10,0.1
264957742,1,9,1.0,10,0.1
264963261,27,1,1.0,28,0.03571428571428571
264964213,14,15,14.0,29,0.4827586206896552
264964919,18,5,5.0,23,0.21739130434782608
264968858,1,8,1.0,9,0.1111111111111111
264974003,2,7,2.0,9,0.2222222222222222
264977764,6,4,4.0,10,0.4
264978506,4,6,4.0,10,0.4
264985483,4,5,4.0,9,0.4444444444444444
264989187,2,8,2.0,10,0.2
264990358,1,19,1.0,20,0.05
264990774,2,14,2.0,16,0.125
264993776,2,15,2.0,17,0.11764705882352941
264994934,3,5,3.0,8,0.375
265000496,4,6,4.0,10,0.4
265002967,1,8,1.0,9,0.1111111111111111
265021138,9,1,1.0,10,0.1
265021765,6,3,3.0,9,0.3333333333333333
265041381,4,15,4.0,19,0.21052631578947367
265041435,2,8,2.0,10,0.2
265051842,1,9,1.0,10,0.1
265056030,3,5,3.0,8,0.375
265057112,2,7,2.0,9,0.2222222222222222
265059052,2,26,2.0,28,0.07142857142857142
265061369,1,9,1.0,10,0.1
265074266,1,19,1.0,20,0.05
265079542,1,8,1.0,9,0.1111111111111111
265079594,3,6,3.0,9,0.3333333333333333
265123832,3,7,3.0,10,0.3
265135377,1,8,1.0,9,0.1111111111111111
265139983,2,7,2.0,9,0.2222222222222222
265141751,2,7,2.0,9,0.2222222222222222
265143793,2,26,2.0,28,0.07142857142857142
265199964,1,8,1.0,9,0.1111111111111111
265233274,5,5,5.0,10,0.5
265245791,1,9,1.0,10,0.1
265252578,9,1,1.0,10,0.1
265338155,9,18,9.0,27,0.3333333333333333
265338736,1,9,1.0,10,0.1
265349851,5,5,5.0,10,0.5
265361225,1,17,1.0,18,0.05555555555555555
265381477,1,8,1.0,9,0.1111111111111111
265399050,1,8,1.0,9,0.1111111111111111
265412585,1,18,1.0,19,0.05263157894736842
265431805,2,8,2.0,10,0.2
265440895,3,7,3.0,10,0.3
265441352,2,8,2.0,10,0.2
265442811,2,8,2.0,10,0.2
265443066,1,9,1.0,10,0.1
265443146,1,9,1.0,10,0.1
265443682,3,7,3.0,10,0.3
265447422,4,6,4.0,10,0.4
265447815,1,8,1.0,9,0.1111111111111111
265452175,1,9,1.0,10,0.1
265551655,5,4,4.0,9,0.4444444444444444
265585318,6,3,3.0,9,0.3333333333333333
265588659,1,9,1.0,10,0.1
265588709,1,9,1.0,10,0.1
265592804,2,8,2.0,10,0.2
265597347,1,9,1.0,10,0.1
265673289,5,15,5.0,20,0.25
265710934,1,7,1.0,8,0.125
265733727,2,8,2.0,10,0.2
265735763,2,8,2.0,10,0.2
265741549,2,7,2.0,9,0.2222222222222222
265747543,1,8,1.0,9,0.1111111111111111
265750834,1,17,1.0,18,0.05555555555555555
265750978,1,9,1.0,10,0.1
265753428,22,1,1.0,23,0.043478260869565216
265753943,4,6,4.0,10,0.4
265757911,5,4,4.0,9,0.4444444444444444
265763321,2,8,2.0,10,0.2
265765055,1,7,1.0,8,0.125
265771960,7,16,7.0,23,0.30434782608695654
265784210,1,8,1.0,9,0.1111111111111111
265786880,6,4,4.0,10,0.4
265789123,1,8,1.0,9,0.1111111111111111
265789341,3,14,3.0,17,0.17647058823529413
265795241,1,8,1.0,9,0.1111111111111111
265831893,1,9,1.0,10,0.1
265853667,1,8,1.0,9,0.1111111111111111
265877829,1,9,1.0,10,0.1
265878596,2,7,2.0,9,0.2222222222222222
265906806,1,8,1.0,9,0.1111111111111111
265951324,1,8,1.0,9,0.1111111111111111
265953125,1,8,1.0,9,0.1111111111111111
265964869,2,8,2.0,10,0.2
265966301,1,8,1.0,9,0.1111111111111111
265973790,5,23,5.0,28,0.17857142857142858
265980466,8,1,1.0,9,0.1111111111111111
265984366,22,8,8.0,30,0.26666666666666666
265991412,1,9,1.0,10,0.1
266010566,2,8,2.0,10,0.2
266031465,5,5,5.0,10,0.5
266035521,1,9,1.0,10,0.1
266036693,7,3,3.0,10,0.3
266038125,2,7,2.0,9,0.2222222222222222
266038631,6,21,6.0,27,0.2222222222222222
266039176,1,9,1.0,10,0.1
266041577,1,9,1.0,10,0.1
266044782,9,18,9.0,27,0.3333333333333333
266046305,1,17,1.0,18,0.05555555555555555
266048717,2,8,2.0,10,0.2
266052320,2,6,2.0,8,0.25
266052647,2,6,2.0,8,0.25
266058520,5,3,3.0,8,0.375
266074372,5,5,5.0,10,0.5
266082117,6,2,2.0,8,0.25
266089494,5,4,4.0,9,0.4444444444444444
266183448,4,6,4.0,10,0.4
266203098,1,9,1.0,10,0.1
266206872,1,8,1.0,9,0.1111111111111111
266207246,1,8,1.0,9,0.1111111111111111
266214579,11,7,7.0,18,0.3888888888888889
266216225,6,3,3.0,9,0.3333333333333333
266216938,5,3,3.0,8,0.375
266224289,3,6,3.0,9,0.3333333333333333
266226844,8,1,1.0,9,0.1111111111111111
266227614,6,14,6.0,20,0.3
266229108,3,7,3.0,10,0.3
266249006,9,1,1.0,10,0.1
266265201,1,9,1.0,10,0.1
266297855,1,9,1.0,10,0.1
266308510,1,9,1.0,10,0.1
266308700,3,6,3.0,9,0.3333333333333333
266309939,1,8,1.0,9,0.1111111111111111
266330683,4,4,4.0,8,0.5
266338853,1,9,1.0,10,0.1
266352695,1,9,1.0,10,0.1
266390995,7,2,2.0,9,0.2222222222222222
266394015,4,6,4.0,10,0.4
266395390,6,4,4.0,10,0.4
266398342,4,6,4.0,10,0.4
266400997,3,6,3.0,9,0.3333333333333333
266403368,1,9,1.0,10,0.1
266404229,4,5,4.0,9,0.4444444444444444
266404482,1,9,1.0,10,0.1
266405319,1,8,1.0,9,0.1111111111111111
266406405,2,7,2.0,9,0.2222222222222222
266406710,3,7,3.0,10,0.3
266427777,1,9,1.0,10,0.1
266429734,3,6,3.0,9,0.3333333333333333
266468805,8,2,2.0,10,0.2
266490663,1,8,1.0,9,0.1111111111111111
266495271,1,9,1.0,10,0.1
266495881,2,7,2.0,9,0.2222222222222222
266496132,1,9,1.0,10,0.1
266497719,1,9,1.0,10,0.1
266501901,1,8,1.0,9,0.1111111111111111
266502666,1,9,1.0,10,0.1
266502848,2,8,2.0,10,0.2
266506727,1,9,1.0,10,0.1
266516572,2,7,2.0,9,0.2222222222222222
266526915,1,9,1.0,10,0.1
266529896,1,18,1.0,19,0.05263157894736842
266531314,4,4,4.0,8,0.5
266544205,1,8,1.0,9,0.1111111111111111
266570450,4,6,4.0,10,0.4
266574207,2,8,2.0,10,0.2
266580287,1,19,1.0,20,0.05
266584449,2,8,2.0,10,0.2
266647287,1,17,1.0,18,0.05555555555555555
266651781,1,7,1.0,8,0.125
266652941,2,7,2.0,9,0.2222222222222222
266655086,2,7,2.0,9,0.2222222222222222
266660305,2,18,2.0,20,0.1
266668386,1,9,1.0,10,0.1
266669855,2,7,2.0,9,0.2222222222222222
266672749,1,8,1.0,9,0.1111111111111111
266679741,3,5,3.0,8,0.375
266722951,2,7,2.0,9,0.2222222222222222
266741502,1,18,1.0,19,0.05263157894736842
266750927,4,5,4.0,9,0.4444444444444444
266764864,5,5,5.0,10,0.5
266773808,1,9,1.0,10,0.1
266783031,1,8,1.0,9,0.1111111111111111
266785193,1,9,1.0,10,0.1
266816696,9,1,1.0,10,0.1
266834729,7,2,2.0,9,0.2222222222222222
266844117,2,17,2.0,19,0.10526315789473684
266865240,2,7,2.0,9,0.2222222222222222
266872006,4,5,4.0,9,0.4444444444444444
266908978,4,6,4.0,10,0.4
266916106,6,4,4.0,10,0.4
266944650,1,8,1.0,9,0.1111111111111111
266944947,3,7,3.0,10,0.3
266948092,3,7,3.0,10,0.3
266972060,1,18,1.0,19,0.05263157894736842
266974294,2,7,2.0,9,0.2222222222222222
266983019,1,9,1.0,10,0.1
266992583,8,1,1.0,9,0.1111111111111111
266994511,1,19,1.0,20,0.05
267014683,1,9,1.0,10,0.1
267030196,1,9,1.0,10,0.1
267039771,4,6,4.0,10,0.4
267040013,4,5,4.0,9,0.4444444444444444
267040073,6,4,4.0,10,0.4
267040140,7,3,3.0,10,0.3
267040393,8,1,1.0,9,0.1111111111111111
267040540,8,2,2.0,10,0.2
267040769,5,4,4.0,9,0.4444444444444444
267040835,4,6,4.0,10,0.4
267041110,7,3,3.0,10,0.3
267041115,9,1,1.0,10,0.1
267041206,7,3,3.0,10,0.3
267041433,3,6,3.0,9,0.3333333333333333
267041737,23,2,2.0,25,0.08
267041774,5,3,3.0,8,0.375
267043551,1,9,1.0,10,0.1
267053803,1,9,1.0,10,0.1
267056561,3,25,3.0,28,0.10714285714285714
267057051,1,9,1.0,10,0.1
267059785,3,7,3.0,10,0.3
267061665,2,8,2.0,10,0.2
267066110,1,18,1.0,19,0.05263157894736842
267082952,2,7,2.0,9,0.2222222222222222
267089311,1,19,1.0,20,0.05
267101523,1,16,1.0,17,0.058823529411764705
267129502,1,9,1.0,10,0.1
267150870,1,9,1.0,10,0.1
267182377,1,8,1.0,9,0.1111111111111111
267186379,2,8,2.0,10,0.2
267187127,1,8,1.0,9,0.1111111111111111
267187478,1,9,1.0,10,0.1
267187715,1,18,1.0,19,0.05263157894736842
267189431,7,3,3.0,10,0.3
267190174,4,23,4.0,27,0.14814814814814814
267191378,4,6,4.0,10,0.4
267192904,1,9,1.0,10,0.1
267192994,4,6,4.0,10,0.4
267195849,1,9,1.0,10,0.1
267203012,9,20,9.0,29,0.3103448275862069
267203651,2,8,2.0,10,0.2
267204188,1,8,1.0,9,0.1111111111111111
267205511,2,8,2.0,10,0.2
267208842,7,3,3.0,10,0.3
267226008,6,4,4.0,10,0.4
267232131,3,6,3.0,9,0.3333333333333333
267234202,7,3,3.0,10,0.3
267234781,2,7,2.0,9,0.2222222222222222
267241445,1,9,1.0,10,0.1
267274073,6,4,4.0,10,0.4
267274709,24,4,4.0,28,0.14285714285714285
267277962,7,3,3.0,10,0.3
267285255,1,9,1.0,10,0.1
267292613,2,7,2.0,9,0.2222222222222222
267322490,19,1,1.0,20,0.05
267325925,8,11,8.0,19,0.42105263157894735
267334659,3,7,3.0,10,0.3
267335342,1,8,1.0,9,0.1111111111111111
267335722,3,7,3.0,10,0.3
267351965,1,18,1.0,19,0.05263157894736842
267353564,2,8,2.0,10,0.2
267353860,2,8,2.0,10,0.2
267370529,24,5,5.0,29,0.1724137931034483
267373031,1,9,1.0,10,0.1
267374887,9,20,9.0,29,0.3103448275862069
267375450,4,6,4.0,10,0.4
267375978,5,24,5.0,29,0.1724137931034483
267377703,1,9,1.0,10,0.1
267380389,3,7,3.0,10,0.3
267389299,1,19,1.0,20,0.05
267395088,1,9,1.0,10,0.1
267396066,5,3,3.0,8,0.375
267397200,4,6,4.0,10,0.4
267451370,6,4,4.0,10,0.4
267477720,3,5,3.0,8,0.375
267520234,1,9,1.0,10,0.1
267523923,6,4,4.0,10,0.4
267551599,1,9,1.0,10,0.1
267564763,1,9,1.0,10,0.1
267567143,2,8,2.0,10,0.2
267591505,8,2,2.0,10,0.2
267596515,1,9,1.0,10,0.1
267623629,1,9,1.0,10,0.1
267630804,3,17,3.0,20,0.15
267652936,2,8,2.0,10,0.2
267674288,7,3,3.0,10,0.3
267690490,1,19,1.0,20,0.05
267703843,2,8,2.0,10,0.2
267743458,8,2,2.0,10,0.2
267744187,1,19,1.0,20,0.05
267755708,6,3,3.0,9,0.3333333333333333
267756787,3,6,3.0,9,0.3333333333333333
267760434,1,9,1.0,10,0.1
267766486,1,18,1.0,19,0.05263157894736842
267766539,9,1,1.0,10,0.1
267768688,3,17,3.0,20,0.15
267771580,3,5,3.0,8,0.375
267779112,5,4,4.0,9,0.4444444444444444
267791522,9,1,1.0,10,0.1
267797136,5,5,5.0,10,0.5
267828342,5,5,5.0,10,0.5
267872519,1,9,1.0,10,0.1
267873835,1,7,1.0,8,0.125
267897161,1,7,1.0,8,0.125
267930712,1,9,1.0,10,0.1
267934444,2,8,2.0,10,0.2
267935357,2,7,2.0,9,0.2222222222222222
267957318,1,9,1.0,10,0.1
267969028,1,28,1.0,29,0.034482758620689655
267969698,1,26,1.0,27,0.037037037037037035
267990931,1,9,1.0,10,0.1
267998030,1,9,1.0,10,0.1
268014970,1,18,1.0,19,0.05263157894736842
268039910,1,19,1.0,20,0.05
268076083,5,14,5.0,19,0.2631578947368421
268078858,7,2,2.0,9,0.2222222222222222
268082937,8,2,2.0,10,0.2
268085638,5,4,4.0,9,0.4444444444444444
268086359,27,2,2.0,29,0.06896551724137931
268087990,28,1,1.0,29,0.034482758620689655
268088921,7,3,3.0,10,0.3
268106298,9,1,1.0,10,0.1
268141928,2,7,2.0,9,0.2222222222222222
268143427,1,9,1.0,10,0.1
268167231,2,7,2.0,9,0.2222222222222222
268168267,1,9,1.0,10,0.1
268169749,3,27,3.0,30,0.1
268174414,2,8,2.0,10,0.2
268177704,2,8,2.0,10,0.2
268177869,7,3,3.0,10,0.3
268201173,2,25,2.0,27,0.07407407407407407
268204981,1,9,1.0,10,0.1
268207042,4,6,4.0,10,0.4
268209014,1,7,1.0,8,0.125
268210835,2,7,2.0,9,0.2222222222222222
268211324,5,13,5.0,18,0.2777777777777778
268211395,5,3,3.0,8,0.375
268211993,3,6,3.0,9,0.3333333333333333
268212694,4,25,4.0,29,0.13793103448275862
268214392,1,9,1.0,10,0.1
268215794,1,8,1.0,9,0.1111111111111111
268220283,1,9,1.0,10,0.1
268223175,24,4,4.0,28,0.14285714285714285
268239310,1,8,1.0,9,0.1111111111111111
268250939,4,24,4.0,28,0.14285714285714285
268251520,2,26,2.0,28,0.07142857142857142
268272648,1,19,1.0,20,0.05
268278973,4,5,4.0,9,0.4444444444444444
268281952,1,9,1.0,10,0.1
268315314,2,8,2.0,10,0.2
268327861,12,6,6.0,18,0.3333333333333333
268328518,2,7,2.0,9,0.2222222222222222
268331494,2,7,2.0,9,0.2222222222222222
268335090,1,9,1.0,10,0.1
268361803,1,9,1.0,10,0.1
268364384,12,17,12.0,29,0.41379310344827586
268365033,1,9,1.0,10,0.1
268400730,2,6,2.0,8,0.25
268406555,24,4,4.0,28,0.14285714285714285
268487692,8,2,2.0,10,0.2
268498658,3,5,3.0,8,0.375
268533561,5,5,5.0,10,0.5
268539267,1,7,1.0,8,0.125
268552215,7,11,7.0,18,0.3888888888888889
268554288,8,1,1.0,9,0.1111111111111111
268580316,1,17,1.0,18,0.05555555555555555
268596420,1,18,1.0,19,0.05263157894736842
268603209,1,9,1.0,10,0.1
268603405,1,9,1.0,10,0.1
268606743,2,26,2.0,28,0.07142857142857142
268607843,1,18,1.0,19,0.05263157894736842
268608297,5,4,4.0,9,0.4444444444444444
268620596,1,9,1.0,10,0.1
268631355,4,6,4.0,10,0.4
268631582,3,6,3.0,9,0.3333333333333333
268665844,3,6,3.0,9,0.3333333333333333
268716496,6,3,3.0,9,0.3333333333333333
268743335,1,9,1.0,10,0.1
268780665,3,17,3.0,20,0.15
268781041,27,1,1.0,28,0.03571428571428571
268783848,4,5,4.0,9,0.4444444444444444
268796522,3,7,3.0,10,0.3
268797961,6,4,4.0,10,0.4
268798507,1,9,1.0,10,0.1
268803636,2,7,2.0,9,0.2222222222222222
268822414,1,9,1.0,10,0.1
268850810,1,8,1.0,9,0.1111111111111111
268865626,5,14,5.0,19,0.2631578947368421
268875972,1,9,1.0,10,0.1
268876321,2,6,2.0,8,0.25
268877019,5,4,4.0,9,0.4444444444444444
268879744,8,2,2.0,10,0.2
268885906,2,6,2.0,8,0.25
268890437,1,9,1.0,10,0.1
268890755,1,9,1.0,10,0.1
268935285,1,9,1.0,10,0.1
268960982,4,5,4.0,9,0.4444444444444444
268986788,1,9,1.0,10,0.1
269028446,3,7,3.0,10,0.3
269031312,2,8,2.0,10,0.2
269035919,4,6,4.0,10,0.4
269055372,1,7,1.0,8,0.125
269091534,1,8,1.0,9,0.1111111111111111
269134458,5,4,4.0,9,0.4444444444444444
269134510,2,7,2.0,9,0.2222222222222222
269138902,1,9,1.0,10,0.1
269139201,1,9,1.0,10,0.1
269160945,1,17,1.0,18,0.05555555555555555
269160975,3,7,3.0,10,0.3
269162544,8,1,1.0,9,0.1111111111111111
269163020,5,5,5.0,10,0.5
269196803,1,9,1.0,10,0.1
269198178,1,9,1.0,10,0.1
269200292,5,5,5.0,10,0.5
269205091,3,7,3.0,10,0.3
269218596,1,17,1.0,18,0.05555555555555555
269225767,1,9,1.0,10,0.1
269247004,1,9,1.0,10,0.1
269281703,2,15,2.0,17,0.11764705882352941
269339357,1,9,1.0,10,0.1
269341038,1,9,1.0,10,0.1
269342552,5,4,4.0,9,0.4444444444444444
269357298,2,18,2.0,20,0.1
269359325,1,8,1.0,9,0.1111111111111111
269372035,2,8,2.0,10,0.2
269374133,2,8,2.0,10,0.2
269375915,3,6,3.0,9,0.3333333333333333
269389880,2,8,2.0,10,0.2
269393763,1,9,1.0,10,0.1
269404453,1,9,1.0,10,0.1
269405275,1,9,1.0,10,0.1
269407020,1,28,1.0,29,0.034482758620689655
269410932,1,8,1.0,9,0.1111111111111111
269422100,1,29,1.0,30,0.03333333333333333
269443695,2,8,2.0,10,0.2
269445103,1,9,1.0,10,0.1
269446838,3,7,3.0,10,0.3
269447457,9,1,1.0,10,0.1
269449744,21,7,7.0,28,0.25
269454629,2,17,2.0,19,0.10526315789473684
269474859,8,1,1.0,9,0.1111111111111111
269475220,4,14,4.0,18,0.2222222222222222
269495570,1,8,1.0,9,0.1111111111111111
269499423,1,9,1.0,10,0.1
269505883,2,8,2.0,10,0.2
269511615,9,1,1.0,10,0.1
269526808,4,6,4.0,10,0.4
269537949,2,7,2.0,9,0.2222222222222222
269540170,9,1,1.0,10,0.1
269541245,2,8,2.0,10,0.2
269545926,1,9,1.0,10,0.1
269545939,1,9,1.0,10,0.1
269548224,8,2,2.0,10,0.2
269555512,1,9,1.0,10,0.1
269560156,1,9,1.0,10,0.1
269590646,1,9,1.0,10,0.1
269610172,4,26,4.0,30,0.13333333333333333
269612041,1,7,1.0,8,0.125
269619101,3,7,3.0,10,0.3
269619645,5,4,4.0,9,0.4444444444444444
269620567,2,8,2.0,10,0.2
269620893,21,8,8.0,29,0.27586206896551724
269626138,4,6,4.0,10,0.4
269626732,3,6,3.0,9,0.3333333333333333
269628400,1,8,1.0,9,0.1111111111111111
269629781,2,8,2.0,10,0.2
269629925,3,7,3.0,10,0.3
269630031,8,1,1.0,9,0.1111111111111111
269632410,2,8,2.0,10,0.2
269639361,6,4,4.0,10,0.4
269644398,9,1,1.0,10,0.1
269644512,4,4,4.0,8,0.5
269658025,1,18,1.0,19,0.05263157894736842
269666572,1,9,1.0,10,0.1
269669008,6,3,3.0,9,0.3333333333333333
269669076,9,1,1.0,10,0.1
269669437,5,4,4.0,9,0.4444444444444444
269701166,9,1,1.0,10,0.1
269712981,8,1,1.0,9,0.1111111111111111
269715016,1,9,1.0,10,0.1
269715243,6,3,3.0,9,0.3333333333333333
269715635,5,5,5.0,10,0.5
269717321,7,3,3.0,10,0.3
269722057,1,8,1.0,9,0.1111111111111111
269742686,6,3,3.0,9,0.3333333333333333
269744091,1,8,1.0,9,0.1111111111111111
269744391,2,8,2.0,10,0.2
269769154,11,16,11.0,27,0.4074074074074074
269769164,2,8,2.0,10,0.2
269773119,8,1,1.0,9,0.1111111111111111
269773273,5,5,5.0,10,0.5
269831010,2,8,2.0,10,0.2
269833416,3,5,3.0,8,0.375
269855490,2,6,2.0,8,0.25
269884284,2,7,2.0,9,0.2222222222222222
269899450,4,6,4.0,10,0.4
269914796,7,2,2.0,9,0.2222222222222222
269922080,12,8,8.0,20,0.4
269927585,4,15,4.0,19,0.21052631578947367
269928303,3,6,3.0,9,0.3333333333333333
269929857,1,7,1.0,8,0.125
269930299,1,8,1.0,9,0.1111111111111111
269930872,1,9,1.0,10,0.1
269931036,5,3,3.0,8,0.375
269931295,1,28,1.0,29,0.034482758620689655
269933201,4,6,4.0,10,0.4
269935922,3,7,3.0,10,0.3
269936113,5,5,5.0,10,0.5
269938251,3,6,3.0,9,0.3333333333333333
269939836,1,8,1.0,9,0.1111111111111111
269962120,1,9,1.0,10,0.1
270004458,4,24,4.0,28,0.14285714285714285
270016254,9,1,1.0,10,0.1
270022547,2,7,2.0,9,0.2222222222222222
270041505,1,8,1.0,9,0.1111111111111111
270053277,7,2,2.0,9,0.2222222222222222
270059334,1,8,1.0,9,0.1111111111111111
270060592,4,6,4.0,10,0.4
270072272,1,9,1.0,10,0.1
270078896,4,6,4.0,10,0.4
270080043,1,9,1.0,10,0.1
270087142,15,15,15.0,30,0.5
270088873,2,8,2.0,10,0.2
270092842,8,2,2.0,10,0.2
270093082,1,9,1.0,10,0.1
270103494,2,8,2.0,10,0.2
270107813,4,5,4.0,9,0.4444444444444444
270108486,3,7,3.0,10,0.3
270118374,5,4,4.0,9,0.4444444444444444
270145658,2,8,2.0,10,0.2
270147163,1,9,1.0,10,0.1
270153102,2,8,2.0,10,0.2
270182448,2,8,2.0,10,0.2
270183057,5,5,5.0,10,0.5
270190697,4,4,4.0,8,0.5
270211329,1,9,1.0,10,0.1
270215195,2,7,2.0,9,0.2222222222222222
270223797,1,9,1.0,10,0.1
270227105,29,1,1.0,30,0.03333333333333333
270227263,8,2,2.0,10,0.2
270227815,8,1,1.0,9,0.1111111111111111
270234000,1,7,1.0,8,0.125
270252654,1,8,1.0,9,0.1111111111111111
270264102,8,10,8.0,18,0.4444444444444444
270285940,1,9,1.0,10,0.1
270298750,3,7,3.0,10,0.3
270299471,1,9,1.0,10,0.1
270306443,4,5,4.0,9,0.4444444444444444
270311432,3,7,3.0,10,0.3
270312992,1,8,1.0,9,0.1111111111111111
270315474,5,4,4.0,9,0.4444444444444444
270319312,3,23,3.0,26,0.11538461538461539
270353358,1,9,1.0,10,0.1
270353485,3,6,3.0,9,0.3333333333333333
270359627,1,7,1.0,8,0.125
270365395,1,9,1.0,10,0.1
270372906,8,1,1.0,9,0.1111111111111111
270380935,1,8,1.0,9,0.1111111111111111
270385976,1,8,1.0,9,0.1111111111111111
270396776,1,18,1.0,19,0.05263157894736842
270407799,3,5,3.0,8,0.375
270408622,5,4,4.0,9,0.4444444444444444
270409814,7,1,1.0,8,0.125
270415678,3,7,3.0,10,0.3
270435225,1,8,1.0,9,0.1111111111111111
270445383,8,22,8.0,30,0.26666666666666666
270457964,2,7,2.0,9,0.2222222222222222
270461463,1,18,1.0,19,0.05263157894736842
270488659,9,1,1.0,10,0.1
270499136,1,19,1.0,20,0.05
270539065,7,2,2.0,9,0.2222222222222222
270544161,3,16,3.0,19,0.15789473684210525
270573179,7,3,3.0,10,0.3
270584047,5,3,3.0,8,0.375
270587014,1,8,1.0,9,0.1111111111111111
270587949,9,1,1.0,10,0.1
270594513,1,19,1.0,20,0.05
270615662,2,7,2.0,9,0.2222222222222222
270679067,6,3,3.0,9,0.3333333333333333
270693132,2,8,2.0,10,0.2
270695863,2,7,2.0,9,0.2222222222222222
270698744,1,8,1.0,9,0.1111111111111111
270715990,1,17,1.0,18,0.05555555555555555
270752988,3,16,3.0,19,0.15789473684210525
270783818,7,3,3.0,10,0.3
270799879,23,4,4.0,27,0.14814814814814814
270803621,8,2,2.0,10,0.2
270804453,8,2,2.0,10,0.2
270804873,5,5,5.0,10,0.5
270805258,5,5,5.0,10,0.5
270806153,1,8,1.0,9,0.1111111111111111
270810139,1,9,1.0,10,0.1
270814574,1,9,1.0,10,0.1
270821313,1,8,1.0,9,0.1111111111111111
270841750,1,8,1.0,9,0.1111111111111111
270846433,5,5,5.0,10,0.5
270863408,6,4,4.0,10,0.4
270863868,9,1,1.0,10,0.1
270875140,3,7,3.0,10,0.3
270881476,2,7,2.0,9,0.2222222222222222
270881937,1,9,1.0,10,0.1
270884338,4,14,4.0,18,0.2222222222222222
270884492,2,7,2.0,9,0.2222222222222222
270887744,3,6,3.0,9,0.3333333333333333
270890007,26,3,3.0,29,0.10344827586206896
270928557,3,24,3.0,27,0.1111111111111111
270941188,6,3,3.0,9,0.3333333333333333
270956317,1,18,1.0,19,0.05263157894736842
270966772,1,9,1.0,10,0.1
270972051,1,9,1.0,10,0.1
270979372,1,7,1.0,8,0.125
270984124,2,7,2.0,9,0.2222222222222222
270986005,4,4,4.0,8,0.5
270998864,6,4,4.0,10,0.4
271003047,1,8,1.0,9,0.1111111111111111
271007122,3,7,3.0,10,0.3
271015157,2,7,2.0,9,0.2222222222222222
271015560,1,9,1.0,10,0.1
271019264,1,9,1.0,10,0.1
271027216,1,9,1.0,10,0.1
271027970,1,9,1.0,10,0.1
271030396,2,6,2.0,8,0.25
271054766,2,7,2.0,9,0.2222222222222222
271059585,4,5,4.0,9,0.4444444444444444
271059937,5,25,5.0,30,0.16666666666666666
271065200,1,9,1.0,10,0.1
271066199,2,8,2.0,10,0.2
271066281,5,5,5.0,10,0.5
271081952,2,6,2.0,8,0.25
271084011,5,23,5.0,28,0.17857142857142858
271102964,1,9,1.0,10,0.1
271114842,4,5,4.0,9,0.4444444444444444
271117204,1,8,1.0,9,0.1111111111111111
271121730,2,18,2.0,20,0.1
271124298,1,9,1.0,10,0.1
271127409,1,9,1.0,10,0.1
271131341,3,5,3.0,8,0.375
271131636,3,7,3.0,10,0.3
271174403,1,9,1.0,10,0.1
271182464,1,7,1.0,8,0.125
271212000,3,6,3.0,9,0.3333333333333333
271215249,1,7,1.0,8,0.125
271225816,4,6,4.0,10,0.4
271240885,1,9,1.0,10,0.1
271250651,1,9,1.0,10,0.1
271258927,1,9,1.0,10,0.1
271281153,1,9,1.0,10,0.1
271282347,3,6,3.0,9,0.3333333333333333
271294374,5,4,4.0,9,0.4444444444444444
271296337,1,8,1.0,9,0.1111111111111111
271298919,1,9,1.0,10,0.1
271300036,9,1,1.0,10,0.1
271317653,3,5,3.0,8,0.375
271334409,11,18,11.0,29,0.3793103448275862
271354930,3,7,3.0,10,0.3
271367883,1,9,1.0,10,0.1
271370188,4,5,4.0,9,0.4444444444444444
271371436,1,9,1.0,10,0.1
271379624,2,8,2.0,10,0.2
271426293,9,1,1.0,10,0.1
271428216,26,1,1.0,27,0.037037037037037035
271431221,26,4,4.0,30,0.13333333333333333
271432959,7,3,3.0,10,0.3
271439704,8,2,2.0,10,0.2
271452068,3,7,3.0,10,0.3
271462474,9,1,1.0,10,0.1
271463830,3,7,3.0,10,0.3
271467532,2,8,2.0,10,0.2
271476362,2,17,2.0,19,0.10526315789473684
271477695,2,17,2.0,19,0.10526315789473684
271493872,2,7,2.0,9,0.2222222222222222
271497848,1,18,1.0,19,0.05263157894736842
271505201,9,1,1.0,10,0.1
271519184,7,1,1.0,8,0.125
271522503,1,9,1.0,10,0.1
271529459,8,1,1.0,9,0.1111111111111111
271534876,1,8,1.0,9,0.1111111111111111
271535222,3,6,3.0,9,0.3333333333333333
271600068,6,4,4.0,10,0.4
271634717,1,9,1.0,10,0.1
271671732,9,1,1.0,10,0.1
271672223,8,1,1.0,9,0.1111111111111111
271676572,7,1,1.0,8,0.125
271695288,2,8,2.0,10,0.2
271697017,2,7,2.0,9,0.2222222222222222
271713509,9,10,9.0,19,0.47368421052631576
271715629,2,7,2.0,9,0.2222222222222222
271734400,1,9,1.0,10,0.1
271737376,2,8,2.0,10,0.2
271738396,1,9,1.0,10,0.1
271753218,1,18,1.0,19,0.05263157894736842
271819981,1,8,1.0,9,0.1111111111111111
271836187,1,8,1.0,9,0.1111111111111111
271862690,1,9,1.0,10,0.1
271864772,4,6,4.0,10,0.4
271871706,2,8,2.0,10,0.2
271873047,1,8,1.0,9,0.1111111111111111
271897660,3,17,3.0,20,0.15
271914607,1,9,1.0,10,0.1
271915396,2,8,2.0,10,0.2
271944832,2,8,2.0,10,0.2
271967716,2,8,2.0,10,0.2
271988332,1,9,1.0,10,0.1
271988355,7,3,3.0,10,0.3
271988860,11,17,11.0,28,0.39285714285714285
271989281,1,8,1.0,9,0.1111111111111111
271990467,6,2,2.0,8,0.25
271990667,8,1,1.0,9,0.1111111111111111
271992655,1,17,1.0,18,0.05555555555555555
271993739,1,9,1.0,10,0.1
272005623,3,7,3.0,10,0.3
272007631,2,8,2.0,10,0.2
272010848,1,9,1.0,10,0.1
272031571,1,9,1.0,10,0.1
272032370,1,9,1.0,10,0.1
272039283,7,2,2.0,9,0.2222222222222222
272041263,3,7,3.0,10,0.3
272054682,3,7,3.0,10,0.3
272058760,2,8,2.0,10,0.2
272088441,2,8,2.0,10,0.2
272096180,5,5,5.0,10,0.5
272099122,1,9,1.0,10,0.1
272109611,2,7,2.0,9,0.2222222222222222
272143359,19,10,10.0,29,0.3448275862068966
272143636,1,8,1.0,9,0.1111111111111111
272149133,3,7,3.0,10,0.3
272156335,1,8,1.0,9,0.1111111111111111
272157181,1,7,1.0,8,0.125
272163471,8,2,2.0,10,0.2
272163769,8,2,2.0,10,0.2
272164158,3,7,3.0,10,0.3
272164424,2,8,2.0,10,0.2
272165090,6,4,4.0,10,0.4
272170180,2,8,2.0,10,0.2
272204879,4,12,4.0,16,0.25
272245422,16,12,12.0,28,0.42857142857142855
272251697,3,7,3.0,10,0.3
272264965,1,9,1.0,10,0.1
272292310,3,7,3.0,10,0.3
272296035,2,8,2.0,10,0.2
272324224,7,2,2.0,9,0.2222222222222222
272355771,1,9,1.0,10,0.1
272364229,1,8,1.0,9,0.1111111111111111
272374769,3,7,3.0,10,0.3
272381824,2,26,2.0,28,0.07142857142857142
272383876,5,5,5.0,10,0.5
272413744,2,6,2.0,8,0.25
272415084,3,7,3.0,10,0.3
272421068,1,19,1.0,20,0.05
272428477,3,15,3.0,18,0.16666666666666666
272430453,1,9,1.0,10,0.1
272432790,3,6,3.0,9,0.3333333333333333
272440309,1,8,1.0,9,0.1111111111111111
272462564,2,17,2.0,19,0.10526315789473684
272488381,4,6,4.0,10,0.4
272494013,7,12,7.0,19,0.3684210526315789
272507926,1,9,1.0,10,0.1
272540484,2,18,2.0,20,0.1
272546974,7,3,3.0,10,0.3
272579257,1,19,1.0,20,0.05
272583671,5,5,5.0,10,0.5
272583768,1,9,1.0,10,0.1
272589536,8,1,1.0,9,0.1111111111111111
272593642,10,14,10.0,24,0.4166666666666667
272619338,2,18,2.0,20,0.1
272671935,8,2,2.0,10,0.2
272698135,1,19,1.0,20,0.05
272699736,1,9,1.0,10,0.1
272722971,1,9,1.0,10,0.1
272737096,6,4,4.0,10,0.4
272740229,9,1,1.0,10,0.1
272759387,3,7,3.0,10,0.3
272793802,3,6,3.0,9,0.3333333333333333
272806915,2,6,2.0,8,0.25
272808875,3,5,3.0,8,0.375
272828280,1,9,1.0,10,0.1
272828765,2,17,2.0,19,0.10526315789473684
272845494,1,9,1.0,10,0.1
272846012,8,2,2.0,10,0.2
272846244,9,1,1.0,10,0.1
272848797,3,6,3.0,9,0.3333333333333333
272856497,1,9,1.0,10,0.1
272892324,2,8,2.0,10,0.2
272932998,2,7,2.0,9,0.2222222222222222
272942529,2,8,2.0,10,0.2
272956129,1,8,1.0,9,0.1111111111111111
272963391,1,8,1.0,9,0.1111111111111111
272964798,4,6,4.0,10,0.4
272966580,7,18,7.0,25,0.28
272968677,2,6,2.0,8,0.25
272969895,3,6,3.0,9,0.3333333333333333
272970234,1,9,1.0,10,0.1
272974660,2,7,2.0,9,0.2222222222222222
272984241,8,11,8.0,19,0.42105263157894735
273002422,1,9,1.0,10,0.1
273010603,2,8,2.0,10,0.2
273015956,3,6,3.0,9,0.3333333333333333
273022968,1,9,1.0,10,0.1
273043240,2,7,2.0,9,0.2222222222222222
273046149,1,9,1.0,10,0.1
273046566,2,8,2.0,10,0.2
273060478,1,9,1.0,10,0.1
273061339,1,7,1.0,8,0.125
273070288,4,16,4.0,20,0.2
273087533,3,6,3.0,9,0.3333333333333333
273089159,4,6,4.0,10,0.4
273101293,1,9,1.0,10,0.1
273106311,1,9,1.0,10,0.1
273113820,1,16,1.0,17,0.058823529411764705
273155003,1,9,1.0,10,0.1
273164125,4,6,4.0,10,0.4
273164510,1,8,1.0,9,0.1111111111111111
273188639,9,1,1.0,10,0.1
273189375,8,1,1.0,9,0.1111111111111111
273199278,3,6,3.0,9,0.3333333333333333
273220797,2,18,2.0,20,0.1
273243329,1,9,1.0,10,0.1
273244885,1,9,1.0,10,0.1
273245999,28,1,1.0,29,0.034482758620689655
273248475,3,7,3.0,10,0.3
273250873,2,8,2.0,10,0.2
273253838,11,16,11.0,27,0.4074074074074074
273255480,4,5,4.0,9,0.4444444444444444
273279129,8,1,1.0,9,0.1111111111111111
273279415,2,8,2.0,10,0.2
273304453,8,1,1.0,9,0.1111111111111111
273305195,4,5,4.0,9,0.4444444444444444
273305778,9,1,1.0,10,0.1
273305949,6,3,3.0,9,0.3333333333333333
273315043,6,4,4.0,10,0.4
273321967,2,7,2.0,9,0.2222222222222222
273323603,8,1,1.0,9,0.1111111111111111
273340532,6,2,2.0,8,0.25
273341606,1,7,1.0,8,0.125
273395951,3,7,3.0,10,0.3
273407337,2,7,2.0,9,0.2222222222222222
273408746,1,9,1.0,10,0.1
273412364,1,8,1.0,9,0.1111111111111111
273419415,9,20,9.0,29,0.3103448275862069
273425617,1,9,1.0,10,0.1
273427868,1,9,1.0,10,0.1
273448965,3,7,3.0,10,0.3
273472286,5,5,5.0,10,0.5
273475602,1,9,1.0,10,0.1
273476573,1,9,1.0,10,0.1
273481810,2,18,2.0,20,0.1
273482345,1,8,1.0,9,0.1111111111111111
273483358,2,7,2.0,9,0.2222222222222222
273483635,1,9,1.0,10,0.1
273485387,1,9,1.0,10,0.1
273493771,1,9,1.0,10,0.1
273513911,1,9,1.0,10,0.1
273540775,28,1,1.0,29,0.034482758620689655
273542829,8,2,2.0,10,0.2
273543287,8,20,8.0,28,0.2857142857142857
273566963,2,7,2.0,9,0.2222222222222222
273567450,2,8,2.0,10,0.2
273567764,6,4,4.0,10,0.4
273568075,4,5,4.0,9,0.4444444444444444
273572367,1,9,1.0,10,0.1
273581175,3,7,3.0,10,0.3
273596771,3,5,3.0,8,0.375
273607515,1,18,1.0,19,0.05263157894736842
273623935,1,9,1.0,10,0.1
273628462,1,9,1.0,10,0.1
273649000,1,9,1.0,10,0.1
273662731,1,19,1.0,20,0.05
273663519,2,6,2.0,8,0.25
273664873,1,9,1.0,10,0.1
273669611,2,8,2.0,10,0.2
273669847,1,9,1.0,10,0.1
273675867,3,7,3.0,10,0.3
273700608,1,9,1.0,10,0.1
273701206,1,8,1.0,9,0.1111111111111111
273723075,1,9,1.0,10,0.1
273756522,2,7,2.0,9,0.2222222222222222
273776975,1,7,1.0,8,0.125
273799278,1,9,1.0,10,0.1
273800004,22,4,4.0,26,0.15384615384615385
273805923,9,1,1.0,10,0.1
273818356,1,9,1.0,10,0.1
273831163,1,18,1.0,19,0.05263157894736842
273912567,5,15,5.0,20,0.25
273921099,1,8,1.0,9,0.1111111111111111
273928828,1,9,1.0,10,0.1
273967248,1,8,1.0,9,0.1111111111111111
273968497,1,7,1.0,8,0.125
273971168,1,17,1.0,18,0.05555555555555555
273990026,2,8,2.0,10,0.2
273990872,6,3,3.0,9,0.3333333333333333
274022136,1,8,1.0,9,0.1111111111111111
274100438,1,19,1.0,20,0.05
274126341,1,8,1.0,9,0.1111111111111111
274131320,2,15,2.0,17,0.11764705882352941
274138616,1,9,1.0,10,0.1
274149968,9,1,1.0,10,0.1
274159302,1,8,1.0,9,0.1111111111111111
274200863,2,18,2.0,20,0.1
274208510,2,8,2.0,10,0.2
274209274,1,8,1.0,9,0.1111111111111111
274282602,6,4,4.0,10,0.4
274289882,1,18,1.0,19,0.05263157894736842
274303217,1,9,1.0,10,0.1
274339199,3,6,3.0,9,0.3333333333333333
274348824,4,22,4.0,26,0.15384615384615385
274360277,1,9,1.0,10,0.1
274398156,1,19,1.0,20,0.05
274402456,1,8,1.0,9,0.1111111111111111
274432428,3,7,3.0,10,0.3
274449709,1,8,1.0,9,0.1111111111111111
274499936,2,26,2.0,28,0.07142857142857142
274538774,9,1,1.0,10,0.1
274540884,1,9,1.0,10,0.1
274546456,5,4,4.0,9,0.4444444444444444
274550484,1,8,1.0,9,0.1111111111111111
274550529,2,8,2.0,10,0.2
274555490,4,6,4.0,10,0.4
274564723,6,4,4.0,10,0.4
274568445,2,8,2.0,10,0.2
274594709,1,27,1.0,28,0.03571428571428571
274599352,2,6,2.0,8,0.25
274627755,2,8,2.0,10,0.2
274632684,7,3,3.0,10,0.3
274633553,1,9,1.0,10,0.1
274663682,1,17,1.0,18,0.05555555555555555
274674122,2,8,2.0,10,0.2
274694590,3,5,3.0,8,0.375
274709451,1,9,1.0,10,0.1
274711832,2,8,2.0,10,0.2
274712913,1,8,1.0,9,0.1111111111111111
274730592,1,8,1.0,9,0.1111111111111111
274761892,1,18,1.0,19,0.05263157894736842
274771006,9,1,1.0,10,0.1
274781854,1,8,1.0,9,0.1111111111111111
274797282,1,9,1.0,10,0.1
274816868,8,17,8.0,25,0.32
274835367,1,9,1.0,10,0.1
274838199,1,19,1.0,20,0.05
274849305,2,8,2.0,10,0.2
274855619,4,5,4.0,9,0.4444444444444444
274862275,1,9,1.0,10,0.1
274875721,1,17,1.0,18,0.05555555555555555
274876111,1,9,1.0,10,0.1
274881322,3,7,3.0,10,0.3
274908406,9,1,1.0,10,0.1
274929614,3,6,3.0,9,0.3333333333333333
274954748,2,8,2.0,10,0.2
274964070,3,6,3.0,9,0.3333333333333333
274980471,3,7,3.0,10,0.3
274981378,3,25,3.0,28,0.10714285714285714
274983167,4,5,4.0,9,0.4444444444444444
274993987,1,9,1.0,10,0.1
274998117,3,6,3.0,9,0.3333333333333333
275003151,3,7,3.0,10,0.3
275004064,9,1,1.0,10,0.1
275005201,3,7,3.0,10,0.3
275006144,1,9,1.0,10,0.1
275007150,2,7,2.0,9,0.2222222222222222
275013272,1,9,1.0,10,0.1
275018426,1,19,1.0,20,0.05
275030167,1,9,1.0,10,0.1
275069544,3,7,3.0,10,0.3
275075677,1,9,1.0,10,0.1
275080014,3,15,3.0,18,0.16666666666666666
275098727,1,7,1.0,8,0.125
275105108,1,9,1.0,10,0.1
275119021,5,22,5.0,27,0.18518518518518517
275160668,6,14,6.0,20,0.3
275169788,2,7,2.0,9,0.2222222222222222
275172342,6,22,6.0,28,0.21428571428571427
275178754,1,9,1.0,10,0.1
275194962,3,7,3.0,10,0.3
275195452,1,8,1.0,9,0.1111111111111111
275212605,1,9,1.0,10,0.1
275214853,1,18,1.0,19,0.05263157894736842
275216931,2,8,2.0,10,0.2
275217338,1,9,1.0,10,0.1
275217564,1,9,1.0,10,0.1
275242543,2,8,2.0,10,0.2
275246131,3,6,3.0,9,0.3333333333333333
275253596,6,3,3.0,9,0.3333333333333333
275289409,8,1,1.0,9,0.1111111111111111
275305422,1,8,1.0,9,0.1111111111111111
275305877,4,24,4.0,28,0.14285714285714285
275306282,2,8,2.0,10,0.2
275343705,9,1,1.0,10,0.1
275378376,7,2,2.0,9,0.2222222222222222
275382534,1,18,1.0,19,0.05263157894736842
275423091,2,7,2.0,9,0.2222222222222222
275430987,1,18,1.0,19,0.05263157894736842
275432094,1,7,1.0,8,0.125
275432816,27,2,2.0,29,0.06896551724137931
275439086,1,8,1.0,9,0.1111111111111111
275443976,1,9,1.0,10,0.1
275499372,5,3,3.0,8,0.375
275500883,7,3,3.0,10,0.3
275502552,3,6,3.0,9,0.3333333333333333
275503035,4,6,4.0,10,0.4
275504871,2,26,2.0,28,0.07142857142857142
275510082,4,6,4.0,10,0.4
275511534,1,18,1.0,19,0.05263157894736842
275513185,3,6,3.0,9,0.3333333333333333
275515331,7,3,3.0,10,0.3
275515825,1,9,1.0,10,0.1
275515919,3,6,3.0,9,0.3333333333333333
275517443,2,8,2.0,10,0.2
275520344,5,5,5.0,10,0.5
275539620,1,9,1.0,10,0.1
275540415,1,9,1.0,10,0.1
275544303,2,8,2.0,10,0.2
275567195,3,7,3.0,10,0.3
275580609,4,6,4.0,10,0.4
275640558,1,19,1.0,20,0.05
275675753,1,9,1.0,10,0.1
275693961,1,8,1.0,9,0.1111111111111111
275702124,2,18,2.0,20,0.1
275726050,1,18,1.0,19,0.05263157894736842
275733883,2,8,2.0,10,0.2
275761458,1,8,1.0,9,0.1111111111111111
275784208,1,8,1.0,9,0.1111111111111111
275797183,4,5,4.0,9,0.4444444444444444
275811264,1,9,1.0,10,0.1
275812577,1,8,1.0,9,0.1111111111111111
275812870,1,9,1.0,10,0.1
275812977,12,16,12.0,28,0.42857142857142855
275837778,28,1,1.0,29,0.034482758620689655
275837790,8,2,2.0,10,0.2
275838857,1,18,1.0,19,0.05263157894736842
275838969,1,8,1.0,9,0.1111111111111111
275950747,2,18,2.0,20,0.1
275953376,3,6,3.0,9,0.3333333333333333
275954528,1,9,1.0,10,0.1
275962086,4,6,4.0,10,0.4
275963346,1,9,1.0,10,0.1
275963806,3,16,3.0,19,0.15789473684210525
275970462,1,9,1.0,10,0.1
275984194,1,8,1.0,9,0.1111111111111111
275991208,4,6,4.0,10,0.4
275991559,1,8,1.0,9,0.1111111111111111
275994345,4,24,4.0,28,0.14285714285714285
275994509,3,7,3.0,10,0.3
275995022,3,6,3.0,9,0.3333333333333333
275995510,5,5,5.0,10,0.5
276003985,7,2,2.0,9,0.2222222222222222
276004108,1,9,1.0,10,0.1
276009156,1,9,1.0,10,0.1
276020777,8,1,1.0,9,0.1111111111111111
276021207,1,27,1.0,28,0.03571428571428571
276022419,4,6,4.0,10,0.4
276023426,7,3,3.0,10,0.3
276027594,3,6,3.0,9,0.3333333333333333
276048966,8,2,2.0,10,0.2
276056920,3,7,3.0,10,0.3
276057162,8,1,1.0,9,0.1111111111111111
276058934,1,9,1.0,10,0.1
276104994,3,15,3.0,18,0.16666666666666666
276112145,8,2,2.0,10,0.2
276115015,9,1,1.0,10,0.1
276116503,6,2,2.0,8,0.25
276117886,9,20,9.0,29,0.3103448275862069
276126095,2,6,2.0,8,0.25
276129780,3,5,3.0,8,0.375
276131561,8,2,2.0,10,0.2
276133080,2,16,2.0,18,0.1111111111111111
276134650,4,6,4.0,10,0.4
276137335,8,1,1.0,9,0.1111111111111111
276138030,2,8,2.0,10,0.2
276183016,3,7,3.0,10,0.3
276185964,4,6,4.0,10,0.4
276207860,6,4,4.0,10,0.4
276232520,5,4,4.0,9,0.4444444444444444
276237084,1,8,1.0,9,0.1111111111111111
276241300,1,17,1.0,18,0.05555555555555555
276243583,2,18,2.0,20,0.1
276247045,6,3,3.0,9,0.3333333333333333
276251511,1,18,1.0,19,0.05263157894736842
276265678,1,18,1.0,19,0.05263157894736842
276283744,1,9,1.0,10,0.1
276285747,1,19,1.0,20,0.05
276287652,1,9,1.0,10,0.1
276288179,1,8,1.0,9,0.1111111111111111
276294667,4,14,4.0,18,0.2222222222222222
276298871,2,8,2.0,10,0.2
276300417,1,8,1.0,9,0.1111111111111111
276304048,4,6,4.0,10,0.4
276304920,4,6,4.0,10,0.4
276305178,4,6,4.0,10,0.4
276309230,3,7,3.0,10,0.3
276311249,6,4,4.0,10,0.4
276313692,18,10,10.0,28,0.35714285714285715
276318213,1,9,1.0,10,0.1
276335974,1,8,1.0,9,0.1111111111111111
276359470,6,4,4.0,10,0.4
276360227,3,6,3.0,9,0.3333333333333333
276361603,2,8,2.0,10,0.2
276406969,1,9,1.0,10,0.1
276424337,1,9,1.0,10,0.1
276430730,2,8,2.0,10,0.2
276432252,1,19,1.0,20,0.05
276435578,1,18,1.0,19,0.05263157894736842
276436670,3,17,3.0,20,0.15
276436723,1,9,1.0,10,0.1
276450802,1,8,1.0,9,0.1111111111111111
276452278,9,1,1.0,10,0.1
276452677,2,6,2.0,8,0.25
276453041,7,2,2.0,9,0.2222222222222222
276453478,1,8,1.0,9,0.1111111111111111
276456168,1,9,1.0,10,0.1
276456569,1,28,1.0,29,0.034482758620689655
276456915,1,7,1.0,8,0.125
276463611,7,3,3.0,10,0.3
276478231,2,8,2.0,10,0.2
276500104,2,8,2.0,10,0.2
276508101,2,7,2.0,9,0.2222222222222222
276513092,18,11,11.0,29,0.3793103448275862
276513448,1,17,1.0,18,0.05555555555555555
276524868,3,7,3.0,10,0.3
276528963,1,9,1.0,10,0.1
276569827,17,3,3.0,20,0.15
276581570,1,18,1.0,19,0.05263157894736842
276583992,8,2,2.0,10,0.2
276598949,1,28,1.0,29,0.034482758620689655
276599289,1,9,1.0,10,0.1
276602002,15,13,13.0,28,0.4642857142857143
276602842,1,9,1.0,10,0.1
276623835,4,5,4.0,9,0.4444444444444444
276628171,1,9,1.0,10,0.1
276628245,1,9,1.0,10,0.1
276652828,1,9,1.0,10,0.1
276653308,3,7,3.0,10,0.3
276665736,2,8,2.0,10,0.2
276666172,1,9,1.0,10,0.1
276670975,1,7,1.0,8,0.125
276674583,2,17,2.0,19,0.10526315789473684
276676111,4,5,4.0,9,0.4444444444444444
276689851,2,8,2.0,10,0.2
276698710,2,8,2.0,10,0.2
276715385,2,18,2.0,20,0.1
276752437,1,19,1.0,20,0.05
276758102,2,8,2.0,10,0.2
276758418,28,2,2.0,30,0.06666666666666667
276771548,2,8,2.0,10,0.2
276776753,9,1,1.0,10,0.1
276786060,2,7,2.0,9,0.2222222222222222
276799591,1,8,1.0,9,0.1111111111111111
276805618,1,8,1.0,9,0.1111111111111111
276817002,3,5,3.0,8,0.375
276817140,2,8,2.0,10,0.2
276817710,2,28,2.0,30,0.06666666666666667
276817995,1,8,1.0,9,0.1111111111111111
276831628,1,8,1.0,9,0.1111111111111111
276832908,3,7,3.0,10,0.3
276836608,1,28,1.0,29,0.034482758620689655
276842194,1,9,1.0,10,0.1
276852270,1,9,1.0,10,0.1
276865519,1,16,1.0,17,0.058823529411764705
276884576,1,9,1.0,10,0.1
276888158,3,7,3.0,10,0.3
276889295,4,5,4.0,9,0.4444444444444444
276907192,3,16,3.0,19,0.15789473684210525
276908419,2,6,2.0,8,0.25
276908699,3,7,3.0,10,0.3
276909446,1,9,1.0,10,0.1
276910227,1,7,1.0,8,0.125
276910627,1,9,1.0,10,0.1
276910841,9,1,1.0,10,0.1
276910985,7,3,3.0,10,0.3
276919444,5,19,5.0,24,0.20833333333333334
276919905,1,9,1.0,10,0.1
276958183,1,8,1.0,9,0.1111111111111111
276958807,4,5,4.0,9,0.4444444444444444
276966153,7,1,1.0,8,0.125
276972608,2,17,2.0,19,0.10526315789473684
276989315,2,8,2.0,10,0.2
277021498,19,8,8.0,27,0.2962962962962963
277030278,4,5,4.0,9,0.4444444444444444
277031021,9,1,1.0,10,0.1
277031038,2,17,2.0,19,0.10526315789473684
277036729,4,4,4.0,8,0.5
277051607,1,15,1.0,16,0.0625
277052053,1,9,1.0,10,0.1
277056816,9,1,1.0,10,0.1
277057086,2,17,2.0,19,0.10526315789473684
277061282,3,7,3.0,10,0.3
277072243,6,4,4.0,10,0.4
277075278,1,9,1.0,10,0.1
277094542,3,16,3.0,19,0.15789473684210525
277101359,9,1,1.0,10,0.1
277106970,1,9,1.0,10,0.1
277107880,1,29,1.0,30,0.03333333333333333
277142984,1,9,1.0,10,0.1
277158234,1,9,1.0,10,0.1
277168607,3,7,3.0,10,0.3
277186768,1,9,1.0,10,0.1
277200841,4,6,4.0,10,0.4
277215763,1,8,1.0,9,0.1111111111111111
277220937,6,3,3.0,9,0.3333333333333333
277223606,4,6,4.0,10,0.4
277224427,6,4,4.0,10,0.4
277225731,2,8,2.0,10,0.2
277225762,3,7,3.0,10,0.3
277237118,7,12,7.0,19,0.3684210526315789
277239533,4,6,4.0,10,0.4
277241185,8,1,1.0,9,0.1111111111111111
277273386,4,5,4.0,9,0.4444444444444444
277273895,1,8,1.0,9,0.1111111111111111
277293666,2,8,2.0,10,0.2
277296527,7,3,3.0,10,0.3
277309670,4,6,4.0,10,0.4
277316173,7,3,3.0,10,0.3
277334432,1,18,1.0,19,0.05263157894736842
277336406,4,6,4.0,10,0.4
277336782,4,6,4.0,10,0.4
277348092,1,9,1.0,10,0.1
277360924,1,19,1.0,20,0.05
277408112,4,6,4.0,10,0.4
277409332,3,7,3.0,10,0.3
277430078,9,18,9.0,27,0.3333333333333333
277430529,1,8,1.0,9,0.1111111111111111
277451736,2,7,2.0,9,0.2222222222222222
277454638,2,8,2.0,10,0.2
277454715,4,5,4.0,9,0.4444444444444444
277458425,5,4,4.0,9,0.4444444444444444
277459949,1,8,1.0,9,0.1111111111111111
277461942,7,3,3.0,10,0.3
277463529,1,9,1.0,10,0.1
277484803,4,15,4.0,19,0.21052631578947367
277512294,1,9,1.0,10,0.1
277534158,1,7,1.0,8,0.125
277546448,7,1,1.0,8,0.125
277555314,7,3,3.0,10,0.3
277578741,2,7,2.0,9,0.2222222222222222
277580505,2,18,2.0,20,0.1
277598616,1,9,1.0,10,0.1
277628279,2,8,2.0,10,0.2
277631726,1,9,1.0,10,0.1
277644969,1,9,1.0,10,0.1
277681189,3,7,3.0,10,0.3
277683147,1,19,1.0,20,0.05
277693489,6,3,3.0,9,0.3333333333333333
277696378,4,6,4.0,10,0.4
277709335,2,7,2.0,9,0.2222222222222222
277720613,1,9,1.0,10,0.1
277722841,4,16,4.0,20,0.2
277730614,1,8,1.0,9,0.1111111111111111
277755647,1,9,1.0,10,0.1
277756994,8,2,2.0,10,0.2
277784699,7,2,2.0,9,0.2222222222222222
277786451,4,5,4.0,9,0.4444444444444444
277791478,4,6,4.0,10,0.4
277794793,1,19,1.0,20,0.05
277798355,8,2,2.0,10,0.2
277824516,7,3,3.0,10,0.3
277873820,1,9,1.0,10,0.1
277893421,1,9,1.0,10,0.1
277900448,1,9,1.0,10,0.1
277904157,2,8,2.0,10,0.2
277920070,2,8,2.0,10,0.2
277930906,1,18,1.0,19,0.05263157894736842
277933697,1,9,1.0,10,0.1
277939249,1,8,1.0,9,0.1111111111111111
277963506,2,8,2.0,10,0.2
277965534,2,18,2.0,20,0.1
277998495,7,3,3.0,10,0.3
277999476,1,9,1.0,10,0.1
278006450,5,5,5.0,10,0.5
278020970,2,7,2.0,9,0.2222222222222222
278029396,7,22,7.0,29,0.2413793103448276
278029922,2,8,2.0,10,0.2
278054240,1,9,1.0,10,0.1
278064099,4,5,4.0,9,0.4444444444444444
278064133,2,7,2.0,9,0.2222222222222222
278068861,5,5,5.0,10,0.5
278071348,2,6,2.0,8,0.25
278110415,1,9,1.0,10,0.1
278121682,2,6,2.0,8,0.25
278143382,4,23,4.0,27,0.14814814814814814
278158120,6,4,4.0,10,0.4
278167458,1,8,1.0,9,0.1111111111111111
278172437,1,8,1.0,9,0.1111111111111111
278174894,1,16,1.0,17,0.058823529411764705
278187731,3,7,3.0,10,0.3
278192753,4,5,4.0,9,0.4444444444444444
278221037,7,3,3.0,10,0.3
278221566,5,5,5.0,10,0.5
278239621,4,6,4.0,10,0.4
278241329,1,9,1.0,10,0.1
278254436,1,8,1.0,9,0.1111111111111111
278261461,8,2,2.0,10,0.2
278262042,6,4,4.0,10,0.4
278262493,6,2,2.0,8,0.25
278269606,1,7,1.0,8,0.125
278271455,1,9,1.0,10,0.1
278300259,3,25,3.0,28,0.10714285714285714
278300335,8,2,2.0,10,0.2
278313159,9,1,1.0,10,0.1
278323000,8,2,2.0,10,0.2
278323718,1,25,1.0,26,0.038461538461538464
278364265,1,8,1.0,9,0.1111111111111111
278365466,2,18,2.0,20,0.1
278387071,1,9,1.0,10,0.1
278428171,3,7,3.0,10,0.3
278433053,2,16,2.0,18,0.1111111111111111
278444176,5,23,5.0,28,0.17857142857142858
278464355,1,19,1.0,20,0.05
278468557,8,2,2.0,10,0.2
278477114,1,8,1.0,9,0.1111111111111111
278481152,5,3,3.0,8,0.375
278519709,1,26,1.0,27,0.037037037037037035
278564519,7,3,3.0,10,0.3
278587995,3,7,3.0,10,0.3
278610651,3,6,3.0,9,0.3333333333333333
278618226,1,9,1.0,10,0.1
278618367,14,4,4.0,18,0.2222222222222222
278618505,9,1,1.0,10,0.1
278620119,1,19,1.0,20,0.05
278625286,2,27,2.0,29,0.06896551724137931
278626617,2,8,2.0,10,0.2
278630228,4,5,4.0,9,0.4444444444444444
278638268,1,9,1.0,10,0.1
278642241,1,7,1.0,8,0.125
278642569,3,7,3.0,10,0.3
278658687,3,6,3.0,9,0.3333333333333333
278677306,1,9,1.0,10,0.1
278705411,1,9,1.0,10,0.1
278712663,2,17,2.0,19,0.10526315789473684
278730273,3,7,3.0,10,0.3
278746173,3,17,3.0,20,0.15
278746735,2,8,2.0,10,0.2
278758949,2,7,2.0,9,0.2222222222222222
278768031,2,8,2.0,10,0.2
278808355,8,2,2.0,10,0.2
278824152,6,4,4.0,10,0.4
278864871,9,1,1.0,10,0.1
278915543,1,9,1.0,10,0.1
278916095,1,7,1.0,8,0.125
278918648,1,9,1.0,10,0.1
278949338,22,6,6.0,28,0.21428571428571427
278977431,1,17,1.0,18,0.05555555555555555
278980080,2,8,2.0,10,0.2
279047088,1,8,1.0,9,0.1111111111111111
279053823,1,9,1.0,10,0.1
279069597,9,1,1.0,10,0.1
279093546,1,19,1.0,20,0.05
279094771,2,8,2.0,10,0.2
279111966,1,7,1.0,8,0.125
279153505,20,9,9.0,29,0.3103448275862069
279153633,5,4,4.0,9,0.4444444444444444
279166411,4,5,4.0,9,0.4444444444444444
279166674,5,3,3.0,8,0.375
279176660,1,7,1.0,8,0.125
279184761,1,9,1.0,10,0.1
279192242,4,5,4.0,9,0.4444444444444444
279193724,1,7,1.0,8,0.125
279198559,5,4,4.0,9,0.4444444444444444
279198991,1,9,1.0,10,0.1
279203702,1,9,1.0,10,0.1
279212041,1,7,1.0,8,0.125
279215786,1,19,1.0,20,0.05
279252078,3,7,3.0,10,0.3
279286284,5,4,4.0,9,0.4444444444444444
279286703,6,4,4.0,10,0.4
279289676,22,7,7.0,29,0.2413793103448276
279290808,1,7,1.0,8,0.125
279291099,6,21,6.0,27,0.2222222222222222
279291862,8,1,1.0,9,0.1111111111111111
279294975,5,4,4.0,9,0.4444444444444444
279295259,10,8,8.0,18,0.4444444444444444
279322231,8,2,2.0,10,0.2
279325069,2,6,2.0,8,0.25
279327870,2,16,2.0,18,0.1111111111111111
279346741,2,8,2.0,10,0.2
279351060,1,9,1.0,10,0.1
279375784,3,15,3.0,18,0.16666666666666666
279375877,4,5,4.0,9,0.4444444444444444
279382570,8,2,2.0,10,0.2
279383652,6,4,4.0,10,0.4
279387686,1,9,1.0,10,0.1
279390591,2,7,2.0,9,0.2222222222222222
279399911,2,18,2.0,20,0.1
279444172,2,8,2.0,10,0.2
279449403,9,1,1.0,10,0.1
279451885,9,1,1.0,10,0.1
279453341,7,3,3.0,10,0.3
279460842,8,1,1.0,9,0.1111111111111111
279462546,3,16,3.0,19,0.15789473684210525
279466223,22,7,7.0,29,0.2413793103448276
279503688,5,15,5.0,20,0.25
279505322,13,5,5.0,18,0.2777777777777778
279507301,1,18,1.0,19,0.05263157894736842
279508872,1,9,1.0,10,0.1
279523709,8,2,2.0,10,0.2
279541692,1,9,1.0,10,0.1
279542863,4,23,4.0,27,0.14814814814814814
279546344,5,3,3.0,8,0.375
279551652,8,2,2.0,10,0.2
279553260,8,1,1.0,9,0.1111111111111111
279554538,2,6,2.0,8,0.25
279563455,4,16,4.0,20,0.2
279570280,2,8,2.0,10,0.2
279591043,5,5,5.0,10,0.5
279591605,2,8,2.0,10,0.2
279629225,2,7,2.0,9,0.2222222222222222
279634701,1,9,1.0,10,0.1
279706119,1,9,1.0,10,0.1
279734705,1,9,1.0,10,0.1
279735733,3,5,3.0,8,0.375
279766623,4,5,4.0,9,0.4444444444444444
279766823,1,9,1.0,10,0.1
279785715,1,9,1.0,10,0.1
279786366,1,9,1.0,10,0.1
279803552,2,8,2.0,10,0.2
279842224,1,19,1.0,20,0.05
279848292,5,5,5.0,10,0.5
279850092,14,5,5.0,19,0.2631578947368421
279855981,3,7,3.0,10,0.3
279892129,3,7,3.0,10,0.3
279897971,5,23,5.0,28,0.17857142857142858
279915425,7,3,3.0,10,0.3
279921853,1,17,1.0,18,0.05555555555555555
279922293,5,5,5.0,10,0.5
279933845,1,9,1.0,10,0.1
279966851,1,7,1.0,8,0.125
279988595,2,17,2.0,19,0.10526315789473684
279989210,1,9,1.0,10,0.1
280005557,3,6,3.0,9,0.3333333333333333
280018889,1,9,1.0,10,0.1
280024051,1,9,1.0,10,0.1
280029801,7,2,2.0,9,0.2222222222222222
280029945,9,1,1.0,10,0.1
280030067,9,1,1.0,10,0.1
280031116,6,3,3.0,9,0.3333333333333333
280048048,1,9,1.0,10,0.1
280053878,6,3,3.0,9,0.3333333333333333
280054112,6,3,3.0,9,0.3333333333333333
280054415,3,6,3.0,9,0.3333333333333333
280089709,8,1,1.0,9,0.1111111111111111
280161404,2,18,2.0,20,0.1
280184980,7,2,2.0,9,0.2222222222222222
280185629,9,1,1.0,10,0.1
280276857,1,9,1.0,10,0.1
280308419,3,6,3.0,9,0.3333333333333333
280325714,1,9,1.0,10,0.1
280329366,7,2,2.0,9,0.2222222222222222
280329447,1,9,1.0,10,0.1
280357776,1,18,1.0,19,0.05263157894736842
280365259,1,9,1.0,10,0.1
280416324,6,4,4.0,10,0.4
280465182,2,7,2.0,9,0.2222222222222222
280477205,1,8,1.0,9,0.1111111111111111
280478376,1,9,1.0,10,0.1
280486409,13,13,13.0,26,0.5
280499001,1,9,1.0,10,0.1
280501532,1,9,1.0,10,0.1
280504449,2,8,2.0,10,0.2
280517524,2,8,2.0,10,0.2
280518822,9,9,9.0,18,0.5
280531326,11,15,11.0,26,0.4230769230769231
280586362,7,3,3.0,10,0.3
280586862,8,2,2.0,10,0.2
280596802,1,9,1.0,10,0.1
280603695,2,8,2.0,10,0.2
280604462,1,8,1.0,9,0.1111111111111111
280633734,3,6,3.0,9,0.3333333333333333
280637798,4,6,4.0,10,0.4
280651124,28,1,1.0,29,0.034482758620689655
280651308,7,1,1.0,8,0.125
280677226,1,27,1.0,28,0.03571428571428571
280680244,3,7,3.0,10,0.3
280718116,1,7,1.0,8,0.125
280720536,2,8,2.0,10,0.2
280728753,3,16,3.0,19,0.15789473684210525
280735983,1,7,1.0,8,0.125
280742904,2,7,2.0,9,0.2222222222222222
280760443,1,19,1.0,20,0.05
280784896,26,1,1.0,27,0.037037037037037035
280785563,9,1,1.0,10,0.1
280798005,1,19,1.0,20,0.05
280831479,24,6,6.0,30,0.2
280832895,2,8,2.0,10,0.2
280837005,2,8,2.0,10,0.2
280837934,7,3,3.0,10,0.3
280838071,4,5,4.0,9,0.4444444444444444
280838457,1,8,1.0,9,0.1111111111111111
280838495,2,25,2.0,27,0.07407407407407407
280838692,4,5,4.0,9,0.4444444444444444
280839105,4,6,4.0,10,0.4
280868506,1,9,1.0,10,0.1
280915173,7,2,2.0,9,0.2222222222222222
280915511,14,15,14.0,29,0.4827586206896552
280918258,2,8,2.0,10,0.2
280921902,1,9,1.0,10,0.1
280922216,1,9,1.0,10,0.1
280939099,8,2,2.0,10,0.2
280944412,6,3,3.0,9,0.3333333333333333
280944483,2,8,2.0,10,0.2
280970464,6,4,4.0,10,0.4
280976827,1,7,1.0,8,0.125
280977818,1,8,1.0,9,0.1111111111111111
280978506,1,28,1.0,29,0.034482758620689655
280986016,3,7,3.0,10,0.3
280986368,1,8,1.0,9,0.1111111111111111
280990646,1,8,1.0,9,0.1111111111111111
280993370,1,9,1.0,10,0.1
281002664,8,1,1.0,9,0.1111111111111111
281003022,9,1,1.0,10,0.1
281004646,3,7,3.0,10,0.3
281005731,1,9,1.0,10,0.1
281007756,4,5,4.0,9,0.4444444444444444
281008635,8,2,2.0,10,0.2
281010871,1,9,1.0,10,0.1
281042816,2,26,2.0,28,0.07142857142857142
281047766,1,8,1.0,9,0.1111111111111111
281048676,1,19,1.0,20,0.05
281062381,1,9,1.0,10,0.1
281078058,7,3,3.0,10,0.3
281078658,7,3,3.0,10,0.3
281081230,3,7,3.0,10,0.3
281083665,1,9,1.0,10,0.1
281103354,1,19,1.0,20,0.05
281124406,1,9,1.0,10,0.1
281125572,1,8,1.0,9,0.1111111111111111
281131329,3,15,3.0,18,0.16666666666666666
281139558,3,7,3.0,10,0.3
281148464,1,29,1.0,30,0.03333333333333333
281164940,5,4,4.0,9,0.4444444444444444
281173710,1,9,1.0,10,0.1
281191010,6,3,3.0,9,0.3333333333333333
281195668,7,2,2.0,9,0.2222222222222222
281219733,1,9,1.0,10,0.1
281236242,1,9,1.0,10,0.1
281257772,2,7,2.0,9,0.2222222222222222
281262271,1,9,1.0,10,0.1
281280250,1,17,1.0,18,0.05555555555555555
281311684,25,2,2.0,27,0.07407407407407407
281313578,1,26,1.0,27,0.037037037037037035
281341886,2,8,2.0,10,0.2
281343934,2,8,2.0,10,0.2
281346174,4,6,4.0,10,0.4
281347368,3,6,3.0,9,0.3333333333333333
281347914,1,19,1.0,20,0.05
281354226,1,9,1.0,10,0.1
281354550,1,9,1.0,10,0.1
281362038,3,7,3.0,10,0.3
281394548,1,9,1.0,10,0.1
281418736,1,8,1.0,9,0.1111111111111111
281433338,6,2,2.0,8,0.25
281433835,3,7,3.0,10,0.3
281433997,1,18,1.0,19,0.05263157894736842
281435110,1,7,1.0,8,0.125
281443187,2,26,2.0,28,0.07142857142857142
281449503,1,18,1.0,19,0.05263157894736842
281489432,7,2,2.0,9,0.2222222222222222
281494927,15,5,5.0,20,0.25
281529594,1,8,1.0,9,0.1111111111111111
281568375,1,18,1.0,19,0.05263157894736842
281605763,1,18,1.0,19,0.05263157894736842
281611816,1,19,1.0,20,0.05
281614304,1,9,1.0,10,0.1
281627496,6,4,4.0,10,0.4
281627654,6,4,4.0,10,0.4
281627879,3,7,3.0,10,0.3
281628360,2,8,2.0,10,0.2
281630708,2,7,2.0,9,0.2222222222222222
281653142,6,3,3.0,9,0.3333333333333333
281676953,1,9,1.0,10,0.1
281708064,7,2,2.0,9,0.2222222222222222
281718120,1,8,1.0,9,0.1111111111111111
281741151,4,6,4.0,10,0.4
281761771,1,8,1.0,9,0.1111111111111111
281777560,1,8,1.0,9,0.1111111111111111
281779206,3,27,3.0,30,0.1
281807250,3,6,3.0,9,0.3333333333333333
281811696,4,14,4.0,18,0.2222222222222222
281814413,3,7,3.0,10,0.3
281815315,10,9,9.0,19,0.47368421052631576
281838407,7,3,3.0,10,0.3
281839670,5,5,5.0,10,0.5
281840388,3,6,3.0,9,0.3333333333333333
281841038,9,1,1.0,10,0.1
281841731,4,4,4.0,8,0.5
281843957,1,8,1.0,9,0.1111111111111111
281960519,1,8,1.0,9,0.1111111111111111
281964428,1,9,1.0,10,0.1
281973968,1,9,1.0,10,0.1
281976559,2,6,2.0,8,0.25
281982278,2,8,2.0,10,0.2
281982423,1,8,1.0,9,0.1111111111111111
282003156,2,8,2.0,10,0.2
282003324,2,8,2.0,10,0.2
282021540,1,8,1.0,9,0.1111111111111111
282027941,3,7,3.0,10,0.3
282031885,1,17,1.0,18,0.05555555555555555
282032317,2,28,2.0,30,0.06666666666666667
282042816,36,10,10.0,46,0.21739130434782608
282055707,1,9,1.0,10,0.1
282057189,7,2,2.0,9,0.2222222222222222
282058127,1,9,1.0,10,0.1
282060238,6,4,4.0,10,0.4
282076588,7,3,3.0,10,0.3
282077224,2,8,2.0,10,0.2
282085102,1,9,1.0,10,0.1
282094233,2,7,2.0,9,0.2222222222222222
282128421,5,5,5.0,10,0.5
282138347,1,9,1.0,10,0.1
282138688,3,7,3.0,10,0.3
282139579,5,3,3.0,8,0.375
282142615,6,2,2.0,8,0.25
282164516,1,16,1.0,17,0.058823529411764705
282176161,7,3,3.0,10,0.3
282184527,8,19,8.0,27,0.2962962962962963
282191633,1,9,1.0,10,0.1
282191767,1,9,1.0,10,0.1
282192157,7,3,3.0,10,0.3
282206111,1,9,1.0,10,0.1
282252605,1,8,1.0,9,0.1111111111111111
282256277,1,8,1.0,9,0.1111111111111111
282275934,2,7,2.0,9,0.2222222222222222
282293266,1,17,1.0,18,0.05555555555555555
282302279,1,9,1.0,10,0.1
282317172,1,9,1.0,10,0.1
282325141,1,18,1.0,19,0.05263157894736842
282338078,1,9,1.0,10,0.1
282340441,6,4,4.0,10,0.4
282354351,4,15,4.0,19,0.21052631578947367
282389733,1,9,1.0,10,0.1
282395739,4,5,4.0,9,0.4444444444444444
282395813,1,9,1.0,10,0.1
282396029,2,7,2.0,9,0.2222222222222222
282398015,6,4,4.0,10,0.4
282398773,3,6,3.0,9,0.3333333333333333
282401664,1,8,1.0,9,0.1111111111111111
282401800,4,6,4.0,10,0.4
282404188,2,6,2.0,8,0.25
282424342,2,8,2.0,10,0.2
282443057,9,1,1.0,10,0.1
282444997,2,8,2.0,10,0.2
282456213,2,15,2.0,17,0.11764705882352941
282478922,6,3,3.0,9,0.3333333333333333
282485150,1,8,1.0,9,0.1111111111111111
282488229,1,7,1.0,8,0.125
282492029,2,6,2.0,8,0.25
282492959,2,8,2.0,10,0.2
282502419,8,2,2.0,10,0.2
282504502,1,9,1.0,10,0.1
282510671,6,3,3.0,9,0.3333333333333333
282510923,12,5,5.0,17,0.29411764705882354
282532652,1,8,1.0,9,0.1111111111111111
282545786,1,8,1.0,9,0.1111111111111111
282570871,1,9,1.0,10,0.1
282573905,1,19,1.0,20,0.05
282587693,2,6,2.0,8,0.25
282602621,1,9,1.0,10,0.1
282602872,2,7,2.0,9,0.2222222222222222
282604622,3,6,3.0,9,0.3333333333333333
282607499,2,8,2.0,10,0.2
282613041,3,7,3.0,10,0.3
282615605,14,15,14.0,29,0.4827586206896552
282630009,1,9,1.0,10,0.1
282642780,2,8,2.0,10,0.2
282656997,4,15,4.0,19,0.21052631578947367
282680548,1,8,1.0,9,0.1111111111111111
282683551,1,7,1.0,8,0.125
282698064,7,3,3.0,10,0.3
282698256,9,1,1.0,10,0.1
282699837,6,2,2.0,8,0.25
282791520,1,8,1.0,9,0.1111111111111111
282813254,4,6,4.0,10,0.4
282814153,1,8,1.0,9,0.1111111111111111
282814852,3,17,3.0,20,0.15
282825118,1,9,1.0,10,0.1
282825271,2,7,2.0,9,0.2222222222222222
282825330,2,7,2.0,9,0.2222222222222222
282825466,1,8,1.0,9,0.1111111111111111
282825789,2,7,2.0,9,0.2222222222222222
282827382,5,5,5.0,10,0.5
282827608,4,5,4.0,9,0.4444444444444444
282828745,1,8,1.0,9,0.1111111111111111
282831453,2,7,2.0,9,0.2222222222222222
282836511,2,8,2.0,10,0.2
282836787,1,8,1.0,9,0.1111111111111111
282837216,1,19,1.0,20,0.05
282838786,1,8,1.0,9,0.1111111111111111
282840660,2,8,2.0,10,0.2
282844910,2,8,2.0,10,0.2
282847188,2,8,2.0,10,0.2
282848184,3,6,3.0,9,0.3333333333333333
282865677,1,8,1.0,9,0.1111111111111111
282868477,1,8,1.0,9,0.1111111111111111
282906849,1,8,1.0,9,0.1111111111111111
282917332,2,8,2.0,10,0.2
282920872,1,7,1.0,8,0.125
282928902,1,17,1.0,18,0.05555555555555555
282929185,4,5,4.0,9,0.4444444444444444
282929876,2,8,2.0,10,0.2
282951392,1,9,1.0,10,0.1
282962689,7,2,2.0,9,0.2222222222222222
282973216,1,8,1.0,9,0.1111111111111111
282974831,1,19,1.0,20,0.05
282982652,5,4,4.0,9,0.4444444444444444
282998881,1,9,1.0,10,0.1
283012900,5,14,5.0,19,0.2631578947368421
283020111,2,8,2.0,10,0.2
283024668,1,9,1.0,10,0.1
283068498,1,9,1.0,10,0.1
283076213,1,8,1.0,9,0.1111111111111111
283092590,8,2,2.0,10,0.2
283097376,1,9,1.0,10,0.1
283097815,25,3,3.0,28,0.10714285714285714
283098146,20,5,5.0,25,0.2
283113704,1,8,1.0,9,0.1111111111111111
283113879,1,9,1.0,10,0.1
283152779,1,9,1.0,10,0.1
283153034,1,8,1.0,9,0.1111111111111111
283177592,7,3,3.0,10,0.3
283184286,1,8,1.0,9,0.1111111111111111
283206050,1,8,1.0,9,0.1111111111111111
283215046,1,19,1.0,20,0.05
283245565,7,3,3.0,10,0.3
283247757,5,5,5.0,10,0.5
283253767,1,9,1.0,10,0.1
283274366,8,1,1.0,9,0.1111111111111111
283311522,1,8,1.0,9,0.1111111111111111
283315167,1,27,1.0,28,0.03571428571428571
283357960,3,7,3.0,10,0.3
283359381,3,26,3.0,29,0.10344827586206896
283362232,1,9,1.0,10,0.1
283400838,7,3,3.0,10,0.3
283443511,8,1,1.0,9,0.1111111111111111
283451306,20,5,5.0,25,0.2
283463815,1,19,1.0,20,0.05
283495521,1,8,1.0,9,0.1111111111111111
283543773,4,5,4.0,9,0.4444444444444444
283544717,4,5,4.0,9,0.4444444444444444
283546575,1,8,1.0,9,0.1111111111111111
283553206,1,9,1.0,10,0.1
283618936,1,9,1.0,10,0.1
283634431,7,3,3.0,10,0.3
283676752,8,2,2.0,10,0.2
283678438,8,1,1.0,9,0.1111111111111111
283685100,2,8,2.0,10,0.2
283752852,2,8,2.0,10,0.2
283766708,13,15,13.0,28,0.4642857142857143
283773848,1,8,1.0,9,0.1111111111111111
283774651,1,18,1.0,19,0.05263157894736842
283780283,2,8,2.0,10,0.2
283800921,1,9,1.0,10,0.1
283815612,6,4,4.0,10,0.4
283816291,3,7,3.0,10,0.3
283816448,1,9,1.0,10,0.1
283831264,8,1,1.0,9,0.1111111111111111
283831638,5,4,4.0,9,0.4444444444444444
283839623,1,8,1.0,9,0.1111111111111111
283857821,1,9,1.0,10,0.1
283892455,3,6,3.0,9,0.3333333333333333
283893015,5,5,5.0,10,0.5
283893499,4,6,4.0,10,0.4
283895923,5,5,5.0,10,0.5
283901064,8,1,1.0,9,0.1111111111111111
283903728,7,2,2.0,9,0.2222222222222222
283927926,4,6,4.0,10,0.4
283957436,2,6,2.0,8,0.25
283960805,1,9,1.0,10,0.1
283978296,1,9,1.0,10,0.1
283982779,1,8,1.0,9,0.1111111111111111
283994300,3,6,3.0,9,0.3333333333333333
283995504,3,7,3.0,10,0.3
283999203,5,5,5.0,10,0.5
284022591,2,8,2.0,10,0.2
284056452,1,9,1.0,10,0.1
284072391,2,8,2.0,10,0.2
284073385,2,7,2.0,9,0.2222222222222222
284077411,2,7,2.0,9,0.2222222222222222
284079944,2,8,2.0,10,0.2
284082657,5,5,5.0,10,0.5
284083960,1,26,1.0,27,0.037037037037037035
284084983,1,9,1.0,10,0.1
284093912,1,9,1.0,10,0.1
284095060,3,7,3.0,10,0.3
284097342,1,8,1.0,9,0.1111111111111111
284148244,7,3,3.0,10,0.3
284175767,2,8,2.0,10,0.2
284201776,3,5,3.0,8,0.375
284206531,1,9,1.0,10,0.1
284212016,1,18,1.0,19,0.05263157894736842
284226206,1,9,1.0,10,0.1
284232716,8,2,2.0,10,0.2
284241404,1,9,1.0,10,0.1
284243448,3,6,3.0,9,0.3333333333333333
284248126,2,8,2.0,10,0.2
284248479,1,9,1.0,10,0.1
284249956,1,17,1.0,18,0.05555555555555555
284267979,1,8,1.0,9,0.1111111111111111
284301929,2,7,2.0,9,0.2222222222222222
284302068,1,9,1.0,10,0.1
284312218,5,4,4.0,9,0.4444444444444444
284315375,1,9,1.0,10,0.1
284337775,1,9,1.0,10,0.1
284356402,2,8,2.0,10,0.2
284374698,3,15,3.0,18,0.16666666666666666
284385465,3,7,3.0,10,0.3
284386910,26,4,4.0,30,0.13333333333333333
284397188,2,7,2.0,9,0.2222222222222222
284401908,1,9,1.0,10,0.1
284405544,1,9,1.0,10,0.1
284406246,1,7,1.0,8,0.125
284408571,5,5,5.0,10,0.5
284456498,2,8,2.0,10,0.2
284462145,3,6,3.0,9,0.3333333333333333
284464716,10,10,10.0,20,0.5
284482500,4,14,4.0,18,0.2222222222222222
284482688,1,9,1.0,10,0.1
284497863,5,5,5.0,10,0.5
284499798,3,17,3.0,20,0.15
284500089,1,9,1.0,10,0.1
284522924,2,6,2.0,8,0.25
284527179,1,9,1.0,10,0.1
284538176,1,8,1.0,9,0.1111111111111111
284540420,8,1,1.0,9,0.1111111111111111
284541205,9,1,1.0,10,0.1
284559121,2,7,2.0,9,0.2222222222222222
284583056,1,8,1.0,9,0.1111111111111111
284590732,2,17,2.0,19,0.10526315789473684
284630958,1,9,1.0,10,0.1
284637492,7,3,3.0,10,0.3
284642257,3,7,3.0,10,0.3
284649563,7,3,3.0,10,0.3
284652186,1,8,1.0,9,0.1111111111111111
284677062,1,9,1.0,10,0.1
284699332,3,16,3.0,19,0.15789473684210525
284705892,3,17,3.0,20,0.15
284708512,4,6,4.0,10,0.4
284712240,4,6,4.0,10,0.4
284751346,1,19,1.0,20,0.05
284751504,1,8,1.0,9,0.1111111111111111
284774476,2,8,2.0,10,0.2
284774723,2,7,2.0,9,0.2222222222222222
284774856,1,9,1.0,10,0.1
284778296,6,23,6.0,29,0.20689655172413793
284778917,2,27,2.0,29,0.06896551724137931
284780592,1,9,1.0,10,0.1
284782154,1,8,1.0,9,0.1111111111111111
284782793,4,6,4.0,10,0.4
284797360,8,2,2.0,10,0.2
284797998,21,6,6.0,27,0.2222222222222222
284866308,7,3,3.0,10,0.3
284868826,2,7,2.0,9,0.2222222222222222
284892197,5,4,4.0,9,0.4444444444444444
284892751,3,7,3.0,10,0.3
284893322,26,1,1.0,27,0.037037037037037035
284894163,7,3,3.0,10,0.3
284894461,1,9,1.0,10,0.1
284898979,1,9,1.0,10,0.1
284899249,8,2,2.0,10,0.2
284931465,1,9,1.0,10,0.1
284940836,2,16,2.0,18,0.1111111111111111
284940935,1,25,1.0,26,0.038461538461538464
284943033,5,5,5.0,10,0.5
284943535,5,5,5.0,10,0.5
284945132,1,8,1.0,9,0.1111111111111111
284945572,7,3,3.0,10,0.3
284945794,8,2,2.0,10,0.2
284946381,1,9,1.0,10,0.1
284946699,17,11,11.0,28,0.39285714285714285
284948158,2,18,2.0,20,0.1
285001662,1,9,1.0,10,0.1
285007780,1,9,1.0,10,0.1
285054220,4,6,4.0,10,0.4
285055546,1,18,1.0,19,0.05263157894736842
285055824,1,18,1.0,19,0.05263157894736842
285057094,1,8,1.0,9,0.1111111111111111
285057975,23,6,6.0,29,0.20689655172413793
285161451,1,9,1.0,10,0.1
285219367,2,8,2.0,10,0.2
285220354,2,26,2.0,28,0.07142857142857142
285243431,1,8,1.0,9,0.1111111111111111
285250933,7,1,1.0,8,0.125
285252616,1,9,1.0,10,0.1
285259047,6,4,4.0,10,0.4
285259670,1,8,1.0,9,0.1111111111111111
285261347,2,8,2.0,10,0.2
285263045,1,9,1.0,10,0.1
285263367,1,8,1.0,9,0.1111111111111111
285326508,9,1,1.0,10,0.1
285330518,1,9,1.0,10,0.1
285331086,3,7,3.0,10,0.3
285356866,4,6,4.0,10,0.4
285357289,3,6,3.0,9,0.3333333333333333
285366835,2,17,2.0,19,0.10526315789473684
285403010,2,8,2.0,10,0.2
285403981,3,6,3.0,9,0.3333333333333333
285404501,5,3,3.0,8,0.375
285406079,1,9,1.0,10,0.1
285429661,2,18,2.0,20,0.1
285441162,4,4,4.0,8,0.5
285466961,1,8,1.0,9,0.1111111111111111
285479398,2,7,2.0,9,0.2222222222222222
285493018,1,8,1.0,9,0.1111111111111111
285521429,1,9,1.0,10,0.1
285535253,2,8,2.0,10,0.2
285562307,6,4,4.0,10,0.4
285567785,1,9,1.0,10,0.1
285586113,1,9,1.0,10,0.1
285608010,7,2,2.0,9,0.2222222222222222
285616233,7,2,2.0,9,0.2222222222222222
285692888,8,2,2.0,10,0.2
285706064,1,9,1.0,10,0.1
285706291,2,15,2.0,17,0.11764705882352941
285741658,1,7,1.0,8,0.125
285745818,1,9,1.0,10,0.1
285746545,7,3,3.0,10,0.3
285758514,1,19,1.0,20,0.05
285785565,1,9,1.0,10,0.1
285791296,4,6,4.0,10,0.4
285817099,9,18,9.0,27,0.3333333333333333
285850939,3,24,3.0,27,0.1111111111111111
285852747,2,8,2.0,10,0.2
285856648,3,7,3.0,10,0.3
285880029,5,13,5.0,18,0.2777777777777778
285911949,4,6,4.0,10,0.4
285933872,1,19,1.0,20,0.05
285952949,7,3,3.0,10,0.3
285961893,1,19,1.0,20,0.05
286008263,6,4,4.0,10,0.4
286069208,1,7,1.0,8,0.125
286107500,4,6,4.0,10,0.4
286107768,4,6,4.0,10,0.4
286206885,1,9,1.0,10,0.1
286209489,2,6,2.0,8,0.25
286209660,4,6,4.0,10,0.4
286210490,4,6,4.0,10,0.4
286214159,6,4,4.0,10,0.4
286266632,6,4,4.0,10,0.4
286267335,1,8,1.0,9,0.1111111111111111
286322304,1,8,1.0,9,0.1111111111111111
286322364,1,8,1.0,9,0.1111111111111111
286397936,1,9,1.0,10,0.1
286444980,8,2,2.0,10,0.2
286529464,6,14,6.0,20,0.3
286550636,1,9,1.0,10,0.1
286581159,2,8,2.0,10,0.2
286590364,25,2,2.0,27,0.07407407407407407
286598764,1,9,1.0,10,0.1
286599625,2,17,2.0,19,0.10526315789473684
286660789,1,9,1.0,10,0.1
286670504,1,8,1.0,9,0.1111111111111111
286697324,2,7,2.0,9,0.2222222222222222
286718504,1,19,1.0,20,0.05
286788896,1,7,1.0,8,0.125
286813236,2,6,2.0,8,0.25
286818104,1,9,1.0,10,0.1
286839503,2,8,2.0,10,0.2
286851957,2,7,2.0,9,0.2222222222222222
286853022,17,2,2.0,19,0.10526315789473684
286857959,1,9,1.0,10,0.1
286859502,1,7,1.0,8,0.125
286886523,4,15,4.0,19,0.21052631578947367
286891831,1,9,1.0,10,0.1
286900464,2,8,2.0,10,0.2
286925463,2,8,2.0,10,0.2
286925685,2,8,2.0,10,0.2
286927733,3,25,3.0,28,0.10714285714285714
286929353,4,4,4.0,8,0.5
286929570,3,6,3.0,9,0.3333333333333333
286930097,4,6,4.0,10,0.4
286930120,3,7,3.0,10,0.3
286937692,3,7,3.0,10,0.3
286945761,1,8,1.0,9,0.1111111111111111
286959066,2,27,2.0,29,0.06896551724137931
286961338,2,7,2.0,9,0.2222222222222222
286966818,8,20,8.0,28,0.2857142857142857
286978825,3,6,3.0,9,0.3333333333333333
286980463,6,4,4.0,10,0.4
286992502,2,6,2.0,8,0.25
286993169,4,5,4.0,9,0.4444444444444444
286994099,1,29,1.0,30,0.03333333333333333
286997421,1,9,1.0,10,0.1
287036108,5,5,5.0,10,0.5
287036584,2,8,2.0,10,0.2
287040318,1,24,1.0,25,0.04
287043386,1,18,1.0,19,0.05263157894736842
287045002,2,16,2.0,18,0.1111111111111111
287047123,8,2,2.0,10,0.2
287053453,1,28,1.0,29,0.034482758620689655
287060867,5,5,5.0,10,0.5
287082288,3,24,3.0,27,0.1111111111111111
287092223,1,9,1.0,10,0.1
287104764,2,6,2.0,8,0.25
287128828,1,8,1.0,9,0.1111111111111111
287130534,1,18,1.0,19,0.05263157894736842
287133594,7,2,2.0,9,0.2222222222222222
287135275,5,5,5.0,10,0.5
287150939,2,8,2.0,10,0.2
287151755,1,9,1.0,10,0.1
287174117,1,9,1.0,10,0.1
287187772,1,9,1.0,10,0.1
287189384,4,6,4.0,10,0.4
287189869,3,26,3.0,29,0.10344827586206896
287190304,5,5,5.0,10,0.5
287190446,4,6,4.0,10,0.4
287258342,2,8,2.0,10,0.2
287261561,1,9,1.0,10,0.1
287262855,1,9,1.0,10,0.1
287264782,4,15,4.0,19,0.21052631578947367
287298486,1,18,1.0,19,0.05263157894736842
287301383,8,2,2.0,10,0.2
287319535,2,7,2.0,9,0.2222222222222222
287322594,8,2,2.0,10,0.2
287355437,1,9,1.0,10,0.1
287374098,4,6,4.0,10,0.4
287385245,5,5,5.0,10,0.5
287442332,1,18,1.0,19,0.05263157894736842
287475632,6,4,4.0,10,0.4
287498676,2,17,2.0,19,0.10526315789473684
287512111,5,13,5.0,18,0.2777777777777778
287517293,1,9,1.0,10,0.1
287538904,1,9,1.0,10,0.1
287555869,1,7,1.0,8,0.125
287558629,5,24,5.0,29,0.1724137931034483
287563097,1,9,1.0,10,0.1
287575654,1,7,1.0,8,0.125
287579668,3,7,3.0,10,0.3
287579790,3,16,3.0,19,0.15789473684210525
287580490,5,3,3.0,8,0.375
287590586,1,9,1.0,10,0.1
287592235,1,9,1.0,10,0.1
287592744,3,7,3.0,10,0.3
287592786,1,8,1.0,9,0.1111111111111111
287609386,2,7,2.0,9,0.2222222222222222
287659684,1,8,1.0,9,0.1111111111111111
287671632,3,7,3.0,10,0.3
287677910,3,17,3.0,20,0.15
287684876,1,9,1.0,10,0.1
287701393,5,5,5.0,10,0.5
287714469,2,8,2.0,10,0.2
287715073,1,8,1.0,9,0.1111111111111111
287725614,2,8,2.0,10,0.2
287727291,1,7,1.0,8,0.125
287739242,1,9,1.0,10,0.1
287740888,5,14,5.0,19,0.2631578947368421
287741043,2,7,2.0,9,0.2222222222222222
287757034,1,26,1.0,27,0.037037037037037035
287759394,3,7,3.0,10,0.3
287759994,1,8,1.0,9,0.1111111111111111
287764533,7,3,3.0,10,0.3
287766739,1,8,1.0,9,0.1111111111111111
287771372,1,9,1.0,10,0.1
287774128,4,6,4.0,10,0.4
287774286,1,9,1.0,10,0.1
287774313,1,8,1.0,9,0.1111111111111111
287774794,1,9,1.0,10,0.1
287775130,5,23,5.0,28,0.17857142857142858
287778443,8,2,2.0,10,0.2
287790684,18,10,10.0,28,0.35714285714285715
287820960,4,13,4.0,17,0.23529411764705882
287850783,1,9,1.0,10,0.1
287865971,7,2,2.0,9,0.2222222222222222
287897643,6,3,3.0,9,0.3333333333333333
287905292,2,8,2.0,10,0.2
287906576,1,9,1.0,10,0.1
287907128,1,9,1.0,10,0.1
287908406,1,7,1.0,8,0.125
287909764,1,9,1.0,10,0.1
287912087,3,27,3.0,30,0.1
287914566,1,8,1.0,9,0.1111111111111111
287921167,1,9,1.0,10,0.1
287921413,1,8,1.0,9,0.1111111111111111
288008475,1,18,1.0,19,0.05263157894736842
288029978,1,9,1.0,10,0.1
288041632,1,8,1.0,9,0.1111111111111111
288068094,3,5,3.0,8,0.375
288069452,8,2,2.0,10,0.2
288086600,2,6,2.0,8,0.25
288094742,1,9,1.0,10,0.1
288096301,1,9,1.0,10,0.1
288105749,1,9,1.0,10,0.1
288126882,1,8,1.0,9,0.1111111111111111
288144751,2,27,2.0,29,0.06896551724137931
288163981,1,8,1.0,9,0.1111111111111111
288169672,1,9,1.0,10,0.1
288177249,1,9,1.0,10,0.1
288180260,2,8,2.0,10,0.2
288182255,4,6,4.0,10,0.4
288183866,3,7,3.0,10,0.3
288184118,1,9,1.0,10,0.1
288186515,4,6,4.0,10,0.4
288195370,3,7,3.0,10,0.3
288205396,4,5,4.0,9,0.4444444444444444
288232142,1,9,1.0,10,0.1
288253160,2,7,2.0,9,0.2222222222222222
288295202,5,5,5.0,10,0.5
288295413,1,9,1.0,10,0.1
288320301,1,19,1.0,20,0.05
288356134,1,9,1.0,10,0.1
288356231,1,8,1.0,9,0.1111111111111111
288372818,1,7,1.0,8,0.125
288386430,1,9,1.0,10,0.1
288388641,6,14,6.0,20,0.3
288391038,5,5,5.0,10,0.5
288391792,5,4,4.0,9,0.4444444444444444
288392565,2,8,2.0,10,0.2
288392766,10,19,10.0,29,0.3448275862068966
288397407,1,9,1.0,10,0.1
288397669,2,7,2.0,9,0.2222222222222222
288399310,5,5,5.0,10,0.5
288399444,2,24,2.0,26,0.07692307692307693
288401189,3,6,3.0,9,0.3333333333333333
288401617,3,25,3.0,28,0.10714285714285714
288401694,1,9,1.0,10,0.1
288407302,2,8,2.0,10,0.2
288410463,5,4,4.0,9,0.4444444444444444
288417593,3,7,3.0,10,0.3
288418338,9,1,1.0,10,0.1
288419161,2,8,2.0,10,0.2
288421312,1,9,1.0,10,0.1
288453391,1,8,1.0,9,0.1111111111111111
288519280,1,9,1.0,10,0.1
288526493,2,7,2.0,9,0.2222222222222222
288545517,1,8,1.0,9,0.1111111111111111
288561428,6,2,2.0,8,0.25
288572370,2,7,2.0,9,0.2222222222222222
288592492,2,7,2.0,9,0.2222222222222222
288593968,1,7,1.0,8,0.125
288601164,2,8,2.0,10,0.2
288606954,2,8,2.0,10,0.2
288620975,2,7,2.0,9,0.2222222222222222
288636497,3,24,3.0,27,0.1111111111111111
288641141,1,8,1.0,9,0.1111111111111111
288664806,1,9,1.0,10,0.1
288664947,1,9,1.0,10,0.1
288672804,1,19,1.0,20,0.05
288755535,1,9,1.0,10,0.1
288757352,3,7,3.0,10,0.3
288757657,2,8,2.0,10,0.2
288765888,1,8,1.0,9,0.1111111111111111
288768009,2,15,2.0,17,0.11764705882352941
288789143,1,9,1.0,10,0.1
288789251,1,15,1.0,16,0.0625
288797048,1,9,1.0,10,0.1
288861901,2,15,2.0,17,0.11764705882352941
288864157,1,9,1.0,10,0.1
288876690,2,8,2.0,10,0.2
288881963,4,4,4.0,8,0.5
288899979,4,6,4.0,10,0.4
288926316,1,8,1.0,9,0.1111111111111111
288929194,1,9,1.0,10,0.1
288957820,3,6,3.0,9,0.3333333333333333
288959843,2,8,2.0,10,0.2
288962342,1,9,1.0,10,0.1
288964306,9,10,9.0,19,0.47368421052631576
288965572,2,7,2.0,9,0.2222222222222222
288969771,6,2,2.0,8,0.25
288970193,8,1,1.0,9,0.1111111111111111
288976119,2,28,2.0,30,0.06666666666666667
288977100,2,7,2.0,9,0.2222222222222222
288977965,1,9,1.0,10,0.1
288978578,7,3,3.0,10,0.3
288980483,3,7,3.0,10,0.3
288980781,1,18,1.0,19,0.05263157894736842
289013231,3,6,3.0,9,0.3333333333333333
289023565,3,7,3.0,10,0.3
289113503,4,6,4.0,10,0.4
289135354,9,1,1.0,10,0.1
289142375,3,7,3.0,10,0.3
289143447,2,8,2.0,10,0.2
289162608,8,2,2.0,10,0.2
289169243,3,6,3.0,9,0.3333333333333333
289181092,2,7,2.0,9,0.2222222222222222
289186931,1,9,1.0,10,0.1
289187819,2,7,2.0,9,0.2222222222222222
289189390,3,26,3.0,29,0.10344827586206896
289195398,1,9,1.0,10,0.1
289198500,5,4,4.0,9,0.4444444444444444
289203413,1,18,1.0,19,0.05263157894736842
289207829,1,9,1.0,10,0.1
289207830,12,17,12.0,29,0.41379310344827586
289222606,1,18,1.0,19,0.05263157894736842
289244305,1,8,1.0,9,0.1111111111111111
289293558,2,16,2.0,18,0.1111111111111111
289320284,9,1,1.0,10,0.1
289325965,1,19,1.0,20,0.05
289329504,1,9,1.0,10,0.1
289330290,2,8,2.0,10,0.2
289332976,11,25,11.0,36,0.3055555555555556
289334285,3,7,3.0,10,0.3
289366008,2,7,2.0,9,0.2222222222222222
289368248,2,7,2.0,9,0.2222222222222222
289368673,8,2,2.0,10,0.2
289372548,2,8,2.0,10,0.2
289373743,5,4,4.0,9,0.4444444444444444
289387305,4,6,4.0,10,0.4
289387954,3,7,3.0,10,0.3
289392011,3,7,3.0,10,0.3
289392595,1,9,1.0,10,0.1
289397026,5,24,5.0,29,0.1724137931034483
289400771,2,6,2.0,8,0.25
289401450,3,7,3.0,10,0.3
289402962,6,4,4.0,10,0.4
289412139,5,5,5.0,10,0.5
289412653,1,19,1.0,20,0.05
289428791,1,9,1.0,10,0.1
289455951,6,4,4.0,10,0.4
289471145,8,1,1.0,9,0.1111111111111111
289476366,2,8,2.0,10,0.2
289559324,1,8,1.0,9,0.1111111111111111
289577179,6,4,4.0,10,0.4
289613493,5,5,5.0,10,0.5
289674764,1,18,1.0,19,0.05263157894736842
289713677,1,8,1.0,9,0.1111111111111111
289741535,7,3,3.0,10,0.3
289743822,2,8,2.0,10,0.2
289747964,1,8,1.0,9,0.1111111111111111
289777165,1,18,1.0,19,0.05263157894736842
289812336,1,9,1.0,10,0.1
289812710,2,8,2.0,10,0.2
289828052,2,7,2.0,9,0.2222222222222222
289834713,8,17,8.0,25,0.32
289834960,2,8,2.0,10,0.2
289840625,2,18,2.0,20,0.1
289850984,1,8,1.0,9,0.1111111111111111
289897856,1,8,1.0,9,0.1111111111111111
289897902,1,8,1.0,9,0.1111111111111111
289905768,3,7,3.0,10,0.3
289912326,4,5,4.0,9,0.4444444444444444
289947959,7,3,3.0,10,0.3
290029005,6,4,4.0,10,0.4
290035243,4,6,4.0,10,0.4
290042600,12,15,12.0,27,0.4444444444444444
290042818,1,9,1.0,10,0.1
290052061,1,19,1.0,20,0.05
290057318,23,6,6.0,29,0.20689655172413793
290058219,2,8,2.0,10,0.2
290059746,1,8,1.0,9,0.1111111111111111
290110946,2,17,2.0,19,0.10526315789473684
290129321,2,8,2.0,10,0.2
290139342,4,6,4.0,10,0.4
290183807,1,9,1.0,10,0.1
290187204,6,3,3.0,9,0.3333333333333333
290199778,4,4,4.0,8,0.5
290223353,5,5,5.0,10,0.5
290348807,1,9,1.0,10,0.1
290418215,1,9,1.0,10,0.1
290419936,2,8,2.0,10,0.2
290431994,2,8,2.0,10,0.2
290503450,4,6,4.0,10,0.4
290549996,7,2,2.0,9,0.2222222222222222
290550949,1,8,1.0,9,0.1111111111111111
290625222,9,1,1.0,10,0.1
290628983,6,4,4.0,10,0.4
290640012,1,17,1.0,18,0.05555555555555555
290703853,2,8,2.0,10,0.2
290715020,1,9,1.0,10,0.1
290722093,26,3,3.0,29,0.10344827586206896
290741225,3,14,3.0,17,0.17647058823529413
290756858,5,5,5.0,10,0.5
290759921,5,3,3.0,8,0.375
290760943,3,6,3.0,9,0.3333333333333333
290761285,7,3,3.0,10,0.3
290780633,1,8,1.0,9,0.1111111111111111
290804414,23,5,5.0,28,0.17857142857142858
290830777,1,8,1.0,9,0.1111111111111111
290832851,6,2,2.0,8,0.25
290834090,1,9,1.0,10,0.1
290834128,5,5,5.0,10,0.5
290848564,1,8,1.0,9,0.1111111111111111
290851427,2,8,2.0,10,0.2
290882339,9,1,1.0,10,0.1
290926453,1,9,1.0,10,0.1
290970787,2,8,2.0,10,0.2
290971027,3,7,3.0,10,0.3
290978939,1,9,1.0,10,0.1
290997151,1,8,1.0,9,0.1111111111111111
291026035,4,6,4.0,10,0.4
291028270,1,9,1.0,10,0.1
291032578,4,6,4.0,10,0.4
291036940,4,5,4.0,9,0.4444444444444444
291041502,18,10,10.0,28,0.35714285714285715
291049776,4,6,4.0,10,0.4
291052548,3,6,3.0,9,0.3333333333333333
291067389,4,6,4.0,10,0.4
291075446,1,19,1.0,20,0.05
291078727,3,17,3.0,20,0.15
291112744,6,3,3.0,9,0.3333333333333333
291112964,6,4,4.0,10,0.4
291113275,1,9,1.0,10,0.1
291119806,27,1,1.0,28,0.03571428571428571
291147196,8,2,2.0,10,0.2
291166553,1,8,1.0,9,0.1111111111111111
291168251,1,19,1.0,20,0.05
291169030,1,19,1.0,20,0.05
291183860,8,2,2.0,10,0.2
291184355,3,5,3.0,8,0.375
291184848,9,1,1.0,10,0.1
291186191,7,3,3.0,10,0.3
291186885,24,4,4.0,28,0.14285714285714285
291202321,1,18,1.0,19,0.05263157894736842
291225666,1,19,1.0,20,0.05
291252761,2,7,2.0,9,0.2222222222222222
291271250,1,8,1.0,9,0.1111111111111111
291275613,2,8,2.0,10,0.2
291276268,2,7,2.0,9,0.2222222222222222
291276640,4,6,4.0,10,0.4
291296520,1,7,1.0,8,0.125
291298704,1,8,1.0,9,0.1111111111111111
291316151,4,5,4.0,9,0.4444444444444444
291318923,2,8,2.0,10,0.2
291321408,1,9,1.0,10,0.1
291392894,1,8,1.0,9,0.1111111111111111
291404146,5,5,5.0,10,0.5
291424948,1,18,1.0,19,0.05263157894736842
291442946,2,25,2.0,27,0.07407407407407407
291444972,8,2,2.0,10,0.2
291445266,2,8,2.0,10,0.2
291445808,3,7,3.0,10,0.3
291479935,1,18,1.0,19,0.05263157894736842
291485195,4,5,4.0,9,0.4444444444444444
291487186,2,7,2.0,9,0.2222222222222222
291511102,1,7,1.0,8,0.125
291520555,7,3,3.0,10,0.3
291523189,2,8,2.0,10,0.2
291528180,1,9,1.0,10,0.1
291528496,3,6,3.0,9,0.3333333333333333
291528856,2,8,2.0,10,0.2
291529490,3,7,3.0,10,0.3
291530691,2,8,2.0,10,0.2
291534288,2,7,2.0,9,0.2222222222222222
291571427,2,8,2.0,10,0.2
291595593,7,2,2.0,9,0.2222222222222222
291640207,1,17,1.0,18,0.05555555555555555
291641716,2,8,2.0,10,0.2
291642909,1,7,1.0,8,0.125
291657191,1,8,1.0,9,0.1111111111111111
291659694,1,9,1.0,10,0.1
291678555,7,3,3.0,10,0.3
291687896,2,8,2.0,10,0.2
291693957,4,6,4.0,10,0.4
291699875,10,10,10.0,20,0.5
291700035,9,1,1.0,10,0.1
291706837,1,7,1.0,8,0.125
291719037,2,8,2.0,10,0.2
291720270,1,8,1.0,9,0.1111111111111111
291721021,22,4,4.0,26,0.15384615384615385
291733116,2,8,2.0,10,0.2
291733521,2,7,2.0,9,0.2222222222222222
291769147,4,16,4.0,20,0.2
291851715,1,17,1.0,18,0.05555555555555555
291909451,1,8,1.0,9,0.1111111111111111
291910535,1,27,1.0,28,0.03571428571428571
291960756,1,19,1.0,20,0.05
292039966,4,6,4.0,10,0.4
292072044,9,1,1.0,10,0.1
292129374,2,16,2.0,18,0.1111111111111111
292157140,2,8,2.0,10,0.2
292167540,1,19,1.0,20,0.05
292236025,3,6,3.0,9,0.3333333333333333
292255327,8,2,2.0,10,0.2
292263486,3,16,3.0,19,0.15789473684210525
292274723,3,7,3.0,10,0.3
292304795,1,9,1.0,10,0.1
292333350,7,3,3.0,10,0.3
292364087,9,1,1.0,10,0.1
292364982,1,19,1.0,20,0.05
292369601,1,9,1.0,10,0.1
292369688,1,9,1.0,10,0.1
292369859,3,6,3.0,9,0.3333333333333333
292385106,16,1,1.0,17,0.058823529411764705
292410152,1,9,1.0,10,0.1
292423740,7,3,3.0,10,0.3
292425959,3,7,3.0,10,0.3
292430780,5,23,5.0,28,0.17857142857142858
292456434,1,9,1.0,10,0.1
292495498,1,8,1.0,9,0.1111111111111111
292508000,2,18,2.0,20,0.1
292517095,3,25,3.0,28,0.10714285714285714
292545156,1,27,1.0,28,0.03571428571428571
292549247,1,9,1.0,10,0.1
292550613,1,9,1.0,10,0.1
292550822,2,6,2.0,8,0.25
292581695,1,9,1.0,10,0.1
292582033,3,6,3.0,9,0.3333333333333333
292591227,1,9,1.0,10,0.1
292604788,1,8,1.0,9,0.1111111111111111
292610995,5,14,5.0,19,0.2631578947368421
292628307,2,6,2.0,8,0.25
292632580,4,15,4.0,19,0.21052631578947367
292634670,1,8,1.0,9,0.1111111111111111
292637044,3,16,3.0,19,0.15789473684210525
292646621,5,4,4.0,9,0.4444444444444444
292657306,16,14,14.0,30,0.4666666666666667
292665557,7,12,7.0,19,0.3684210526315789
292676592,4,6,4.0,10,0.4
292685513,1,9,1.0,10,0.1
292686556,1,9,1.0,10,0.1
292718195,1,9,1.0,10,0.1
292784283,2,8,2.0,10,0.2
292787333,2,7,2.0,9,0.2222222222222222
292787549,1,9,1.0,10,0.1
292789694,5,4,4.0,9,0.4444444444444444
292824625,9,10,9.0,19,0.47368421052631576
292875389,2,8,2.0,10,0.2
292955576,1,9,1.0,10,0.1
292986196,3,16,3.0,19,0.15789473684210525
293010011,1,8,1.0,9,0.1111111111111111
293019702,1,9,1.0,10,0.1
293036584,6,4,4.0,10,0.4
293046318,1,7,1.0,8,0.125
293048321,1,8,1.0,9,0.1111111111111111
293061789,1,9,1.0,10,0.1
293061914,3,6,3.0,9,0.3333333333333333
293068760,3,6,3.0,9,0.3333333333333333
293097192,2,8,2.0,10,0.2
293097508,1,17,1.0,18,0.05555555555555555
293129736,1,8,1.0,9,0.1111111111111111
293145543,1,9,1.0,10,0.1
293189628,4,6,4.0,10,0.4
293189796,3,5,3.0,8,0.375
293206569,2,6,2.0,8,0.25
293223150,9,1,1.0,10,0.1
293223226,7,3,3.0,10,0.3
293240579,1,9,1.0,10,0.1
293263195,4,4,4.0,8,0.5
293335190,2,8,2.0,10,0.2
293340145,8,2,2.0,10,0.2
293350058,3,16,3.0,19,0.15789473684210525
293364718,5,5,5.0,10,0.5
293368015,1,18,1.0,19,0.05263157894736842
293385912,1,9,1.0,10,0.1
293411425,4,25,4.0,29,0.13793103448275862
293417938,3,15,3.0,18,0.16666666666666666
293425154,1,9,1.0,10,0.1
293432381,4,5,4.0,9,0.4444444444444444
293433006,5,5,5.0,10,0.5
293459445,2,8,2.0,10,0.2
293468480,1,18,1.0,19,0.05263157894736842
293475934,2,7,2.0,9,0.2222222222222222
293504646,2,6,2.0,8,0.25
293505272,3,6,3.0,9,0.3333333333333333
293540190,2,7,2.0,9,0.2222222222222222
293543624,2,8,2.0,10,0.2
293550688,2,8,2.0,10,0.2
293551438,22,5,5.0,27,0.18518518518518517
293555271,2,8,2.0,10,0.2
293556703,2,8,2.0,10,0.2
293556840,2,7,2.0,9,0.2222222222222222
293559503,1,9,1.0,10,0.1
293573836,9,18,9.0,27,0.3333333333333333
293613618,2,8,2.0,10,0.2
293663976,1,7,1.0,8,0.125
293669140,4,5,4.0,9,0.4444444444444444
293669964,1,9,1.0,10,0.1
293677060,2,7,2.0,9,0.2222222222222222
293689675,1,19,1.0,20,0.05
293795501,6,4,4.0,10,0.4
293796906,1,9,1.0,10,0.1
293829287,4,6,4.0,10,0.4
293829607,4,5,4.0,9,0.4444444444444444
293851492,1,8,1.0,9,0.1111111111111111
293855665,1,7,1.0,8,0.125
293858330,4,5,4.0,9,0.4444444444444444
293860191,3,16,3.0,19,0.15789473684210525
293928175,1,9,1.0,10,0.1
293932019,2,8,2.0,10,0.2
293936598,1,17,1.0,18,0.05555555555555555
293941881,7,12,7.0,19,0.3684210526315789
293946052,7,2,2.0,9,0.2222222222222222
293946344,6,4,4.0,10,0.4
293949646,2,7,2.0,9,0.2222222222222222
293964508,6,13,6.0,19,0.3157894736842105
294003846,10,9,9.0,19,0.47368421052631576
294006725,8,1,1.0,9,0.1111111111111111
294013620,4,16,4.0,20,0.2
294017079,1,9,1.0,10,0.1
294040911,6,3,3.0,9,0.3333333333333333
294069186,1,9,1.0,10,0.1
294093725,3,17,3.0,20,0.15
294110582,1,19,1.0,20,0.05
294114611,1,16,1.0,17,0.058823529411764705
294126198,7,2,2.0,9,0.2222222222222222
294159997,1,8,1.0,9,0.1111111111111111
294165415,4,5,4.0,9,0.4444444444444444
294166936,2,8,2.0,10,0.2
294172295,5,4,4.0,9,0.4444444444444444
294172611,7,1,1.0,8,0.125
294177581,17,3,3.0,20,0.15
294218871,2,8,2.0,10,0.2
294242762,5,4,4.0,9,0.4444444444444444
294247800,3,7,3.0,10,0.3
294278279,1,8,1.0,9,0.1111111111111111
294282483,3,7,3.0,10,0.3
294288622,1,9,1.0,10,0.1
294295372,2,8,2.0,10,0.2
294305359,2,8,2.0,10,0.2
294317958,2,8,2.0,10,0.2
294318913,2,8,2.0,10,0.2
294319355,1,7,1.0,8,0.125
294324094,2,28,2.0,30,0.06666666666666667
294325377,2,6,2.0,8,0.25
294327164,1,7,1.0,8,0.125
294327769,1,8,1.0,9,0.1111111111111111
294328368,4,24,4.0,28,0.14285714285714285
294333526,1,9,1.0,10,0.1
294353197,1,17,1.0,18,0.05555555555555555
294369312,8,1,1.0,9,0.1111111111111111
294370074,5,5,5.0,10,0.5
294370339,5,22,5.0,27,0.18518518518518517
294371980,8,2,2.0,10,0.2
294397424,3,7,3.0,10,0.3
294403770,3,17,3.0,20,0.15
294411071,2,7,2.0,9,0.2222222222222222
294435371,1,18,1.0,19,0.05263157894736842
294437994,2,15,2.0,17,0.11764705882352941
294495022,4,6,4.0,10,0.4
294499054,1,18,1.0,19,0.05263157894736842
294524751,1,7,1.0,8,0.125
294527450,2,6,2.0,8,0.25
294543637,2,8,2.0,10,0.2
294553014,1,17,1.0,18,0.05555555555555555
294559194,8,1,1.0,9,0.1111111111111111
294559599,5,5,5.0,10,0.5
294561114,1,7,1.0,8,0.125
294562423,3,7,3.0,10,0.3
294578939,7,2,2.0,9,0.2222222222222222
294579404,1,7,1.0,8,0.125
294585648,25,3,3.0,28,0.10714285714285714
294593611,5,4,4.0,9,0.4444444444444444
294594741,6,3,3.0,9,0.3333333333333333
294595237,1,19,1.0,20,0.05
294601806,1,8,1.0,9,0.1111111111111111
294623596,2,15,2.0,17,0.11764705882352941
294658204,2,22,2.0,24,0.08333333333333333
294677919,2,25,2.0,27,0.07407407407407407
294679368,2,13,2.0,15,0.13333333333333333
294715636,2,8,2.0,10,0.2
294723371,1,9,1.0,10,0.1
294735928,16,3,3.0,19,0.15789473684210525
294736206,1,9,1.0,10,0.1
294736633,7,3,3.0,10,0.3
294736782,1,8,1.0,9,0.1111111111111111
294737482,1,9,1.0,10,0.1
294776996,9,1,1.0,10,0.1
294825773,2,8,2.0,10,0.2
294858133,3,15,3.0,18,0.16666666666666666
294880506,2,25,2.0,27,0.07407407407407407
294882298,1,8,1.0,9,0.1111111111111111
294886184,1,19,1.0,20,0.05
294887665,9,1,1.0,10,0.1
294899703,2,7,2.0,9,0.2222222222222222
294920580,7,1,1.0,8,0.125
294921902,3,7,3.0,10,0.3
294921916,6,3,3.0,9,0.3333333333333333
294921991,2,7,2.0,9,0.2222222222222222
294922928,6,4,4.0,10,0.4
294924578,5,5,5.0,10,0.5
294934681,1,25,1.0,26,0.038461538461538464
294993499,1,18,1.0,19,0.05263157894736842
295028607,8,1,1.0,9,0.1111111111111111
295032940,6,4,4.0,10,0.4
295035193,7,3,3.0,10,0.3
295055001,1,9,1.0,10,0.1
295074008,4,6,4.0,10,0.4
295100659,1,9,1.0,10,0.1
295105704,3,6,3.0,9,0.3333333333333333
295139651,8,1,1.0,9,0.1111111111111111
295174869,4,6,4.0,10,0.4
295190975,1,17,1.0,18,0.05555555555555555
295228963,28,1,1.0,29,0.034482758620689655
295237691,2,7,2.0,9,0.2222222222222222
295240029,9,1,1.0,10,0.1
295244731,2,17,2.0,19,0.10526315789473684
295247036,1,9,1.0,10,0.1
295257420,9,1,1.0,10,0.1
295267512,17,1,1.0,18,0.05555555555555555
295273784,3,7,3.0,10,0.3
295283286,2,8,2.0,10,0.2
295287999,1,18,1.0,19,0.05263157894736842
295298729,9,1,1.0,10,0.1
295298992,8,1,1.0,9,0.1111111111111111
295300911,5,5,5.0,10,0.5
295337886,6,3,3.0,9,0.3333333333333333
295391772,3,6,3.0,9,0.3333333333333333
295408871,26,3,3.0,29,0.10344827586206896
295429940,1,8,1.0,9,0.1111111111111111
295432675,8,1,1.0,9,0.1111111111111111
295469464,8,1,1.0,9,0.1111111111111111
295483914,5,4,4.0,9,0.4444444444444444
295520884,1,9,1.0,10,0.1
295591203,7,2,2.0,9,0.2222222222222222
295604290,1,9,1.0,10,0.1
295615562,2,18,2.0,20,0.1
295621637,3,6,3.0,9,0.3333333333333333
295707912,5,5,5.0,10,0.5
295718205,2,17,2.0,19,0.10526315789473684
295793114,1,9,1.0,10,0.1
295803557,10,17,10.0,27,0.37037037037037035
295811419,4,14,4.0,18,0.2222222222222222
295813793,6,23,6.0,29,0.20689655172413793
295813931,1,26,1.0,27,0.037037037037037035
295814727,1,18,1.0,19,0.05263157894736842
295821284,1,29,1.0,30,0.03333333333333333
295837577,1,9,1.0,10,0.1
295842063,1,9,1.0,10,0.1
295843102,1,19,1.0,20,0.05
295847229,3,7,3.0,10,0.3
295915663,2,8,2.0,10,0.2
295916423,4,5,4.0,9,0.4444444444444444
295922564,2,8,2.0,10,0.2
295924638,6,2,2.0,8,0.25
295929068,7,2,2.0,9,0.2222222222222222
295954528,1,9,1.0,10,0.1
295962909,3,15,3.0,18,0.16666666666666666
295991161,19,10,10.0,29,0.3448275862068966
295992172,1,9,1.0,10,0.1
296017292,1,9,1.0,10,0.1
296023821,1,9,1.0,10,0.1
296023839,1,9,1.0,10,0.1
296026271,2,8,2.0,10,0.2
296029833,2,8,2.0,10,0.2
296033654,2,8,2.0,10,0.2
296033990,2,8,2.0,10,0.2
296038381,4,15,4.0,19,0.21052631578947367
296045235,3,6,3.0,9,0.3333333333333333
296062099,2,16,2.0,18,0.1111111111111111
296097106,1,9,1.0,10,0.1
296172495,28,2,2.0,30,0.06666666666666667
296172719,8,1,1.0,9,0.1111111111111111
296213486,2,8,2.0,10,0.2
296214775,5,5,5.0,10,0.5
296269671,1,18,1.0,19,0.05263157894736842
296269836,1,17,1.0,18,0.05555555555555555
296271298,1,8,1.0,9,0.1111111111111111
296329053,1,19,1.0,20,0.05
296330657,5,15,5.0,20,0.25
296340732,1,9,1.0,10,0.1
296360082,4,6,4.0,10,0.4
296417101,1,8,1.0,9,0.1111111111111111
296455903,6,4,4.0,10,0.4
296469305,1,8,1.0,9,0.1111111111111111
296469784,1,9,1.0,10,0.1
296538274,1,18,1.0,19,0.05263157894736842
296538627,1,9,1.0,10,0.1
296559358,9,1,1.0,10,0.1
296560485,1,9,1.0,10,0.1
296570341,2,7,2.0,9,0.2222222222222222
296571040,2,8,2.0,10,0.2
296571355,4,6,4.0,10,0.4
296620993,1,18,1.0,19,0.05263157894736842
296626038,8,2,2.0,10,0.2
296628714,1,8,1.0,9,0.1111111111111111
296630246,3,7,3.0,10,0.3
296631062,3,7,3.0,10,0.3
296635498,9,19,9.0,28,0.32142857142857145
296707317,1,18,1.0,19,0.05263157894736842
296710708,2,17,2.0,19,0.10526315789473684
296718271,8,18,8.0,26,0.3076923076923077
296747942,4,25,4.0,29,0.13793103448275862
296749875,3,7,3.0,10,0.3
296762695,6,4,4.0,10,0.4
296784897,1,13,1.0,14,0.07142857142857142
296842274,1,9,1.0,10,0.1
296852695,2,7,2.0,9,0.2222222222222222
296853015,2,8,2.0,10,0.2
296853948,1,9,1.0,10,0.1
296854192,5,5,5.0,10,0.5
296854636,1,7,1.0,8,0.125
296908615,1,9,1.0,10,0.1
296925680,1,8,1.0,9,0.1111111111111111
296981745,2,17,2.0,19,0.10526315789473684
296988567,2,17,2.0,19,0.10526315789473684
296999662,1,8,1.0,9,0.1111111111111111
297003725,2,8,2.0,10,0.2
297004621,1,8,1.0,9,0.1111111111111111
297011446,1,8,1.0,9,0.1111111111111111
297043876,1,9,1.0,10,0.1
297048221,4,5,4.0,9,0.4444444444444444
297068639,1,8,1.0,9,0.1111111111111111
297081864,1,9,1.0,10,0.1
297126171,5,4,4.0,9,0.4444444444444444
297146105,2,8,2.0,10,0.2
297170831,1,18,1.0,19,0.05263157894736842
297175303,2,8,2.0,10,0.2
297181081,2,8,2.0,10,0.2
297181708,4,6,4.0,10,0.4
297184269,5,3,3.0,8,0.375
297184784,3,7,3.0,10,0.3
297192809,2,8,2.0,10,0.2
297196371,6,4,4.0,10,0.4
297240651,5,4,4.0,9,0.4444444444444444
297242682,9,1,1.0,10,0.1
297246281,26,4,4.0,30,0.13333333333333333
297248516,3,7,3.0,10,0.3
297249083,5,5,5.0,10,0.5
297249351,1,9,1.0,10,0.1
297250080,8,1,1.0,9,0.1111111111111111
297250748,3,6,3.0,9,0.3333333333333333
297251406,8,2,2.0,10,0.2
297260398,6,4,4.0,10,0.4
297264969,9,1,1.0,10,0.1
297277821,6,3,3.0,9,0.3333333333333333
297278442,6,3,3.0,9,0.3333333333333333
297278563,8,1,1.0,9,0.1111111111111111
297278768,20,5,5.0,25,0.2
297280578,5,5,5.0,10,0.5
297285400,1,8,1.0,9,0.1111111111111111
297307295,4,6,4.0,10,0.4
297326706,2,8,2.0,10,0.2
297329606,4,6,4.0,10,0.4
297340507,1,8,1.0,9,0.1111111111111111
297346267,2,15,2.0,17,0.11764705882352941
297355653,1,9,1.0,10,0.1
297355914,4,6,4.0,10,0.4
297361012,8,2,2.0,10,0.2
297361463,9,1,1.0,10,0.1
297413157,6,12,6.0,18,0.3333333333333333
297425598,8,2,2.0,10,0.2
297442708,4,5,4.0,9,0.4444444444444444
297444297,1,9,1.0,10,0.1
297444689,1,14,1.0,15,0.06666666666666667
297445351,8,2,2.0,10,0.2
297453048,1,9,1.0,10,0.1
297474016,2,18,2.0,20,0.1
297474823,4,6,4.0,10,0.4
297475942,6,4,4.0,10,0.4
297477612,1,9,1.0,10,0.1
297502693,2,6,2.0,8,0.25
297526074,1,9,1.0,10,0.1
297562937,2,8,2.0,10,0.2
297573863,1,9,1.0,10,0.1
297582497,6,14,6.0,20,0.3
297634052,10,10,10.0,20,0.5
297635369,3,17,3.0,20,0.15
297640310,1,17,1.0,18,0.05555555555555555
297741494,8,1,1.0,9,0.1111111111111111
297774186,6,4,4.0,10,0.4
297789585,2,7,2.0,9,0.2222222222222222
297806819,2,18,2.0,20,0.1
297810772,2,27,2.0,29,0.06896551724137931
297817010,5,5,5.0,10,0.5
297821746,1,8,1.0,9,0.1111111111111111
297829774,2,8,2.0,10,0.2
297858286,1,8,1.0,9,0.1111111111111111
297864386,3,7,3.0,10,0.3
297898134,2,8,2.0,10,0.2
297899746,2,17,2.0,19,0.10526315789473684
297913477,1,8,1.0,9,0.1111111111111111
297948338,2,7,2.0,9,0.2222222222222222
297951904,2,8,2.0,10,0.2
297957638,1,18,1.0,19,0.05263157894736842
297975724,1,7,1.0,8,0.125
297992807,1,9,1.0,10,0.1
297997048,2,7,2.0,9,0.2222222222222222
298009725,2,8,2.0,10,0.2
298055964,2,7,2.0,9,0.2222222222222222
298065235,1,9,1.0,10,0.1
298082465,2,8,2.0,10,0.2
298093966,1,9,1.0,10,0.1
298108521,2,18,2.0,20,0.1
298116189,26,4,4.0,30,0.13333333333333333
298116367,1,9,1.0,10,0.1
298147008,3,6,3.0,9,0.3333333333333333
298150701,4,14,4.0,18,0.2222222222222222
298157805,3,7,3.0,10,0.3
298179676,1,9,1.0,10,0.1
298277002,2,27,2.0,29,0.06896551724137931
298350311,5,4,4.0,9,0.4444444444444444
298350563,3,7,3.0,10,0.3
298350830,5,5,5.0,10,0.5
298369939,1,9,1.0,10,0.1
298372022,9,1,1.0,10,0.1
298380165,11,9,9.0,20,0.45
298380525,6,4,4.0,10,0.4
298399588,1,9,1.0,10,0.1
298439537,5,4,4.0,9,0.4444444444444444
298466212,1,19,1.0,20,0.05
298483942,7,1,1.0,8,0.125
298485478,27,3,3.0,30,0.1
298491687,1,7,1.0,8,0.125
298494347,5,5,5.0,10,0.5
298496743,5,3,3.0,8,0.375
298512272,2,8,2.0,10,0.2
298536144,2,6,2.0,8,0.25
298536728,1,9,1.0,10,0.1
298550809,1,9,1.0,10,0.1
298563734,2,16,2.0,18,0.1111111111111111
298588845,6,4,4.0,10,0.4
298617678,1,9,1.0,10,0.1
298651275,2,8,2.0,10,0.2
298654020,1,26,1.0,27,0.037037037037037035
298654549,5,5,5.0,10,0.5
298737565,2,7,2.0,9,0.2222222222222222
298737887,2,7,2.0,9,0.2222222222222222
298746922,9,1,1.0,10,0.1
298747221,26,2,2.0,28,0.07142857142857142
298750994,1,8,1.0,9,0.1111111111111111
298758096,3,26,3.0,29,0.10344827586206896
298788103,1,8,1.0,9,0.1111111111111111
298816285,1,8,1.0,9,0.1111111111111111
298831891,1,25,1.0,26,0.038461538461538464
298845353,4,6,4.0,10,0.4
298848129,6,4,4.0,10,0.4
298849883,9,1,1.0,10,0.1
298854514,7,2,2.0,9,0.2222222222222222
298866499,1,8,1.0,9,0.1111111111111111
298868581,1,7,1.0,8,0.125
298873592,9,1,1.0,10,0.1
298873947,8,1,1.0,9,0.1111111111111111
298875829,5,5,5.0,10,0.5
298876383,3,6,3.0,9,0.3333333333333333
298876832,14,14,14.0,28,0.5
298882841,1,8,1.0,9,0.1111111111111111
298918117,1,9,1.0,10,0.1
298947916,1,9,1.0,10,0.1
298976867,8,2,2.0,10,0.2
298983255,1,8,1.0,9,0.1111111111111111
298985319,1,9,1.0,10,0.1
298994892,1,19,1.0,20,0.05
298997003,1,17,1.0,18,0.05555555555555555
299035595,1,9,1.0,10,0.1
299081302,4,16,4.0,20,0.2
299084179,2,8,2.0,10,0.2
299169051,13,7,7.0,20,0.35
299180110,1,9,1.0,10,0.1
299182533,2,17,2.0,19,0.10526315789473684
299185776,1,9,1.0,10,0.1
299185890,8,1,1.0,9,0.1111111111111111
299202217,1,19,1.0,20,0.05
299229042,8,2,2.0,10,0.2
299230272,5,5,5.0,10,0.5
299231550,4,6,4.0,10,0.4
299248688,11,15,11.0,26,0.4230769230769231
299248877,8,1,1.0,9,0.1111111111111111
299248983,1,9,1.0,10,0.1
299249087,7,2,2.0,9,0.2222222222222222
299249343,9,1,1.0,10,0.1
299249914,3,7,3.0,10,0.3
299250082,8,1,1.0,9,0.1111111111111111
299264101,7,3,3.0,10,0.3
299265158,16,12,12.0,28,0.42857142857142855
299279986,19,7,7.0,26,0.2692307692307692
299288826,6,4,4.0,10,0.4
299308845,2,18,2.0,20,0.1
299364078,4,5,4.0,9,0.4444444444444444
299367944,7,3,3.0,10,0.3
299368127,24,3,3.0,27,0.1111111111111111
299420223,1,19,1.0,20,0.05
299438555,2,8,2.0,10,0.2
299439857,1,9,1.0,10,0.1
299468992,1,9,1.0,10,0.1
299494186,2,8,2.0,10,0.2
299508836,1,7,1.0,8,0.125
299509137,1,8,1.0,9,0.1111111111111111
299517319,1,9,1.0,10,0.1
299522059,4,6,4.0,10,0.4
299559645,1,8,1.0,9,0.1111111111111111
299563978,1,8,1.0,9,0.1111111111111111
299564460,2,7,2.0,9,0.2222222222222222
299567186,1,9,1.0,10,0.1
299567307,1,17,1.0,18,0.05555555555555555
299567875,1,9,1.0,10,0.1
299581623,8,2,2.0,10,0.2
299598326,1,7,1.0,8,0.125
299632909,1,9,1.0,10,0.1
299667692,1,19,1.0,20,0.05
299687795,1,9,1.0,10,0.1
299741001,7,3,3.0,10,0.3
299741317,2,7,2.0,9,0.2222222222222222
299742184,6,4,4.0,10,0.4
299742901,3,7,3.0,10,0.3
299743907,9,1,1.0,10,0.1
299807224,4,6,4.0,10,0.4
299815215,1,18,1.0,19,0.05263157894736842
299861797,1,9,1.0,10,0.1
299881781,1,9,1.0,10,0.1
299890656,1,9,1.0,10,0.1
299905137,2,8,2.0,10,0.2
299905426,5,5,5.0,10,0.5
299905950,2,8,2.0,10,0.2
299906425,4,6,4.0,10,0.4
299906744,4,6,4.0,10,0.4
299907288,1,9,1.0,10,0.1
299909113,1,9,1.0,10,0.1
299915093,1,9,1.0,10,0.1
299917551,1,9,1.0,10,0.1
299918314,1,19,1.0,20,0.05
299996466,4,5,4.0,9,0.4444444444444444
299997767,7,3,3.0,10,0.3
300014161,3,6,3.0,9,0.3333333333333333
300015048,3,17,3.0,20,0.15
300027346,2,8,2.0,10,0.2
300035679,3,7,3.0,10,0.3
300036127,5,5,5.0,10,0.5
300037950,18,10,10.0,28,0.35714285714285715
300038168,4,6,4.0,10,0.4
300055329,1,19,1.0,20,0.05
300060512,2,6,2.0,8,0.25
300063419,1,8,1.0,9,0.1111111111111111
300084844,2,8,2.0,10,0.2
300094665,3,15,3.0,18,0.16666666666666666
300095498,1,8,1.0,9,0.1111111111111111
300097942,2,17,2.0,19,0.10526315789473684
300122998,1,7,1.0,8,0.125
300125772,1,9,1.0,10,0.1
300135985,3,7,3.0,10,0.3
300138364,5,5,5.0,10,0.5
300157995,1,8,1.0,9,0.1111111111111111
300185947,3,6,3.0,9,0.3333333333333333
300186175,6,3,3.0,9,0.3333333333333333
300197120,3,6,3.0,9,0.3333333333333333
300208824,2,7,2.0,9,0.2222222222222222
300212258,1,9,1.0,10,0.1
300220284,1,19,1.0,20,0.05
300234407,1,7,1.0,8,0.125
300234659,3,6,3.0,9,0.3333333333333333
300234802,8,22,8.0,30,0.26666666666666666
300235079,7,3,3.0,10,0.3
300235323,6,4,4.0,10,0.4
300237719,2,8,2.0,10,0.2
300238055,7,2,2.0,9,0.2222222222222222
300275537,1,8,1.0,9,0.1111111111111111
300278093,1,8,1.0,9,0.1111111111111111
300331870,4,5,4.0,9,0.4444444444444444
300364333,2,8,2.0,10,0.2
300365019,2,8,2.0,10,0.2
300411287,1,9,1.0,10,0.1
300417324,1,9,1.0,10,0.1
300460713,2,8,2.0,10,0.2
300464967,1,18,1.0,19,0.05263157894736842
300477145,3,15,3.0,18,0.16666666666666666
300479718,2,17,2.0,19,0.10526315789473684
300491784,2,7,2.0,9,0.2222222222222222
300493918,1,9,1.0,10,0.1
300505464,4,6,4.0,10,0.4
300506437,4,6,4.0,10,0.4
300513016,7,2,2.0,9,0.2222222222222222
300514457,5,15,5.0,20,0.25
300514987,7,3,3.0,10,0.3
300521473,7,3,3.0,10,0.3
300523737,1,9,1.0,10,0.1
300528825,1,9,1.0,10,0.1
300587666,1,9,1.0,10,0.1
300597413,2,8,2.0,10,0.2
300598760,2,8,2.0,10,0.2
300599953,4,6,4.0,10,0.4
300621475,2,18,2.0,20,0.1
300628518,1,7,1.0,8,0.125
300629179,3,7,3.0,10,0.3
300629624,1,9,1.0,10,0.1
300632216,2,8,2.0,10,0.2
300633325,3,7,3.0,10,0.3
300644739,1,7,1.0,8,0.125
300646493,1,9,1.0,10,0.1
300648123,3,7,3.0,10,0.3
300648814,9,1,1.0,10,0.1
300681028,1,18,1.0,19,0.05263157894736842
300685232,2,17,2.0,19,0.10526315789473684
300713026,2,8,2.0,10,0.2
300713227,1,8,1.0,9,0.1111111111111111
300716398,2,8,2.0,10,0.2
300716641,1,9,1.0,10,0.1
300726060,4,23,4.0,27,0.14814814814814814
300743998,1,18,1.0,19,0.05263157894736842
300763286,1,19,1.0,20,0.05
300767355,1,22,1.0,23,0.043478260869565216
300803940,2,16,2.0,18,0.1111111111111111
300810058,1,24,1.0,25,0.04
300811304,6,3,3.0,9,0.3333333333333333
300856363,10,9,9.0,19,0.47368421052631576
300856969,6,21,6.0,27,0.2222222222222222
300858222,7,3,3.0,10,0.3
300862281,1,18,1.0,19,0.05263157894736842
300871954,1,8,1.0,9,0.1111111111111111
300912484,3,7,3.0,10,0.3
300912692,1,8,1.0,9,0.1111111111111111
300951249,1,9,1.0,10,0.1
300974941,3,5,3.0,8,0.375
300991143,1,9,1.0,10,0.1
301009158,1,8,1.0,9,0.1111111111111111
301019153,2,8,2.0,10,0.2
301050005,1,8,1.0,9,0.1111111111111111
301057803,3,6,3.0,9,0.3333333333333333
301058994,6,4,4.0,10,0.4
301059633,1,7,1.0,8,0.125
301060109,3,6,3.0,9,0.3333333333333333
301090401,2,8,2.0,10,0.2
301090414,5,3,3.0,8,0.375
301092822,1,9,1.0,10,0.1
301096938,2,8,2.0,10,0.2
301098855,23,5,5.0,28,0.17857142857142858
301101254,5,5,5.0,10,0.5
301106053,2,8,2.0,10,0.2
301108075,1,9,1.0,10,0.1
301110458,1,9,1.0,10,0.1
301134846,1,9,1.0,10,0.1
301140208,6,4,4.0,10,0.4
301140722,13,6,6.0,19,0.3157894736842105
301154960,3,7,3.0,10,0.3
301162299,2,8,2.0,10,0.2
301173774,24,6,6.0,30,0.2
301195690,1,18,1.0,19,0.05263157894736842
301200700,1,18,1.0,19,0.05263157894736842
301202703,15,12,12.0,27,0.4444444444444444
301204728,8,2,2.0,10,0.2
301245131,3,7,3.0,10,0.3
301246221,4,15,4.0,19,0.21052631578947367
301272434,2,7,2.0,9,0.2222222222222222
301286897,8,1,1.0,9,0.1111111111111111
301295553,2,8,2.0,10,0.2
301354735,9,1,1.0,10,0.1
301354985,25,4,4.0,29,0.13793103448275862
301355317,8,2,2.0,10,0.2
301364831,3,7,3.0,10,0.3
301372253,1,9,1.0,10,0.1
301373345,4,6,4.0,10,0.4
301377758,2,8,2.0,10,0.2
301386828,1,9,1.0,10,0.1
301402657,4,5,4.0,9,0.4444444444444444
301403191,1,9,1.0,10,0.1
301403483,1,9,1.0,10,0.1
301406911,3,7,3.0,10,0.3
301407596,1,9,1.0,10,0.1
301408342,12,17,12.0,29,0.41379310344827586
301439179,2,14,2.0,16,0.125
301439368,9,1,1.0,10,0.1
301499730,3,7,3.0,10,0.3
301505067,1,9,1.0,10,0.1
301505479,4,6,4.0,10,0.4
301505727,2,18,2.0,20,0.1
301505743,3,6,3.0,9,0.3333333333333333
301506531,1,9,1.0,10,0.1
301521629,2,27,2.0,29,0.06896551724137931
301521883,1,7,1.0,8,0.125
301553308,4,5,4.0,9,0.4444444444444444
301554010,2,8,2.0,10,0.2
301556874,8,2,2.0,10,0.2
301586823,8,1,1.0,9,0.1111111111111111
301587557,5,5,5.0,10,0.5
301618732,4,5,4.0,9,0.4444444444444444
301620586,18,8,8.0,26,0.3076923076923077
301621694,1,17,1.0,18,0.05555555555555555
301622471,1,8,1.0,9,0.1111111111111111
301655325,3,7,3.0,10,0.3
301655488,1,9,1.0,10,0.1
301658492,2,7,2.0,9,0.2222222222222222
301660849,2,16,2.0,18,0.1111111111111111
301677094,14,6,6.0,20,0.3
301677589,5,5,5.0,10,0.5
301681832,2,7,2.0,9,0.2222222222222222
301683146,6,4,4.0,10,0.4
301685192,6,4,4.0,10,0.4
301685500,2,6,2.0,8,0.25
301691629,1,9,1.0,10,0.1
301698197,2,8,2.0,10,0.2
301729652,1,17,1.0,18,0.05555555555555555
301730317,3,6,3.0,9,0.3333333333333333
301731909,1,7,1.0,8,0.125
301742446,8,11,8.0,19,0.42105263157894735
301759914,1,9,1.0,10,0.1
301773753,1,9,1.0,10,0.1
301787598,3,6,3.0,9,0.3333333333333333
301815257,1,18,1.0,19,0.05263157894736842
301824273,1,9,1.0,10,0.1
301865597,1,9,1.0,10,0.1
301867913,1,26,1.0,27,0.037037037037037035
301879405,1,9,1.0,10,0.1
301889097,7,3,3.0,10,0.3
301906817,2,18,2.0,20,0.1
301908835,1,9,1.0,10,0.1
301917866,4,5,4.0,9,0.4444444444444444
301925015,1,9,1.0,10,0.1
301925517,7,3,3.0,10,0.3
301986006,4,5,4.0,9,0.4444444444444444
301987502,2,7,2.0,9,0.2222222222222222
302023814,1,17,1.0,18,0.05555555555555555
302050606,4,16,4.0,20,0.2
302076996,2,7,2.0,9,0.2222222222222222
302077554,2,8,2.0,10,0.2
302111476,1,9,1.0,10,0.1
302124541,1,18,1.0,19,0.05263157894736842
302143991,2,8,2.0,10,0.2
302186314,1,8,1.0,9,0.1111111111111111
302188256,4,6,4.0,10,0.4
302188433,3,16,3.0,19,0.15789473684210525
302229704,2,7,2.0,9,0.2222222222222222
302252137,4,6,4.0,10,0.4
302260831,1,7,1.0,8,0.125
302261151,1,9,1.0,10,0.1
302266123,1,9,1.0,10,0.1
302275010,10,16,10.0,26,0.38461538461538464
302276160,7,22,7.0,29,0.2413793103448276
302314736,2,8,2.0,10,0.2
302340940,1,9,1.0,10,0.1
302346610,2,8,2.0,10,0.2
302349705,2,15,2.0,17,0.11764705882352941
302351751,1,9,1.0,10,0.1
302352241,5,4,4.0,9,0.4444444444444444
302355033,3,5,3.0,8,0.375
302381159,7,3,3.0,10,0.3
302381405,2,8,2.0,10,0.2
302381877,3,5,3.0,8,0.375
302440849,1,8,1.0,9,0.1111111111111111
302467701,1,8,1.0,9,0.1111111111111111
302476309,5,4,4.0,9,0.4444444444444444
302480597,3,6,3.0,9,0.3333333333333333
302480989,4,5,4.0,9,0.4444444444444444
302481865,3,7,3.0,10,0.3
302484626,1,9,1.0,10,0.1
302488329,5,5,5.0,10,0.5
302509981,1,7,1.0,8,0.125
302514839,3,6,3.0,9,0.3333333333333333
302516526,1,9,1.0,10,0.1
302517174,2,27,2.0,29,0.06896551724137931
302530955,1,18,1.0,19,0.05263157894736842
302554992,1,9,1.0,10,0.1
302555086,1,8,1.0,9,0.1111111111111111
302555832,2,8,2.0,10,0.2
302569953,3,7,3.0,10,0.3
302576010,5,4,4.0,9,0.4444444444444444
302577019,1,8,1.0,9,0.1111111111111111
302577411,2,8,2.0,10,0.2
302586750,19,9,9.0,28,0.32142857142857145
302592105,6,4,4.0,10,0.4
302593421,4,5,4.0,9,0.4444444444444444
302593591,7,3,3.0,10,0.3
302602887,3,7,3.0,10,0.3
302604446,3,5,3.0,8,0.375
302604714,3,7,3.0,10,0.3
302605872,5,4,4.0,9,0.4444444444444444
302606509,2,8,2.0,10,0.2
302606895,3,6,3.0,9,0.3333333333333333
302607309,1,9,1.0,10,0.1
302607387,1,9,1.0,10,0.1
302608889,1,9,1.0,10,0.1
302610970,3,6,3.0,9,0.3333333333333333
302612630,4,6,4.0,10,0.4
302613139,3,5,3.0,8,0.375
302618887,1,8,1.0,9,0.1111111111111111
302622513,1,8,1.0,9,0.1111111111111111
302623237,5,5,5.0,10,0.5
302643957,2,6,2.0,8,0.25
302644607,1,8,1.0,9,0.1111111111111111
302646426,1,8,1.0,9,0.1111111111111111
302672337,1,9,1.0,10,0.1
302672946,1,9,1.0,10,0.1
302675883,1,8,1.0,9,0.1111111111111111
302701339,1,9,1.0,10,0.1
302708468,5,4,4.0,9,0.4444444444444444
302727086,6,3,3.0,9,0.3333333333333333
302727783,3,7,3.0,10,0.3
302763635,2,16,2.0,18,0.1111111111111111
302779394,1,8,1.0,9,0.1111111111111111
302781810,5,5,5.0,10,0.5
302825356,4,6,4.0,10,0.4
302853044,7,3,3.0,10,0.3
302863969,3,6,3.0,9,0.3333333333333333
302864331,2,17,2.0,19,0.10526315789473684
302870576,2,7,2.0,9,0.2222222222222222
302871280,3,16,3.0,19,0.15789473684210525
302875297,1,9,1.0,10,0.1
302900174,1,9,1.0,10,0.1
302901319,1,9,1.0,10,0.1
302901592,18,11,11.0,29,0.3793103448275862
302901874,7,3,3.0,10,0.3
302902099,8,1,1.0,9,0.1111111111111111
302902676,8,1,1.0,9,0.1111111111111111
302902869,9,1,1.0,10,0.1
302902901,28,2,2.0,30,0.06666666666666667
302922627,7,2,2.0,9,0.2222222222222222
302924825,27,2,2.0,29,0.06896551724137931
302951039,1,8,1.0,9,0.1111111111111111
302953740,1,9,1.0,10,0.1
302954286,1,8,1.0,9,0.1111111111111111
302959607,1,9,1.0,10,0.1
302973051,3,7,3.0,10,0.3
302975930,1,9,1.0,10,0.1
303006896,1,8,1.0,9,0.1111111111111111
303029050,1,18,1.0,19,0.05263157894736842
303043343,1,19,1.0,20,0.05
303082602,1,17,1.0,18,0.05555555555555555
303087024,1,9,1.0,10,0.1
303088402,1,9,1.0,10,0.1
303092150,1,9,1.0,10,0.1
303092596,9,1,1.0,10,0.1
303092721,9,1,1.0,10,0.1
303096567,2,16,2.0,18,0.1111111111111111
303097930,8,2,2.0,10,0.2
303097976,2,17,2.0,19,0.10526315789473684
303109190,2,8,2.0,10,0.2
303109784,5,15,5.0,20,0.25
303121087,1,7,1.0,8,0.125
303128920,9,1,1.0,10,0.1
303129764,8,2,2.0,10,0.2
303140649,1,8,1.0,9,0.1111111111111111
303163507,1,9,1.0,10,0.1
303164897,1,9,1.0,10,0.1
303189977,2,7,2.0,9,0.2222222222222222
303209882,1,9,1.0,10,0.1
303230924,1,9,1.0,10,0.1
303235807,1,8,1.0,9,0.1111111111111111
303244338,4,16,4.0,20,0.2
303262945,1,9,1.0,10,0.1
303263277,1,9,1.0,10,0.1
303263405,6,4,4.0,10,0.4
303278192,4,6,4.0,10,0.4
303279050,1,9,1.0,10,0.1
303283986,1,9,1.0,10,0.1
303284031,2,8,2.0,10,0.2
303286593,14,4,4.0,18,0.2222222222222222
303293489,1,8,1.0,9,0.1111111111111111
303333154,3,7,3.0,10,0.3
303337034,1,9,1.0,10,0.1
303348223,2,8,2.0,10,0.2
303374383,1,8,1.0,9,0.1111111111111111
303379466,1,7,1.0,8,0.125
303391805,8,21,8.0,29,0.27586206896551724
303392681,3,7,3.0,10,0.3
303406660,2,8,2.0,10,0.2
303424399,1,9,1.0,10,0.1
303433692,5,4,4.0,9,0.4444444444444444
303443242,26,2,2.0,28,0.07142857142857142
303460849,1,19,1.0,20,0.05
303469904,1,9,1.0,10,0.1
303497917,2,8,2.0,10,0.2
303547421,6,14,6.0,20,0.3
303568335,1,8,1.0,9,0.1111111111111111
303610654,1,18,1.0,19,0.05263157894736842
303635793,1,9,1.0,10,0.1
303637368,1,9,1.0,10,0.1
303730721,2,7,2.0,9,0.2222222222222222
303731029,19,9,9.0,28,0.32142857142857145
303760999,1,8,1.0,9,0.1111111111111111
303802174,9,1,1.0,10,0.1
303816484,4,24,4.0,28,0.14285714285714285
303821536,5,5,5.0,10,0.5
303823532,1,9,1.0,10,0.1
303824835,2,8,2.0,10,0.2
303836215,8,1,1.0,9,0.1111111111111111
303839188,7,3,3.0,10,0.3
303843810,3,7,3.0,10,0.3
303867688,2,7,2.0,9,0.2222222222222222
303875901,2,8,2.0,10,0.2
303917461,1,9,1.0,10,0.1
303926028,2,8,2.0,10,0.2
303966853,2,7,2.0,9,0.2222222222222222
303969444,8,1,1.0,9,0.1111111111111111
303970131,5,14,5.0,19,0.2631578947368421
303974172,7,2,2.0,9,0.2222222222222222
303974496,8,2,2.0,10,0.2
303976316,1,8,1.0,9,0.1111111111111111
304002271,1,7,1.0,8,0.125
304031495,2,18,2.0,20,0.1
304051185,1,9,1.0,10,0.1
304058478,1,9,1.0,10,0.1
304064650,10,18,10.0,28,0.35714285714285715
304068274,5,4,4.0,9,0.4444444444444444
304100993,1,9,1.0,10,0.1
304118590,1,9,1.0,10,0.1
304130924,1,28,1.0,29,0.034482758620689655
304133564,1,9,1.0,10,0.1
304162021,2,6,2.0,8,0.25
304164199,1,9,1.0,10,0.1
304164757,2,8,2.0,10,0.2
304204782,4,16,4.0,20,0.2
304243872,8,2,2.0,10,0.2
304244147,2,8,2.0,10,0.2
304244403,23,3,3.0,26,0.11538461538461539
304244941,9,1,1.0,10,0.1
304247733,2,18,2.0,20,0.1
304282822,1,9,1.0,10,0.1
304341144,2,8,2.0,10,0.2
304346295,1,9,1.0,10,0.1
304354865,2,7,2.0,9,0.2222222222222222
304361676,3,7,3.0,10,0.3
304364392,1,9,1.0,10,0.1
304380747,1,26,1.0,27,0.037037037037037035
304393713,1,9,1.0,10,0.1
304393793,1,9,1.0,10,0.1
304398103,7,2,2.0,9,0.2222222222222222
304398307,7,2,2.0,9,0.2222222222222222
304406376,3,7,3.0,10,0.3
304437358,2,17,2.0,19,0.10526315789473684
304453544,1,8,1.0,9,0.1111111111111111
304474349,8,2,2.0,10,0.2
304477480,1,8,1.0,9,0.1111111111111111
304496448,3,7,3.0,10,0.3
304525554,1,8,1.0,9,0.1111111111111111
304526250,7,3,3.0,10,0.3
304550610,7,2,2.0,9,0.2222222222222222
304562355,2,7,2.0,9,0.2222222222222222
304564066,4,5,4.0,9,0.4444444444444444
304568354,11,18,11.0,29,0.3793103448275862
304592469,6,4,4.0,10,0.4
304592896,15,5,5.0,20,0.25
304593027,7,3,3.0,10,0.3
304601467,3,17,3.0,20,0.15
304639850,3,6,3.0,9,0.3333333333333333
304640090,2,7,2.0,9,0.2222222222222222
304640722,9,1,1.0,10,0.1
304642224,1,19,1.0,20,0.05
304649123,6,4,4.0,10,0.4
304649945,3,17,3.0,20,0.15
304667303,2,7,2.0,9,0.2222222222222222
304668627,5,5,5.0,10,0.5
304669471,5,4,4.0,9,0.4444444444444444
304705770,1,9,1.0,10,0.1
304715500,1,18,1.0,19,0.05263157894736842
304734008,1,9,1.0,10,0.1
304735678,9,1,1.0,10,0.1
304736521,5,4,4.0,9,0.4444444444444444
304745710,7,3,3.0,10,0.3
304746110,3,26,3.0,29,0.10344827586206896
304775574,3,7,3.0,10,0.3
304794152,2,7,2.0,9,0.2222222222222222
304801337,1,9,1.0,10,0.1
304826162,3,7,3.0,10,0.3
304826174,1,8,1.0,9,0.1111111111111111
304828976,2,7,2.0,9,0.2222222222222222
304844577,3,7,3.0,10,0.3
304851110,4,4,4.0,8,0.5
304897611,2,8,2.0,10,0.2
304898907,1,9,1.0,10,0.1
304901111,2,8,2.0,10,0.2
304903979,1,17,1.0,18,0.05555555555555555
304912427,5,4,4.0,9,0.4444444444444444
304963287,1,8,1.0,9,0.1111111111111111
304963875,1,7,1.0,8,0.125
304967263,1,9,1.0,10,0.1
304972571,1,9,1.0,10,0.1
304973888,8,1,1.0,9,0.1111111111111111
304978896,3,6,3.0,9,0.3333333333333333
305001564,1,8,1.0,9,0.1111111111111111
305010584,8,2,2.0,10,0.2
305011874,5,5,5.0,10,0.5
305041823,8,1,1.0,9,0.1111111111111111
305046860,8,1,1.0,9,0.1111111111111111
305052199,5,5,5.0,10,0.5
305059033,3,15,3.0,18,0.16666666666666666
305085651,6,3,3.0,9,0.3333333333333333
305098131,1,18,1.0,19,0.05263157894736842
305098672,9,1,1.0,10,0.1
305100968,2,8,2.0,10,0.2
305174743,1,9,1.0,10,0.1
305193025,4,5,4.0,9,0.4444444444444444
305207860,2,7,2.0,9,0.2222222222222222
305209084,1,9,1.0,10,0.1
305214156,1,18,1.0,19,0.05263157894736842
305222292,4,6,4.0,10,0.4
305228527,2,8,2.0,10,0.2
305290904,3,6,3.0,9,0.3333333333333333
305314242,1,19,1.0,20,0.05
305327691,4,5,4.0,9,0.4444444444444444
305346716,4,15,4.0,19,0.21052631578947367
305347023,1,9,1.0,10,0.1
305353741,3,16,3.0,19,0.15789473684210525
305366230,5,5,5.0,10,0.5
305368956,2,7,2.0,9,0.2222222222222222
305369653,5,5,5.0,10,0.5
305369908,26,2,2.0,28,0.07142857142857142
305370133,3,5,3.0,8,0.375
305372194,1,9,1.0,10,0.1
305387294,3,7,3.0,10,0.3
305442325,6,4,4.0,10,0.4
305477491,1,7,1.0,8,0.125
305491353,7,2,2.0,9,0.2222222222222222
305516698,4,6,4.0,10,0.4
305531852,1,19,1.0,20,0.05
305537358,1,17,1.0,18,0.05555555555555555
305540168,18,1,1.0,19,0.05263157894736842
305545478,1,9,1.0,10,0.1
305558317,7,2,2.0,9,0.2222222222222222
305558799,7,2,2.0,9,0.2222222222222222
305561262,2,7,2.0,9,0.2222222222222222
305593632,8,1,1.0,9,0.1111111111111111
305620339,9,1,1.0,10,0.1
305625345,1,9,1.0,10,0.1
305635223,6,3,3.0,9,0.3333333333333333
305638070,7,3,3.0,10,0.3
305663487,1,19,1.0,20,0.05
305684333,3,7,3.0,10,0.3
305696112,3,7,3.0,10,0.3
305700620,1,9,1.0,10,0.1
305714012,1,9,1.0,10,0.1
305736162,1,9,1.0,10,0.1
305738773,7,2,2.0,9,0.2222222222222222
305747743,6,11,6.0,17,0.35294117647058826
305754272,1,9,1.0,10,0.1
305766300,8,2,2.0,10,0.2
305766496,1,8,1.0,9,0.1111111111111111
305766625,1,9,1.0,10,0.1
305808333,3,5,3.0,8,0.375
305811601,2,17,2.0,19,0.10526315789473684
305816860,2,26,2.0,28,0.07142857142857142
305818328,3,24,3.0,27,0.1111111111111111
305818806,2,8,2.0,10,0.2
305819051,1,9,1.0,10,0.1
305821957,1,19,1.0,20,0.05
305823608,2,16,2.0,18,0.1111111111111111
305853041,1,9,1.0,10,0.1
305858465,1,18,1.0,19,0.05263157894736842
305877312,8,22,8.0,30,0.26666666666666666
305878012,1,18,1.0,19,0.05263157894736842
305881398,3,5,3.0,8,0.375
305888345,9,1,1.0,10,0.1
305891215,15,14,14.0,29,0.4827586206896552
305893997,9,1,1.0,10,0.1
305902276,1,9,1.0,10,0.1
305915733,1,8,1.0,9,0.1111111111111111
305920657,1,9,1.0,10,0.1
305920948,4,6,4.0,10,0.4
305921266,4,6,4.0,10,0.4
305922431,2,8,2.0,10,0.2
305922645,1,8,1.0,9,0.1111111111111111
305925048,1,28,1.0,29,0.034482758620689655
305925303,2,8,2.0,10,0.2
305925553,2,8,2.0,10,0.2
305925722,1,8,1.0,9,0.1111111111111111
305930115,3,6,3.0,9,0.3333333333333333
305932883,1,9,1.0,10,0.1
305950957,1,8,1.0,9,0.1111111111111111
305968551,1,9,1.0,10,0.1
305973801,2,8,2.0,10,0.2
305974165,1,19,1.0,20,0.05
305982309,3,14,3.0,17,0.17647058823529413
305983945,5,4,4.0,9,0.4444444444444444
305987226,2,7,2.0,9,0.2222222222222222
306000427,1,9,1.0,10,0.1
306001080,26,2,2.0,28,0.07142857142857142
306024088,3,6,3.0,9,0.3333333333333333
306027536,1,9,1.0,10,0.1
306032551,10,9,9.0,19,0.47368421052631576
306038000,9,1,1.0,10,0.1
306038546,8,1,1.0,9,0.1111111111111111
306051681,1,7,1.0,8,0.125
306067522,3,25,3.0,28,0.10714285714285714
306078106,4,5,4.0,9,0.4444444444444444
306090633,8,1,1.0,9,0.1111111111111111
306091129,9,1,1.0,10,0.1
306092697,2,8,2.0,10,0.2
306104459,2,8,2.0,10,0.2
306106363,7,3,3.0,10,0.3
306109233,2,7,2.0,9,0.2222222222222222
306109558,5,5,5.0,10,0.5
306110414,7,20,7.0,27,0.25925925925925924
306111957,1,8,1.0,9,0.1111111111111111
306124427,6,4,4.0,10,0.4
306129603,1,9,1.0,10,0.1
306131687,1,8,1.0,9,0.1111111111111111
306152673,7,3,3.0,10,0.3
306200593,1,8,1.0,9,0.1111111111111111
306219899,4,6,4.0,10,0.4
306226848,1,9,1.0,10,0.1
306235432,1,9,1.0,10,0.1
306265047,1,28,1.0,29,0.034482758620689655
306267124,2,18,2.0,20,0.1
306277376,4,6,4.0,10,0.4
306300139,1,9,1.0,10,0.1
306309843,3,7,3.0,10,0.3
306352709,2,8,2.0,10,0.2
306365997,2,7,2.0,9,0.2222222222222222
306367650,2,7,2.0,9,0.2222222222222222
306371105,1,9,1.0,10,0.1
306377229,1,7,1.0,8,0.125
306378144,1,9,1.0,10,0.1
306378957,4,5,4.0,9,0.4444444444444444
306380568,1,9,1.0,10,0.1
306381059,1,9,1.0,10,0.1
306382013,9,11,9.0,20,0.45
306382518,1,7,1.0,8,0.125
306385466,2,8,2.0,10,0.2
306387596,4,24,4.0,28,0.14285714285714285
306388530,2,7,2.0,9,0.2222222222222222
306431818,2,17,2.0,19,0.10526315789473684
306462171,6,20,6.0,26,0.23076923076923078
306462751,1,7,1.0,8,0.125
306464814,3,7,3.0,10,0.3
306472266,1,9,1.0,10,0.1
306473204,7,2,2.0,9,0.2222222222222222
306474612,2,8,2.0,10,0.2
306476606,3,7,3.0,10,0.3
306477933,2,8,2.0,10,0.2
306483796,1,9,1.0,10,0.1
306487880,2,8,2.0,10,0.2
306488429,2,8,2.0,10,0.2
306489064,8,12,8.0,20,0.4
306489446,1,9,1.0,10,0.1
306494631,1,9,1.0,10,0.1
306501978,2,7,2.0,9,0.2222222222222222
306503503,2,8,2.0,10,0.2
306504517,24,4,4.0,28,0.14285714285714285
306504716,2,7,2.0,9,0.2222222222222222
306508192,1,9,1.0,10,0.1
306516283,2,8,2.0,10,0.2
306516990,1,9,1.0,10,0.1
306531060,1,9,1.0,10,0.1
306532366,1,9,1.0,10,0.1
306533363,4,5,4.0,9,0.4444444444444444
306545687,4,5,4.0,9,0.4444444444444444
306549199,2,15,2.0,17,0.11764705882352941
306579383,8,2,2.0,10,0.2
306579700,7,2,2.0,9,0.2222222222222222
306590247,1,8,1.0,9,0.1111111111111111
306622312,8,2,2.0,10,0.2
306623525,2,7,2.0,9,0.2222222222222222
306623710,4,6,4.0,10,0.4
306627180,2,8,2.0,10,0.2
306630032,3,7,3.0,10,0.3
306630995,1,7,1.0,8,0.125
306631418,2,7,2.0,9,0.2222222222222222
306633292,2,8,2.0,10,0.2
306653116,1,8,1.0,9,0.1111111111111111
306655831,3,7,3.0,10,0.3
306659018,28,1,1.0,29,0.034482758620689655
306659584,1,9,1.0,10,0.1
306659677,5,4,4.0,9,0.4444444444444444
306659929,4,4,4.0,8,0.5
306660878,2,8,2.0,10,0.2
306662096,9,1,1.0,10,0.1
306667221,1,9,1.0,10,0.1
306687495,1,8,1.0,9,0.1111111111111111
306692746,3,6,3.0,9,0.3333333333333333
306697979,3,6,3.0,9,0.3333333333333333
306699439,2,8,2.0,10,0.2
306708749,1,16,1.0,17,0.058823529411764705
306729459,2,8,2.0,10,0.2
306733786,1,9,1.0,10,0.1
306736812,10,10,10.0,20,0.5
306736872,9,1,1.0,10,0.1
306744713,1,18,1.0,19,0.05263157894736842
306759176,1,9,1.0,10,0.1
306766118,3,7,3.0,10,0.3
306767978,2,7,2.0,9,0.2222222222222222
306776093,1,9,1.0,10,0.1
306794424,1,8,1.0,9,0.1111111111111111
306797546,1,9,1.0,10,0.1
306828621,2,8,2.0,10,0.2
306831647,4,5,4.0,9,0.4444444444444444
306832116,6,4,4.0,10,0.4
306851197,1,19,1.0,20,0.05
306877622,3,7,3.0,10,0.3
306878023,6,14,6.0,20,0.3
306943440,3,24,3.0,27,0.1111111111111111
306943662,3,14,3.0,17,0.17647058823529413
306989361,1,8,1.0,9,0.1111111111111111
307042479,5,5,5.0,10,0.5
307064754,8,1,1.0,9,0.1111111111111111
307125137,8,1,1.0,9,0.1111111111111111
307141778,2,28,2.0,30,0.06666666666666667
307141917,1,8,1.0,9,0.1111111111111111
307145449,3,7,3.0,10,0.3
307145635,1,9,1.0,10,0.1
307157857,1,9,1.0,10,0.1
307203386,7,13,7.0,20,0.35
307207880,1,9,1.0,10,0.1
307208040,3,6,3.0,9,0.3333333333333333
307209984,8,2,2.0,10,0.2
307217937,1,7,1.0,8,0.125
307219691,1,9,1.0,10,0.1
307230071,9,1,1.0,10,0.1
307230606,4,6,4.0,10,0.4
307234810,2,7,2.0,9,0.2222222222222222
307234850,3,17,3.0,20,0.15
307236134,6,3,3.0,9,0.3333333333333333
307236736,1,9,1.0,10,0.1
307239263,8,2,2.0,10,0.2
307239437,7,3,3.0,10,0.3
307240026,2,7,2.0,9,0.2222222222222222
307262753,7,2,2.0,9,0.2222222222222222
307263256,5,5,5.0,10,0.5
307275597,1,7,1.0,8,0.125
307279367,2,7,2.0,9,0.2222222222222222
307293688,1,9,1.0,10,0.1
307308491,1,9,1.0,10,0.1
307310145,4,6,4.0,10,0.4
307338024,1,9,1.0,10,0.1
307338152,4,6,4.0,10,0.4
307339774,4,6,4.0,10,0.4
307340292,1,9,1.0,10,0.1
307341451,1,9,1.0,10,0.1
307341690,5,4,4.0,9,0.4444444444444444
307344598,1,8,1.0,9,0.1111111111111111
307344749,6,3,3.0,9,0.3333333333333333
307344874,1,9,1.0,10,0.1
307345575,1,9,1.0,10,0.1
307348497,2,8,2.0,10,0.2
307349497,3,7,3.0,10,0.3
307355615,2,8,2.0,10,0.2
307355618,1,9,1.0,10,0.1
307357204,3,16,3.0,19,0.15789473684210525
307361833,1,9,1.0,10,0.1
307371765,7,3,3.0,10,0.3
307404828,1,9,1.0,10,0.1
307419484,1,9,1.0,10,0.1
307423212,4,5,4.0,9,0.4444444444444444
307435085,2,8,2.0,10,0.2
307448441,1,17,1.0,18,0.05555555555555555
307449725,1,9,1.0,10,0.1
307497509,1,8,1.0,9,0.1111111111111111
307501343,1,9,1.0,10,0.1
307511238,1,9,1.0,10,0.1
307538526,1,7,1.0,8,0.125
307555937,1,9,1.0,10,0.1
307559456,1,9,1.0,10,0.1
307569197,1,17,1.0,18,0.05555555555555555
307585408,7,1,1.0,8,0.125
307586345,8,2,2.0,10,0.2
307587743,1,9,1.0,10,0.1
307590998,1,9,1.0,10,0.1
307594280,1,9,1.0,10,0.1
307611215,1,7,1.0,8,0.125
307640641,1,17,1.0,18,0.05555555555555555
307663421,1,9,1.0,10,0.1
307663790,7,11,7.0,18,0.3888888888888889
307670097,1,9,1.0,10,0.1
307710839,3,17,3.0,20,0.15
307725201,9,1,1.0,10,0.1
307736081,1,9,1.0,10,0.1
307737386,2,8,2.0,10,0.2
307747223,6,3,3.0,9,0.3333333333333333
307762241,2,8,2.0,10,0.2
307762748,3,6,3.0,9,0.3333333333333333
307762970,1,9,1.0,10,0.1
307773078,1,8,1.0,9,0.1111111111111111
307781035,6,4,4.0,10,0.4
307801058,2,8,2.0,10,0.2
307810737,4,4,4.0,8,0.5
307812221,1,8,1.0,9,0.1111111111111111
307812266,8,22,8.0,30,0.26666666666666666
307812792,1,9,1.0,10,0.1
307834220,4,5,4.0,9,0.4444444444444444
307836618,1,8,1.0,9,0.1111111111111111
307856522,1,9,1.0,10,0.1
307874913,1,9,1.0,10,0.1
307881635,4,6,4.0,10,0.4
307887420,2,18,2.0,20,0.1
307888059,1,9,1.0,10,0.1
307899164,1,8,1.0,9,0.1111111111111111
307908926,5,4,4.0,9,0.4444444444444444
307909724,5,5,5.0,10,0.5
307919503,8,1,1.0,9,0.1111111111111111
307935244,2,8,2.0,10,0.2
307947201,5,22,5.0,27,0.18518518518518517
307947719,1,8,1.0,9,0.1111111111111111
307948348,2,8,2.0,10,0.2
307948428,6,2,2.0,8,0.25
307948986,2,8,2.0,10,0.2
307949544,5,5,5.0,10,0.5
307997601,2,8,2.0,10,0.2
308008568,1,8,1.0,9,0.1111111111111111
308015667,4,6,4.0,10,0.4
308020851,3,25,3.0,28,0.10714285714285714
308022480,24,5,5.0,29,0.1724137931034483
308027592,1,9,1.0,10,0.1
308029419,8,2,2.0,10,0.2
308065981,2,8,2.0,10,0.2
308102320,1,9,1.0,10,0.1
308116860,5,5,5.0,10,0.5
308121727,7,2,2.0,9,0.2222222222222222
308143242,2,14,2.0,16,0.125
308148788,1,8,1.0,9,0.1111111111111111
308162629,1,9,1.0,10,0.1
308177530,2,8,2.0,10,0.2
308179216,2,7,2.0,9,0.2222222222222222
308184128,3,6,3.0,9,0.3333333333333333
308184432,1,19,1.0,20,0.05
308186679,1,9,1.0,10,0.1
308210474,11,9,9.0,20,0.45
308227643,2,7,2.0,9,0.2222222222222222
308229198,17,12,12.0,29,0.41379310344827586
308229868,8,2,2.0,10,0.2
308230394,8,1,1.0,9,0.1111111111111111
308247937,3,7,3.0,10,0.3
308251472,5,5,5.0,10,0.5
308258621,1,8,1.0,9,0.1111111111111111
308275778,1,17,1.0,18,0.05555555555555555
308277465,6,22,6.0,28,0.21428571428571427
308279148,7,3,3.0,10,0.3
308312597,1,9,1.0,10,0.1
308335394,2,8,2.0,10,0.2
308350878,2,8,2.0,10,0.2
308351506,4,5,4.0,9,0.4444444444444444
308422048,6,4,4.0,10,0.4
308433277,1,7,1.0,8,0.125
308433874,1,9,1.0,10,0.1
308435292,2,8,2.0,10,0.2
308436989,1,9,1.0,10,0.1
308437638,1,18,1.0,19,0.05263157894736842
308439262,9,1,1.0,10,0.1
308450016,16,3,3.0,19,0.15789473684210525
308450215,6,3,3.0,9,0.3333333333333333
308450638,2,7,2.0,9,0.2222222222222222
308453124,1,8,1.0,9,0.1111111111111111
308464451,1,9,1.0,10,0.1
308476315,1,8,1.0,9,0.1111111111111111
308491769,1,9,1.0,10,0.1
308504700,3,5,3.0,8,0.375
308514817,1,17,1.0,18,0.05555555555555555
308530411,3,6,3.0,9,0.3333333333333333
308565597,21,8,8.0,29,0.27586206896551724
308650643,12,16,12.0,28,0.42857142857142855
308659116,1,9,1.0,10,0.1
308690482,1,9,1.0,10,0.1
308722501,1,9,1.0,10,0.1
308725565,1,8,1.0,9,0.1111111111111111
308726277,3,6,3.0,9,0.3333333333333333
308730335,1,9,1.0,10,0.1
308733020,2,8,2.0,10,0.2
308746075,1,8,1.0,9,0.1111111111111111
308746538,11,17,11.0,28,0.39285714285714285
308746947,2,18,2.0,20,0.1
308750267,2,7,2.0,9,0.2222222222222222
308751876,4,6,4.0,10,0.4
308753185,1,8,1.0,9,0.1111111111111111
308760045,1,8,1.0,9,0.1111111111111111
308760247,8,21,8.0,29,0.27586206896551724
308761245,2,8,2.0,10,0.2
308761660,1,7,1.0,8,0.125
308762010,1,7,1.0,8,0.125
308773789,7,13,7.0,20,0.35
308777690,3,6,3.0,9,0.3333333333333333
308778328,3,7,3.0,10,0.3
308782501,4,14,4.0,18,0.2222222222222222
308796188,1,8,1.0,9,0.1111111111111111
308797592,1,9,1.0,10,0.1
308798190,1,9,1.0,10,0.1
308798481,4,6,4.0,10,0.4
308822616,3,6,3.0,9,0.3333333333333333
308865933,8,2,2.0,10,0.2
308869334,1,9,1.0,10,0.1
308876686,1,9,1.0,10,0.1
308887218,1,9,1.0,10,0.1
308888962,6,4,4.0,10,0.4
308892506,4,6,4.0,10,0.4
308895625,1,8,1.0,9,0.1111111111111111
308904835,5,21,5.0,26,0.19230769230769232
308920233,1,8,1.0,9,0.1111111111111111
308932323,2,6,2.0,8,0.25
308937936,8,1,1.0,9,0.1111111111111111
308939180,9,1,1.0,10,0.1
308943117,4,6,4.0,10,0.4
308947094,2,8,2.0,10,0.2
308955291,1,8,1.0,9,0.1111111111111111
308957456,3,25,3.0,28,0.10714285714285714
308965483,11,19,11.0,30,0.36666666666666664
308970708,3,6,3.0,9,0.3333333333333333
308971349,6,4,4.0,10,0.4
308972294,1,8,1.0,9,0.1111111111111111
308973654,11,17,11.0,28,0.39285714285714285
308975928,1,9,1.0,10,0.1
308984991,1,8,1.0,9,0.1111111111111111
309029969,8,2,2.0,10,0.2
309040129,1,9,1.0,10,0.1
309040810,3,6,3.0,9,0.3333333333333333
309041592,2,8,2.0,10,0.2
309052448,1,9,1.0,10,0.1
309054978,1,7,1.0,8,0.125
309061655,3,5,3.0,8,0.375
309103644,3,7,3.0,10,0.3
309107323,1,17,1.0,18,0.05555555555555555
309115159,3,24,3.0,27,0.1111111111111111
309121662,7,2,2.0,9,0.2222222222222222
309151017,1,9,1.0,10,0.1
309151879,1,9,1.0,10,0.1
309152684,1,9,1.0,10,0.1
309171998,5,4,4.0,9,0.4444444444444444
309198761,1,9,1.0,10,0.1
309199677,3,17,3.0,20,0.15
309220474,3,7,3.0,10,0.3
309227611,8,20,8.0,28,0.2857142857142857
309235235,1,9,1.0,10,0.1
309238427,2,17,2.0,19,0.10526315789473684
309258448,2,7,2.0,9,0.2222222222222222
309259680,3,7,3.0,10,0.3
309313819,1,8,1.0,9,0.1111111111111111
309327969,9,1,1.0,10,0.1
309327985,4,4,4.0,8,0.5
309340007,4,5,4.0,9,0.4444444444444444
309344285,9,1,1.0,10,0.1
309349034,1,8,1.0,9,0.1111111111111111
309370175,1,9,1.0,10,0.1
309453071,1,16,1.0,17,0.058823529411764705
309453116,2,7,2.0,9,0.2222222222222222
309467207,3,16,3.0,19,0.15789473684210525
309488050,4,16,4.0,20,0.2
309503527,1,19,1.0,20,0.05
309519421,1,8,1.0,9,0.1111111111111111
309546133,1,19,1.0,20,0.05
309564554,1,9,1.0,10,0.1
309580668,4,23,4.0,27,0.14814814814814814
309582228,2,8,2.0,10,0.2
309598592,6,4,4.0,10,0.4
309628302,1,18,1.0,19,0.05263157894736842
309639840,1,9,1.0,10,0.1
309646349,5,23,5.0,28,0.17857142857142858
309658430,3,7,3.0,10,0.3
309682901,10,8,8.0,18,0.4444444444444444
309707182,3,17,3.0,20,0.15
309718961,1,8,1.0,9,0.1111111111111111
309722920,2,7,2.0,9,0.2222222222222222
309725638,3,7,3.0,10,0.3
309762768,1,18,1.0,19,0.05263157894736842
309765017,1,8,1.0,9,0.1111111111111111
309765111,7,3,3.0,10,0.3
309768274,3,7,3.0,10,0.3
309777751,1,9,1.0,10,0.1
309784491,2,6,2.0,8,0.25
309797500,1,8,1.0,9,0.1111111111111111
309808464,1,18,1.0,19,0.05263157894736842
309826156,23,6,6.0,29,0.20689655172413793
309827851,7,3,3.0,10,0.3
309829702,1,9,1.0,10,0.1
309833434,1,9,1.0,10,0.1
309856063,2,8,2.0,10,0.2
309859520,2,8,2.0,10,0.2
309861913,6,21,6.0,27,0.2222222222222222
309870252,3,7,3.0,10,0.3
309888185,9,1,1.0,10,0.1
309888405,5,3,3.0,8,0.375
309908265,4,16,4.0,20,0.2
309910902,3,15,3.0,18,0.16666666666666666
309922409,1,8,1.0,9,0.1111111111111111
309937826,2,8,2.0,10,0.2
309955115,21,8,8.0,29,0.27586206896551724
309955794,4,6,4.0,10,0.4
309956588,7,2,2.0,9,0.2222222222222222
309956744,15,14,14.0,29,0.4827586206896552
309960391,7,21,7.0,28,0.25
309969120,4,5,4.0,9,0.4444444444444444
309977225,1,8,1.0,9,0.1111111111111111
310004366,5,5,5.0,10,0.5
310013493,1,9,1.0,10,0.1
310015228,1,8,1.0,9,0.1111111111111111
310015324,1,8,1.0,9,0.1111111111111111
310018511,5,5,5.0,10,0.5
310027010,3,7,3.0,10,0.3
310027773,18,9,9.0,27,0.3333333333333333
310032987,3,5,3.0,8,0.375
310050639,1,7,1.0,8,0.125
310058307,2,7,2.0,9,0.2222222222222222
310064725,1,8,1.0,9,0.1111111111111111
310075350,7,3,3.0,10,0.3
310077263,17,11,11.0,28,0.39285714285714285
310079714,1,9,1.0,10,0.1
310079899,3,7,3.0,10,0.3
310080368,2,7,2.0,9,0.2222222222222222
310085903,1,9,1.0,10,0.1
310093585,6,4,4.0,10,0.4
310094513,2,8,2.0,10,0.2
310094644,6,4,4.0,10,0.4
310094646,1,8,1.0,9,0.1111111111111111
310094838,2,7,2.0,9,0.2222222222222222
310095023,1,9,1.0,10,0.1
310095528,3,5,3.0,8,0.375
310096009,4,15,4.0,19,0.21052631578947367
310097049,3,7,3.0,10,0.3
310097059,1,9,1.0,10,0.1
310097305,2,7,2.0,9,0.2222222222222222
310101744,1,8,1.0,9,0.1111111111111111
310103287,1,9,1.0,10,0.1
310104592,2,7,2.0,9,0.2222222222222222
310108670,2,8,2.0,10,0.2
310109242,2,17,2.0,19,0.10526315789473684
310109330,2,7,2.0,9,0.2222222222222222
310148977,1,9,1.0,10,0.1
310194747,1,8,1.0,9,0.1111111111111111
310204016,1,9,1.0,10,0.1
310210440,4,6,4.0,10,0.4
310210966,2,8,2.0,10,0.2
310211886,27,2,2.0,29,0.06896551724137931
310212194,6,2,2.0,8,0.25
310233126,6,4,4.0,10,0.4
310289431,22,6,6.0,28,0.21428571428571427
310293705,1,17,1.0,18,0.05555555555555555
310308815,4,6,4.0,10,0.4
310312771,1,7,1.0,8,0.125
310344837,1,8,1.0,9,0.1111111111111111
310364793,1,8,1.0,9,0.1111111111111111
310364999,4,5,4.0,9,0.4444444444444444
310373786,1,9,1.0,10,0.1
310413841,3,6,3.0,9,0.3333333333333333
310427941,1,9,1.0,10,0.1
310436858,1,9,1.0,10,0.1
310442403,1,8,1.0,9,0.1111111111111111
310475823,8,2,2.0,10,0.2
310478093,3,7,3.0,10,0.3
310478597,3,7,3.0,10,0.3
310479018,2,8,2.0,10,0.2
310479271,4,6,4.0,10,0.4
310487378,2,8,2.0,10,0.2
310496044,9,1,1.0,10,0.1
310496881,6,4,4.0,10,0.4
310497299,7,2,2.0,9,0.2222222222222222
310497719,2,8,2.0,10,0.2
310506547,3,5,3.0,8,0.375
310511123,8,2,2.0,10,0.2
310511310,3,7,3.0,10,0.3
310515026,9,1,1.0,10,0.1
310540418,2,18,2.0,20,0.1
310541899,1,9,1.0,10,0.1
310547141,8,1,1.0,9,0.1111111111111111
310548553,1,9,1.0,10,0.1
310565940,3,6,3.0,9,0.3333333333333333
310570078,1,9,1.0,10,0.1
310605069,1,9,1.0,10,0.1
310613037,4,5,4.0,9,0.4444444444444444
310635621,6,4,4.0,10,0.4
310639461,2,7,2.0,9,0.2222222222222222
310664734,1,7,1.0,8,0.125
310718396,6,4,4.0,10,0.4
310718866,5,4,4.0,9,0.4444444444444444
310726862,2,7,2.0,9,0.2222222222222222
310806050,6,3,3.0,9,0.3333333333333333
310829420,8,2,2.0,10,0.2
310854396,4,6,4.0,10,0.4
310858612,1,19,1.0,20,0.05
310860400,2,6,2.0,8,0.25
310894376,1,9,1.0,10,0.1
310901201,7,2,2.0,9,0.2222222222222222
310902700,3,17,3.0,20,0.15
310906162,1,8,1.0,9,0.1111111111111111
310958901,4,6,4.0,10,0.4
310975548,2,8,2.0,10,0.2
310981867,2,7,2.0,9,0.2222222222222222
311013585,7,2,2.0,9,0.2222222222222222
311014438,2,17,2.0,19,0.10526315789473684
311022220,14,14,14.0,28,0.5
311099541,2,7,2.0,9,0.2222222222222222
311104063,5,25,5.0,30,0.16666666666666666
311105391,1,9,1.0,10,0.1
311120185,1,27,1.0,28,0.03571428571428571
311121698,5,5,5.0,10,0.5
311129784,6,3,3.0,9,0.3333333333333333
311137292,3,16,3.0,19,0.15789473684210525
311138253,1,17,1.0,18,0.05555555555555555
311142315,1,8,1.0,9,0.1111111111111111
311157837,3,7,3.0,10,0.3
311179570,7,3,3.0,10,0.3
311181653,1,9,1.0,10,0.1
311182036,1,17,1.0,18,0.05555555555555555
311184071,1,9,1.0,10,0.1
311186351,2,7,2.0,9,0.2222222222222222
311186975,2,8,2.0,10,0.2
311211008,8,2,2.0,10,0.2
311223836,2,15,2.0,17,0.11764705882352941
311258411,10,9,9.0,19,0.47368421052631576
311275986,1,9,1.0,10,0.1
311276560,3,6,3.0,9,0.3333333333333333
311286759,1,9,1.0,10,0.1
311287397,1,7,1.0,8,0.125
311289423,2,8,2.0,10,0.2
311308743,1,18,1.0,19,0.05263157894736842
311347325,2,18,2.0,20,0.1
311358164,1,17,1.0,18,0.05555555555555555
311365589,1,18,1.0,19,0.05263157894736842
311397310,2,8,2.0,10,0.2
311414186,4,6,4.0,10,0.4
311418872,2,8,2.0,10,0.2
311419163,2,8,2.0,10,0.2
311419281,5,23,5.0,28,0.17857142857142858
311419539,3,6,3.0,9,0.3333333333333333
311421644,3,7,3.0,10,0.3
311422706,8,10,8.0,18,0.4444444444444444
311498533,9,10,9.0,19,0.47368421052631576
311510925,1,8,1.0,9,0.1111111111111111
311511212,6,3,3.0,9,0.3333333333333333
311514086,1,28,1.0,29,0.034482758620689655
311517619,3,6,3.0,9,0.3333333333333333
311523307,1,18,1.0,19,0.05263157894736842
311539827,2,6,2.0,8,0.25
311557329,2,7,2.0,9,0.2222222222222222
311566931,9,20,9.0,29,0.3103448275862069
311580199,1,8,1.0,9,0.1111111111111111
311591669,5,5,5.0,10,0.5
311606677,3,7,3.0,10,0.3
311639699,1,19,1.0,20,0.05
311652546,2,17,2.0,19,0.10526315789473684
311673656,1,19,1.0,20,0.05
311696278,5,5,5.0,10,0.5
311697161,3,7,3.0,10,0.3
311701096,1,9,1.0,10,0.1
311705653,6,4,4.0,10,0.4
311707814,1,9,1.0,10,0.1
311714125,2,8,2.0,10,0.2
311720059,2,7,2.0,9,0.2222222222222222
311733008,1,8,1.0,9,0.1111111111111111
311733357,1,7,1.0,8,0.125
311752772,3,7,3.0,10,0.3
311758365,1,18,1.0,19,0.05263157894736842
311761008,4,6,4.0,10,0.4
311773398,1,9,1.0,10,0.1
311774722,1,8,1.0,9,0.1111111111111111
311801203,1,19,1.0,20,0.05
311851182,1,19,1.0,20,0.05
311871507,1,17,1.0,18,0.05555555555555555
311892410,3,16,3.0,19,0.15789473684210525
311900773,1,9,1.0,10,0.1
311905673,5,5,5.0,10,0.5
311910997,3,7,3.0,10,0.3
311916334,2,18,2.0,20,0.1
311935540,3,14,3.0,17,0.17647058823529413
311938304,28,1,1.0,29,0.034482758620689655
311958113,2,8,2.0,10,0.2
311972491,2,7,2.0,9,0.2222222222222222
311982921,7,13,7.0,20,0.35
311993827,4,6,4.0,10,0.4
311999230,1,8,1.0,9,0.1111111111111111
311999350,13,15,13.0,28,0.4642857142857143
312000217,6,4,4.0,10,0.4
312000747,7,2,2.0,9,0.2222222222222222
312011204,7,3,3.0,10,0.3
312014373,7,20,7.0,27,0.25925925925925924
312014716,2,8,2.0,10,0.2
312015043,4,6,4.0,10,0.4
312015638,2,8,2.0,10,0.2
312016119,1,9,1.0,10,0.1
312025048,2,8,2.0,10,0.2
312028939,8,2,2.0,10,0.2
312029796,8,2,2.0,10,0.2
312047192,6,3,3.0,9,0.3333333333333333
312047792,2,15,2.0,17,0.11764705882352941
312052659,4,6,4.0,10,0.4
312058653,2,8,2.0,10,0.2
312059467,2,8,2.0,10,0.2
312059608,3,6,3.0,9,0.3333333333333333
312059830,6,4,4.0,10,0.4
312060035,2,7,2.0,9,0.2222222222222222
312068046,2,8,2.0,10,0.2
312070573,1,8,1.0,9,0.1111111111111111
312073307,2,8,2.0,10,0.2
312073613,1,9,1.0,10,0.1
312076898,1,8,1.0,9,0.1111111111111111
312076986,1,25,1.0,26,0.038461538461538464
312078802,3,7,3.0,10,0.3
312080007,1,7,1.0,8,0.125
312080813,2,7,2.0,9,0.2222222222222222
312084299,1,8,1.0,9,0.1111111111111111
312088190,2,8,2.0,10,0.2
312098297,7,3,3.0,10,0.3
312100417,2,7,2.0,9,0.2222222222222222
312117308,6,4,4.0,10,0.4
312118037,9,1,1.0,10,0.1
312118366,8,1,1.0,9,0.1111111111111111
312118714,1,8,1.0,9,0.1111111111111111
312138421,2,8,2.0,10,0.2
312140487,4,6,4.0,10,0.4
312140765,1,7,1.0,8,0.125
312141243,3,7,3.0,10,0.3
312141278,1,7,1.0,8,0.125
312142476,5,4,4.0,9,0.4444444444444444
312146449,2,8,2.0,10,0.2
312146740,1,9,1.0,10,0.1
312168787,29,1,1.0,30,0.03333333333333333
312182972,3,7,3.0,10,0.3
312183641,3,7,3.0,10,0.3
312184414,2,7,2.0,9,0.2222222222222222
312184520,3,7,3.0,10,0.3
312186848,1,9,1.0,10,0.1
312192747,4,6,4.0,10,0.4
312199226,2,7,2.0,9,0.2222222222222222
312203530,8,2,2.0,10,0.2
312208502,1,18,1.0,19,0.05263157894736842
312220665,1,9,1.0,10,0.1
312231022,1,9,1.0,10,0.1
312267358,1,9,1.0,10,0.1
312267486,3,25,3.0,28,0.10714285714285714
312268781,1,8,1.0,9,0.1111111111111111
312273165,1,29,1.0,30,0.03333333333333333
312277263,2,6,2.0,8,0.25
312299667,4,5,4.0,9,0.4444444444444444
312304060,1,8,1.0,9,0.1111111111111111
312304367,6,4,4.0,10,0.4
312318146,1,9,1.0,10,0.1
312324995,1,9,1.0,10,0.1
312366740,5,23,5.0,28,0.17857142857142858
312367201,9,21,9.0,30,0.3
312368083,3,6,3.0,9,0.3333333333333333
312368944,2,8,2.0,10,0.2
312369319,1,9,1.0,10,0.1
312402675,1,16,1.0,17,0.058823529411764705
312403619,1,9,1.0,10,0.1
312420822,1,9,1.0,10,0.1
312424558,2,7,2.0,9,0.2222222222222222
312425602,3,5,3.0,8,0.375
312445362,2,6,2.0,8,0.25
312453633,4,5,4.0,9,0.4444444444444444
312456915,2,14,2.0,16,0.125
312472530,7,3,3.0,10,0.3
312476795,2,17,2.0,19,0.10526315789473684
312477592,1,9,1.0,10,0.1
312477769,3,7,3.0,10,0.3
312478240,5,3,3.0,8,0.375
312480034,2,8,2.0,10,0.2
312481556,8,1,1.0,9,0.1111111111111111
312487222,2,8,2.0,10,0.2
312487501,16,12,12.0,28,0.42857142857142855
312492906,1,8,1.0,9,0.1111111111111111
312498667,4,5,4.0,9,0.4444444444444444
312512438,1,9,1.0,10,0.1
312517329,3,6,3.0,9,0.3333333333333333
312529102,1,9,1.0,10,0.1
312529417,1,9,1.0,10,0.1
312530813,1,8,1.0,9,0.1111111111111111
312535990,1,9,1.0,10,0.1
312540846,3,17,3.0,20,0.15
312554891,9,1,1.0,10,0.1
312562825,3,7,3.0,10,0.3
312585414,4,5,4.0,9,0.4444444444444444
312590243,4,24,4.0,28,0.14285714285714285
312597144,3,6,3.0,9,0.3333333333333333
312597164,7,2,2.0,9,0.2222222222222222
312607832,4,14,4.0,18,0.2222222222222222
312627352,1,9,1.0,10,0.1
312635304,1,7,1.0,8,0.125
312699498,1,8,1.0,9,0.1111111111111111
312720924,1,17,1.0,18,0.05555555555555555
312741794,1,8,1.0,9,0.1111111111111111
312755850,1,18,1.0,19,0.05263157894736842
312759609,1,18,1.0,19,0.05263157894736842
312770384,1,17,1.0,18,0.05555555555555555
312823788,1,8,1.0,9,0.1111111111111111
312843300,1,9,1.0,10,0.1
312850274,28,1,1.0,29,0.034482758620689655
312888276,7,2,2.0,9,0.2222222222222222
312891338,3,7,3.0,10,0.3
312902618,1,18,1.0,19,0.05263157894736842
312960906,12,8,8.0,20,0.4
312986123,7,13,7.0,20,0.35
313000333,3,14,3.0,17,0.17647058823529413
313097294,5,4,4.0,9,0.4444444444444444
313100778,7,2,2.0,9,0.2222222222222222
313101641,2,8,2.0,10,0.2
313109261,8,2,2.0,10,0.2
313109607,19,1,1.0,20,0.05
313116027,5,5,5.0,10,0.5
313116792,24,5,5.0,29,0.1724137931034483
313117733,1,9,1.0,10,0.1
313118101,2,8,2.0,10,0.2
313119565,7,3,3.0,10,0.3
313131077,1,9,1.0,10,0.1
313133841,1,9,1.0,10,0.1
313134349,5,4,4.0,9,0.4444444444444444
313134947,2,8,2.0,10,0.2
313137552,4,24,4.0,28,0.14285714285714285
313138797,8,2,2.0,10,0.2
313194087,1,19,1.0,20,0.05
313197250,1,8,1.0,9,0.1111111111111111
313202794,1,7,1.0,8,0.125
313253899,3,7,3.0,10,0.3
313360182,2,7,2.0,9,0.2222222222222222
313362533,3,5,3.0,8,0.375
313394946,2,8,2.0,10,0.2
313399158,2,16,2.0,18,0.1111111111111111
313399399,2,7,2.0,9,0.2222222222222222
313404319,6,2,2.0,8,0.25
313425926,1,7,1.0,8,0.125
313437564,1,9,1.0,10,0.1
313511700,3,6,3.0,9,0.3333333333333333
313522938,2,7,2.0,9,0.2222222222222222
313530663,6,22,6.0,28,0.21428571428571427
313533543,2,7,2.0,9,0.2222222222222222
313534791,2,8,2.0,10,0.2
313539395,1,16,1.0,17,0.058823529411764705
313592517,1,9,1.0,10,0.1
313596094,8,2,2.0,10,0.2
313597022,1,8,1.0,9,0.1111111111111111
313602054,5,5,5.0,10,0.5
313617837,3,5,3.0,8,0.375
313618092,1,18,1.0,19,0.05263157894736842
313620466,4,5,4.0,9,0.4444444444444444
313620777,8,2,2.0,10,0.2
313621072,3,7,3.0,10,0.3
313636360,1,16,1.0,17,0.058823529411764705
313660260,7,21,7.0,28,0.25
313663227,6,3,3.0,9,0.3333333333333333
313686182,2,8,2.0,10,0.2
313686514,2,8,2.0,10,0.2
313691363,6,4,4.0,10,0.4
313699593,2,8,2.0,10,0.2
313711772,26,1,1.0,27,0.037037037037037035
313722557,1,9,1.0,10,0.1
313728122,1,9,1.0,10,0.1
313835540,2,7,2.0,9,0.2222222222222222
313946694,8,22,8.0,30,0.26666666666666666
313955728,10,18,10.0,28,0.35714285714285715
313957775,7,2,2.0,9,0.2222222222222222
313958211,9,19,9.0,28,0.32142857142857145
313962310,1,9,1.0,10,0.1
313963890,7,3,3.0,10,0.3
313967853,1,29,1.0,30,0.03333333333333333
313970083,3,27,3.0,30,0.1
313976120,1,18,1.0,19,0.05263157894736842
314006960,5,4,4.0,9,0.4444444444444444
314016417,7,3,3.0,10,0.3
314020217,1,9,1.0,10,0.1
314026641,7,3,3.0,10,0.3
314042419,3,7,3.0,10,0.3
314051941,3,7,3.0,10,0.3
314057426,1,19,1.0,20,0.05
314075825,1,17,1.0,18,0.05555555555555555
314083315,6,4,4.0,10,0.4
314099855,1,9,1.0,10,0.1
314100611,28,1,1.0,29,0.034482758620689655
314102762,3,5,3.0,8,0.375
314111345,3,5,3.0,8,0.375
314111816,4,6,4.0,10,0.4
314130230,3,16,3.0,19,0.15789473684210525
314169721,4,5,4.0,9,0.4444444444444444
314172260,3,15,3.0,18,0.16666666666666666
314177129,2,8,2.0,10,0.2
314183150,2,7,2.0,9,0.2222222222222222
314211697,9,19,9.0,28,0.32142857142857145
314214739,7,3,3.0,10,0.3
314215664,4,6,4.0,10,0.4
314216972,3,6,3.0,9,0.3333333333333333
314222915,1,9,1.0,10,0.1
314223022,1,8,1.0,9,0.1111111111111111
314264168,2,8,2.0,10,0.2
314265864,1,8,1.0,9,0.1111111111111111
314284515,3,14,3.0,17,0.17647058823529413
314380638,7,2,2.0,9,0.2222222222222222
314380809,5,5,5.0,10,0.5
314380967,3,6,3.0,9,0.3333333333333333
314381259,14,14,14.0,28,0.5
314381749,5,4,4.0,9,0.4444444444444444
314420527,4,6,4.0,10,0.4
314438850,1,9,1.0,10,0.1
314450393,7,1,1.0,8,0.125
314462422,8,2,2.0,10,0.2
314470854,8,2,2.0,10,0.2
314475467,2,8,2.0,10,0.2
314476343,1,9,1.0,10,0.1
314479547,1,9,1.0,10,0.1
314486086,1,8,1.0,9,0.1111111111111111
314528086,1,9,1.0,10,0.1
314560754,1,9,1.0,10,0.1
314567296,1,19,1.0,20,0.05
314577064,7,3,3.0,10,0.3
314611576,9,1,1.0,10,0.1
314611937,12,17,12.0,29,0.41379310344827586
314612097,9,1,1.0,10,0.1
314621377,1,8,1.0,9,0.1111111111111111
314644794,3,7,3.0,10,0.3
314688520,6,24,6.0,30,0.2
314710602,1,9,1.0,10,0.1
314720430,1,17,1.0,18,0.05555555555555555
314733342,1,8,1.0,9,0.1111111111111111
314740270,2,8,2.0,10,0.2
314763866,7,3,3.0,10,0.3
314772031,6,4,4.0,10,0.4
314776264,1,9,1.0,10,0.1
314804268,2,8,2.0,10,0.2
314814790,1,9,1.0,10,0.1
314823439,9,1,1.0,10,0.1
314824559,3,7,3.0,10,0.3
314825991,6,4,4.0,10,0.4
314827106,5,5,5.0,10,0.5
314850618,3,14,3.0,17,0.17647058823529413
314897614,5,5,5.0,10,0.5
314898291,27,2,2.0,29,0.06896551724137931
314915891,1,9,1.0,10,0.1
314921429,5,4,4.0,9,0.4444444444444444
314935835,3,7,3.0,10,0.3
314936205,2,7,2.0,9,0.2222222222222222
314937231,6,3,3.0,9,0.3333333333333333
314944708,1,28,1.0,29,0.034482758620689655
314946062,7,3,3.0,10,0.3
314946145,1,8,1.0,9,0.1111111111111111
314947006,2,8,2.0,10,0.2
314947117,5,4,4.0,9,0.4444444444444444
314949549,6,4,4.0,10,0.4
314959082,8,2,2.0,10,0.2
314965734,3,7,3.0,10,0.3
314980428,1,8,1.0,9,0.1111111111111111
314980542,1,9,1.0,10,0.1
314981965,8,1,1.0,9,0.1111111111111111
314983703,7,3,3.0,10,0.3
314984009,9,1,1.0,10,0.1
314984287,8,1,1.0,9,0.1111111111111111
314986934,3,6,3.0,9,0.3333333333333333
315029051,6,4,4.0,10,0.4
315031203,9,1,1.0,10,0.1
315044720,3,7,3.0,10,0.3
315046091,1,19,1.0,20,0.05
315052864,2,8,2.0,10,0.2
315053248,1,9,1.0,10,0.1
315054917,3,7,3.0,10,0.3
315055731,1,8,1.0,9,0.1111111111111111
315056213,2,8,2.0,10,0.2
315056668,9,1,1.0,10,0.1
315058142,5,5,5.0,10,0.5
315087156,1,9,1.0,10,0.1
315145516,1,9,1.0,10,0.1
315149206,2,8,2.0,10,0.2
315157591,2,8,2.0,10,0.2
315199003,1,18,1.0,19,0.05263157894736842
315199221,3,7,3.0,10,0.3
315200830,1,9,1.0,10,0.1
315201672,2,8,2.0,10,0.2
315202655,1,9,1.0,10,0.1
315206387,11,17,11.0,28,0.39285714285714285
315215126,1,9,1.0,10,0.1
315228862,1,8,1.0,9,0.1111111111111111
315240397,4,25,4.0,29,0.13793103448275862
315241309,1,8,1.0,9,0.1111111111111111
315253541,1,8,1.0,9,0.1111111111111111
315267215,1,8,1.0,9,0.1111111111111111
315267255,1,8,1.0,9,0.1111111111111111
315289770,2,7,2.0,9,0.2222222222222222
315290324,1,9,1.0,10,0.1
315290895,8,2,2.0,10,0.2
315290990,2,8,2.0,10,0.2
315295551,2,7,2.0,9,0.2222222222222222
315338682,1,9,1.0,10,0.1
315339301,4,6,4.0,10,0.4
315350159,8,12,8.0,20,0.4
315366692,14,13,13.0,27,0.48148148148148145
315393214,1,8,1.0,9,0.1111111111111111
315417309,9,1,1.0,10,0.1
315423487,5,5,5.0,10,0.5
315443118,5,22,5.0,27,0.18518518518518517
315451221,6,2,2.0,8,0.25
315458971,3,7,3.0,10,0.3
315468458,1,9,1.0,10,0.1
315495314,1,8,1.0,9,0.1111111111111111
315559245,2,17,2.0,19,0.10526315789473684
315562501,1,9,1.0,10,0.1
315585893,1,8,1.0,9,0.1111111111111111
315592042,7,3,3.0,10,0.3
315593101,5,4,4.0,9,0.4444444444444444
315613416,2,16,2.0,18,0.1111111111111111
315625007,1,8,1.0,9,0.1111111111111111
315629475,6,4,4.0,10,0.4
315643212,1,19,1.0,20,0.05
315676187,5,5,5.0,10,0.5
315677694,3,6,3.0,9,0.3333333333333333
315695882,2,7,2.0,9,0.2222222222222222
315725484,1,18,1.0,19,0.05263157894736842
315738898,2,7,2.0,9,0.2222222222222222
315740187,5,15,5.0,20,0.25
315745880,1,9,1.0,10,0.1
315746099,1,7,1.0,8,0.125
315752694,5,22,5.0,27,0.18518518518518517
315804160,2,8,2.0,10,0.2
315811803,2,8,2.0,10,0.2
315811965,1,9,1.0,10,0.1
315812627,4,5,4.0,9,0.4444444444444444
315825712,1,7,1.0,8,0.125
315841272,7,12,7.0,19,0.3684210526315789
315848601,4,6,4.0,10,0.4
315848853,1,8,1.0,9,0.1111111111111111
315872696,1,9,1.0,10,0.1
315892998,1,18,1.0,19,0.05263157894736842
315913896,5,4,4.0,9,0.4444444444444444
315916788,4,6,4.0,10,0.4
315930608,8,1,1.0,9,0.1111111111111111
315932984,5,15,5.0,20,0.25
315935294,4,6,4.0,10,0.4
315966450,4,6,4.0,10,0.4
315969421,1,8,1.0,9,0.1111111111111111
315972608,3,14,3.0,17,0.17647058823529413
315977379,12,16,12.0,28,0.42857142857142855
315978849,7,3,3.0,10,0.3
315979256,5,5,5.0,10,0.5
315999281,4,13,4.0,17,0.23529411764705882
316016397,16,4,4.0,20,0.2
316017625,9,1,1.0,10,0.1
316021016,1,9,1.0,10,0.1
316039194,9,1,1.0,10,0.1
316041108,7,1,1.0,8,0.125
316043202,1,9,1.0,10,0.1
316051009,1,8,1.0,9,0.1111111111111111
316052163,6,4,4.0,10,0.4
316054703,1,9,1.0,10,0.1
316055708,7,2,2.0,9,0.2222222222222222
316059368,11,18,11.0,29,0.3793103448275862
316061383,1,9,1.0,10,0.1
316069301,8,2,2.0,10,0.2
316122167,1,19,1.0,20,0.05
316136385,3,7,3.0,10,0.3
316136818,4,6,4.0,10,0.4
316143494,2,17,2.0,19,0.10526315789473684
316196049,2,8,2.0,10,0.2
316215725,7,22,7.0,29,0.2413793103448276
316219315,1,7,1.0,8,0.125
316245817,5,4,4.0,9,0.4444444444444444
316246499,1,9,1.0,10,0.1
316274419,8,2,2.0,10,0.2
316295203,8,1,1.0,9,0.1111111111111111
316295654,9,1,1.0,10,0.1
316300400,7,3,3.0,10,0.3
316378453,1,9,1.0,10,0.1
316468719,2,6,2.0,8,0.25
316500351,1,9,1.0,10,0.1
316534291,2,17,2.0,19,0.10526315789473684
316537227,6,14,6.0,20,0.3
316611868,5,5,5.0,10,0.5
316612432,2,7,2.0,9,0.2222222222222222
316614249,6,4,4.0,10,0.4
316614721,9,1,1.0,10,0.1
316624703,3,7,3.0,10,0.3
316626629,3,6,3.0,9,0.3333333333333333
316627234,1,9,1.0,10,0.1
316681188,1,18,1.0,19,0.05263157894736842
316737003,2,8,2.0,10,0.2
316749462,1,8,1.0,9,0.1111111111111111
316751756,1,9,1.0,10,0.1
316786604,1,9,1.0,10,0.1
316812104,1,9,1.0,10,0.1
316817074,1,9,1.0,10,0.1
316889370,1,17,1.0,18,0.05555555555555555
316892417,6,4,4.0,10,0.4
316909571,1,7,1.0,8,0.125
316913946,1,7,1.0,8,0.125
316939901,8,9,8.0,17,0.47058823529411764
316941265,8,2,2.0,10,0.2
316945201,2,8,2.0,10,0.2
316951159,2,8,2.0,10,0.2
316965256,1,7,1.0,8,0.125
317051415,3,7,3.0,10,0.3
317058751,1,9,1.0,10,0.1
317062317,1,19,1.0,20,0.05
317071780,1,9,1.0,10,0.1
317116469,1,9,1.0,10,0.1
317120061,2,8,2.0,10,0.2
317133485,1,19,1.0,20,0.05
317136690,2,8,2.0,10,0.2
317181481,1,8,1.0,9,0.1111111111111111
317182781,1,29,1.0,30,0.03333333333333333
317185372,2,8,2.0,10,0.2
317185988,2,8,2.0,10,0.2
317193100,1,8,1.0,9,0.1111111111111111
317195411,2,8,2.0,10,0.2
317204397,1,9,1.0,10,0.1
317211538,1,19,1.0,20,0.05
317211869,3,6,3.0,9,0.3333333333333333
317224729,1,8,1.0,9,0.1111111111111111
317232057,1,9,1.0,10,0.1
317244124,1,8,1.0,9,0.1111111111111111
317245857,18,10,10.0,28,0.35714285714285715
317250447,1,19,1.0,20,0.05
317278194,1,8,1.0,9,0.1111111111111111
317295833,1,9,1.0,10,0.1
317316568,1,7,1.0,8,0.125
317319866,1,9,1.0,10,0.1
317322657,2,8,2.0,10,0.2
317323103,2,6,2.0,8,0.25
317323410,6,4,4.0,10,0.4
317323671,2,7,2.0,9,0.2222222222222222
317328307,1,9,1.0,10,0.1
317359519,24,5,5.0,29,0.1724137931034483
317383362,1,17,1.0,18,0.05555555555555555
317387155,2,7,2.0,9,0.2222222222222222
317387656,2,8,2.0,10,0.2
317389366,4,12,4.0,16,0.25
317415865,1,9,1.0,10,0.1
317435199,2,7,2.0,9,0.2222222222222222
317440242,1,7,1.0,8,0.125
317440385,1,9,1.0,10,0.1
317440417,2,8,2.0,10,0.2
317440474,1,9,1.0,10,0.1
317467108,1,8,1.0,9,0.1111111111111111
317474783,2,8,2.0,10,0.2
317500041,4,15,4.0,19,0.21052631578947367
317505446,1,9,1.0,10,0.1
317541039,2,18,2.0,20,0.1
317545935,6,2,2.0,8,0.25
317557477,7,2,2.0,9,0.2222222222222222
317572325,8,2,2.0,10,0.2
317572425,6,3,3.0,9,0.3333333333333333
317577697,2,8,2.0,10,0.2
317584285,1,17,1.0,18,0.05555555555555555
317587033,4,5,4.0,9,0.4444444444444444
317609063,1,9,1.0,10,0.1
317618531,2,7,2.0,9,0.2222222222222222
317639327,5,5,5.0,10,0.5
317668038,2,7,2.0,9,0.2222222222222222
317670563,2,8,2.0,10,0.2
317684867,8,2,2.0,10,0.2
317704776,26,1,1.0,27,0.037037037037037035
317714238,1,9,1.0,10,0.1
317748892,2,8,2.0,10,0.2
317749127,2,7,2.0,9,0.2222222222222222
317754070,1,9,1.0,10,0.1
317765486,3,7,3.0,10,0.3
317773054,19,8,8.0,27,0.2962962962962963
317774155,3,7,3.0,10,0.3
317803596,1,8,1.0,9,0.1111111111111111
317841226,8,2,2.0,10,0.2
317898879,4,6,4.0,10,0.4
317928100,8,2,2.0,10,0.2
317950728,6,4,4.0,10,0.4
317963711,4,6,4.0,10,0.4
317968461,2,7,2.0,9,0.2222222222222222
317985959,8,1,1.0,9,0.1111111111111111
317986561,1,8,1.0,9,0.1111111111111111
317990501,9,1,1.0,10,0.1
318001235,1,19,1.0,20,0.05
318006894,7,3,3.0,10,0.3
318007887,7,3,3.0,10,0.3
318008638,8,2,2.0,10,0.2
318009930,3,6,3.0,9,0.3333333333333333
318013541,1,9,1.0,10,0.1
318046927,1,9,1.0,10,0.1
318046997,1,9,1.0,10,0.1
318049516,1,9,1.0,10,0.1
318076498,1,8,1.0,9,0.1111111111111111
318087571,1,19,1.0,20,0.05
318088521,8,2,2.0,10,0.2
318114580,2,8,2.0,10,0.2
318121322,5,5,5.0,10,0.5
318124445,2,8,2.0,10,0.2
318128567,6,4,4.0,10,0.4
318151021,9,18,9.0,27,0.3333333333333333
318151616,7,3,3.0,10,0.3
318183617,7,3,3.0,10,0.3
318187153,2,26,2.0,28,0.07142857142857142
318196867,1,8,1.0,9,0.1111111111111111
318200093,1,9,1.0,10,0.1
318209373,4,16,4.0,20,0.2
318235972,1,9,1.0,10,0.1
318240184,1,18,1.0,19,0.05263157894736842
318241745,3,16,3.0,19,0.15789473684210525
318249282,1,8,1.0,9,0.1111111111111111
318276398,5,15,5.0,20,0.25
318282032,2,26,2.0,28,0.07142857142857142
318286429,2,8,2.0,10,0.2
318294482,1,8,1.0,9,0.1111111111111111
318322087,6,24,6.0,30,0.2
318334371,8,1,1.0,9,0.1111111111111111
318334597,16,4,4.0,20,0.2
318335949,2,8,2.0,10,0.2
318342631,3,5,3.0,8,0.375
318350434,1,8,1.0,9,0.1111111111111111
318360488,3,7,3.0,10,0.3
318366363,5,3,3.0,8,0.375
318384862,4,16,4.0,20,0.2
318425598,1,8,1.0,9,0.1111111111111111
318435788,1,9,1.0,10,0.1
318436277,1,9,1.0,10,0.1
318499326,1,9,1.0,10,0.1
318525154,1,8,1.0,9,0.1111111111111111
318526691,6,4,4.0,10,0.4
318532317,6,4,4.0,10,0.4
318532857,3,6,3.0,9,0.3333333333333333
318533205,2,24,2.0,26,0.07692307692307693
318534984,3,7,3.0,10,0.3
318544073,8,20,8.0,28,0.2857142857142857
318546606,1,9,1.0,10,0.1
318552412,3,6,3.0,9,0.3333333333333333
318557993,1,8,1.0,9,0.1111111111111111
318560500,4,25,4.0,29,0.13793103448275862
318564872,1,27,1.0,28,0.03571428571428571
318581864,1,8,1.0,9,0.1111111111111111
318586981,3,5,3.0,8,0.375
318612383,5,5,5.0,10,0.5
318613121,7,2,2.0,9,0.2222222222222222
318614400,2,8,2.0,10,0.2
318628709,4,5,4.0,9,0.4444444444444444
318646956,7,2,2.0,9,0.2222222222222222
318676085,3,6,3.0,9,0.3333333333333333
318685694,1,16,1.0,17,0.058823529411764705
318743462,4,15,4.0,19,0.21052631578947367
318745273,1,9,1.0,10,0.1
318812046,8,1,1.0,9,0.1111111111111111
318812477,3,6,3.0,9,0.3333333333333333
318815315,4,6,4.0,10,0.4
318815808,2,8,2.0,10,0.2
318816808,3,7,3.0,10,0.3
318817544,6,4,4.0,10,0.4
318818143,2,8,2.0,10,0.2
318820936,2,8,2.0,10,0.2
318822079,3,7,3.0,10,0.3
318823192,2,8,2.0,10,0.2
318824104,1,9,1.0,10,0.1
318832444,3,6,3.0,9,0.3333333333333333
318835829,1,8,1.0,9,0.1111111111111111
318841577,2,7,2.0,9,0.2222222222222222
318845750,1,19,1.0,20,0.05
318871352,2,7,2.0,9,0.2222222222222222
318872432,3,7,3.0,10,0.3
318874962,8,2,2.0,10,0.2
318901660,4,6,4.0,10,0.4
318903450,2,8,2.0,10,0.2
318906000,1,8,1.0,9,0.1111111111111111
318934274,2,7,2.0,9,0.2222222222222222
319037031,2,7,2.0,9,0.2222222222222222
319038737,2,8,2.0,10,0.2
319049634,3,5,3.0,8,0.375
319068606,3,7,3.0,10,0.3
319069233,1,9,1.0,10,0.1
319090733,1,9,1.0,10,0.1
319091021,8,2,2.0,10,0.2
319103351,7,2,2.0,9,0.2222222222222222
319104031,7,3,3.0,10,0.3
319127191,2,8,2.0,10,0.2
319130593,9,1,1.0,10,0.1
319133598,4,5,4.0,9,0.4444444444444444
319138180,8,1,1.0,9,0.1111111111111111
319145263,1,28,1.0,29,0.034482758620689655
319146594,1,7,1.0,8,0.125
319173876,6,4,4.0,10,0.4
319174752,5,5,5.0,10,0.5
319175149,8,2,2.0,10,0.2
319207003,9,1,1.0,10,0.1
319207399,3,6,3.0,9,0.3333333333333333
319207416,5,3,3.0,8,0.375
319207472,1,9,1.0,10,0.1
319207682,4,6,4.0,10,0.4
319207761,1,9,1.0,10,0.1
319212392,17,2,2.0,19,0.10526315789473684
319235747,2,8,2.0,10,0.2
319241522,3,7,3.0,10,0.3
319249010,5,5,5.0,10,0.5
319249173,6,2,2.0,8,0.25
319250314,2,7,2.0,9,0.2222222222222222
319251022,8,2,2.0,10,0.2
319259641,3,17,3.0,20,0.15
319305337,3,7,3.0,10,0.3
319305748,2,8,2.0,10,0.2
319311615,1,9,1.0,10,0.1
319315608,4,6,4.0,10,0.4
319332578,3,7,3.0,10,0.3
319340933,1,9,1.0,10,0.1
319341285,5,5,5.0,10,0.5
319370311,1,8,1.0,9,0.1111111111111111
319373794,8,1,1.0,9,0.1111111111111111
319377132,5,13,5.0,18,0.2777777777777778
319377162,5,5,5.0,10,0.5
319418835,5,23,5.0,28,0.17857142857142858
319419119,1,8,1.0,9,0.1111111111111111
319419375,1,9,1.0,10,0.1
319420750,1,9,1.0,10,0.1
319432650,1,9,1.0,10,0.1
319441360,3,7,3.0,10,0.3
319450121,1,7,1.0,8,0.125
319464057,1,8,1.0,9,0.1111111111111111
319465982,1,9,1.0,10,0.1
319501276,4,14,4.0,18,0.2222222222222222
319521936,3,7,3.0,10,0.3
319522495,10,8,8.0,18,0.4444444444444444
319523722,2,8,2.0,10,0.2
319550087,1,7,1.0,8,0.125
319555087,1,8,1.0,9,0.1111111111111111
319555516,1,9,1.0,10,0.1
319572733,1,8,1.0,9,0.1111111111111111
319583303,9,1,1.0,10,0.1
319599478,1,8,1.0,9,0.1111111111111111
319605258,16,11,11.0,27,0.4074074074074074
319627778,1,9,1.0,10,0.1
319708418,5,4,4.0,9,0.4444444444444444
319710792,3,6,3.0,9,0.3333333333333333
319711216,1,7,1.0,8,0.125
319711620,3,7,3.0,10,0.3
319729178,3,5,3.0,8,0.375
319737285,3,14,3.0,17,0.17647058823529413
319743210,1,8,1.0,9,0.1111111111111111
319784361,1,17,1.0,18,0.05555555555555555
319793581,5,4,4.0,9,0.4444444444444444
319826808,1,9,1.0,10,0.1
319842554,1,9,1.0,10,0.1
319843080,7,3,3.0,10,0.3
319894035,1,9,1.0,10,0.1
319905318,1,8,1.0,9,0.1111111111111111
319923223,3,16,3.0,19,0.15789473684210525
319942145,5,4,4.0,9,0.4444444444444444
319970256,2,7,2.0,9,0.2222222222222222
319984306,2,8,2.0,10,0.2
319984413,3,5,3.0,8,0.375
319984544,8,22,8.0,30,0.26666666666666666
319984605,1,8,1.0,9,0.1111111111111111
319984668,3,7,3.0,10,0.3
319988224,1,8,1.0,9,0.1111111111111111
320007030,1,9,1.0,10,0.1
320007782,1,8,1.0,9,0.1111111111111111
320061880,1,9,1.0,10,0.1
320081423,1,8,1.0,9,0.1111111111111111
320118121,4,5,4.0,9,0.4444444444444444
320119043,3,7,3.0,10,0.3
320119205,2,7,2.0,9,0.2222222222222222
320119500,23,6,6.0,29,0.20689655172413793
320126067,8,2,2.0,10,0.2
320142677,9,1,1.0,10,0.1
320142709,4,4,4.0,8,0.5
320142916,2,7,2.0,9,0.2222222222222222
320143880,8,2,2.0,10,0.2
320172620,2,8,2.0,10,0.2
320208956,2,6,2.0,8,0.25
320213280,1,9,1.0,10,0.1
320285630,9,1,1.0,10,0.1
320311686,1,8,1.0,9,0.1111111111111111
320326243,5,4,4.0,9,0.4444444444444444
320330396,5,5,5.0,10,0.5
320355284,6,3,3.0,9,0.3333333333333333
320362750,15,12,12.0,27,0.4444444444444444
320374048,4,5,4.0,9,0.4444444444444444
320374314,1,8,1.0,9,0.1111111111111111
320374586,3,5,3.0,8,0.375
320378574,4,5,4.0,9,0.4444444444444444
320380190,2,8,2.0,10,0.2
320390588,9,1,1.0,10,0.1
320391359,3,7,3.0,10,0.3
320392908,17,12,12.0,29,0.41379310344827586
320396990,1,9,1.0,10,0.1
320411493,8,1,1.0,9,0.1111111111111111
320449940,2,7,2.0,9,0.2222222222222222
320484119,2,7,2.0,9,0.2222222222222222
320521990,9,1,1.0,10,0.1
320628698,7,12,7.0,19,0.3684210526315789
320689555,3,6,3.0,9,0.3333333333333333
320701134,25,1,1.0,26,0.038461538461538464
320701853,6,4,4.0,10,0.4
320735806,1,9,1.0,10,0.1
320783757,3,17,3.0,20,0.15
320790248,3,7,3.0,10,0.3
320792080,1,18,1.0,19,0.05263157894736842
320812798,1,9,1.0,10,0.1
320817482,3,7,3.0,10,0.3
320865596,3,16,3.0,19,0.15789473684210525
320892785,3,7,3.0,10,0.3
320899897,1,9,1.0,10,0.1
320904112,1,9,1.0,10,0.1
320904895,1,9,1.0,10,0.1
320913947,5,5,5.0,10,0.5
320924397,4,5,4.0,9,0.4444444444444444
320925022,6,23,6.0,29,0.20689655172413793
320925202,1,7,1.0,8,0.125
320931123,2,6,2.0,8,0.25
320932591,4,13,4.0,17,0.23529411764705882
320991923,1,9,1.0,10,0.1
320999643,8,2,2.0,10,0.2
321002885,2,7,2.0,9,0.2222222222222222
321003587,2,7,2.0,9,0.2222222222222222
321006725,2,7,2.0,9,0.2222222222222222
321007295,1,9,1.0,10,0.1
321007849,1,15,1.0,16,0.0625
321014221,1,19,1.0,20,0.05
321016812,2,7,2.0,9,0.2222222222222222
321039483,1,8,1.0,9,0.1111111111111111
321040566,4,5,4.0,9,0.4444444444444444
321077980,1,9,1.0,10,0.1
321099201,2,7,2.0,9,0.2222222222222222
321100378,5,4,4.0,9,0.4444444444444444
321105184,4,6,4.0,10,0.4
321105352,2,8,2.0,10,0.2
321152855,2,8,2.0,10,0.2
321160383,2,7,2.0,9,0.2222222222222222
321165604,5,4,4.0,9,0.4444444444444444
321169388,2,7,2.0,9,0.2222222222222222
321174209,1,8,1.0,9,0.1111111111111111
321181019,6,4,4.0,10,0.4
321192231,2,7,2.0,9,0.2222222222222222
321206314,3,6,3.0,9,0.3333333333333333
321209821,5,5,5.0,10,0.5
321221383,2,28,2.0,30,0.06666666666666667
321222824,8,2,2.0,10,0.2
321224759,5,24,5.0,29,0.1724137931034483
321228877,1,9,1.0,10,0.1
321229486,7,2,2.0,9,0.2222222222222222
321229947,1,8,1.0,9,0.1111111111111111
321230309,7,3,3.0,10,0.3
321245302,1,9,1.0,10,0.1
321259851,2,7,2.0,9,0.2222222222222222
321278275,1,19,1.0,20,0.05
321308030,8,2,2.0,10,0.2
321331411,2,6,2.0,8,0.25
321331660,1,9,1.0,10,0.1
321331698,2,7,2.0,9,0.2222222222222222
321331893,3,6,3.0,9,0.3333333333333333
321338118,1,17,1.0,18,0.05555555555555555
321340764,1,8,1.0,9,0.1111111111111111
321375695,1,8,1.0,9,0.1111111111111111
321377523,2,8,2.0,10,0.2
321378138,8,2,2.0,10,0.2
321378903,4,4,4.0,8,0.5
321381137,1,8,1.0,9,0.1111111111111111
321382061,2,8,2.0,10,0.2
321388568,1,8,1.0,9,0.1111111111111111
321396208,4,5,4.0,9,0.4444444444444444
321397258,3,6,3.0,9,0.3333333333333333
321426259,26,4,4.0,30,0.13333333333333333
321460864,6,4,4.0,10,0.4
321463853,2,7,2.0,9,0.2222222222222222
321465500,1,7,1.0,8,0.125
321474197,1,26,1.0,27,0.037037037037037035
321481710,5,5,5.0,10,0.5
321482564,5,5,5.0,10,0.5
321483210,1,18,1.0,19,0.05263157894736842
321483387,7,3,3.0,10,0.3
321484883,2,8,2.0,10,0.2
321492944,1,9,1.0,10,0.1
321496119,8,2,2.0,10,0.2
321519709,2,8,2.0,10,0.2
321548380,2,17,2.0,19,0.10526315789473684
321559476,1,9,1.0,10,0.1
321592605,1,18,1.0,19,0.05263157894736842
321655340,8,2,2.0,10,0.2
321656107,1,8,1.0,9,0.1111111111111111
321670580,1,8,1.0,9,0.1111111111111111
321672017,3,6,3.0,9,0.3333333333333333
321676537,1,18,1.0,19,0.05263157894736842
321678272,1,9,1.0,10,0.1
321679200,1,19,1.0,20,0.05
321714316,1,8,1.0,9,0.1111111111111111
321717472,1,9,1.0,10,0.1
321735999,1,9,1.0,10,0.1
321740154,1,19,1.0,20,0.05
321752238,1,9,1.0,10,0.1
321755997,1,8,1.0,9,0.1111111111111111
321765076,8,2,2.0,10,0.2
321765443,1,18,1.0,19,0.05263157894736842
321766465,1,8,1.0,9,0.1111111111111111
321809503,1,9,1.0,10,0.1
321822446,2,6,2.0,8,0.25
321829903,2,8,2.0,10,0.2
321834968,2,8,2.0,10,0.2
321835611,1,9,1.0,10,0.1
321843578,3,6,3.0,9,0.3333333333333333
321881391,8,2,2.0,10,0.2
321918159,8,2,2.0,10,0.2
321918758,28,1,1.0,29,0.034482758620689655
321918803,4,5,4.0,9,0.4444444444444444
321954327,2,8,2.0,10,0.2
321968459,4,6,4.0,10,0.4
321975404,4,24,4.0,28,0.14285714285714285
321985117,3,7,3.0,10,0.3
321992359,1,19,1.0,20,0.05
322002235,1,8,1.0,9,0.1111111111111111
322007108,1,9,1.0,10,0.1
322007388,1,19,1.0,20,0.05
322011915,1,9,1.0,10,0.1
322045713,3,6,3.0,9,0.3333333333333333
322059826,1,7,1.0,8,0.125
322069844,1,7,1.0,8,0.125
322071865,8,11,8.0,19,0.42105263157894735
322076101,1,19,1.0,20,0.05
322076910,6,4,4.0,10,0.4
322077592,7,3,3.0,10,0.3
322090982,1,8,1.0,9,0.1111111111111111
322111587,1,7,1.0,8,0.125
322172084,20,7,7.0,27,0.25925925925925924
322173486,19,9,9.0,28,0.32142857142857145
322174103,2,7,2.0,9,0.2222222222222222
322174518,8,12,8.0,20,0.4
322177360,3,7,3.0,10,0.3
322178988,16,12,12.0,28,0.42857142857142855
322185281,7,3,3.0,10,0.3
322186806,1,9,1.0,10,0.1
322189385,4,5,4.0,9,0.4444444444444444
322193184,3,7,3.0,10,0.3
322194119,5,5,5.0,10,0.5
322207650,1,19,1.0,20,0.05
322213434,4,6,4.0,10,0.4
322220596,2,7,2.0,9,0.2222222222222222
322222606,2,8,2.0,10,0.2
322292579,2,17,2.0,19,0.10526315789473684
322311964,1,8,1.0,9,0.1111111111111111
322353880,1,18,1.0,19,0.05263157894736842
322383334,3,16,3.0,19,0.15789473684210525
322384326,4,6,4.0,10,0.4
322384655,5,5,5.0,10,0.5
322385316,1,9,1.0,10,0.1
322395870,1,9,1.0,10,0.1
322397499,4,6,4.0,10,0.4
322424509,1,9,1.0,10,0.1
322432755,1,9,1.0,10,0.1
322438645,5,5,5.0,10,0.5
322439734,1,7,1.0,8,0.125
322442406,1,9,1.0,10,0.1
322467349,1,26,1.0,27,0.037037037037037035
322467580,4,6,4.0,10,0.4
322468174,9,1,1.0,10,0.1
322468999,2,8,2.0,10,0.2
322522245,4,6,4.0,10,0.4
322549367,3,7,3.0,10,0.3
322553640,1,9,1.0,10,0.1
322562398,5,4,4.0,9,0.4444444444444444
322566577,1,9,1.0,10,0.1
322568248,2,8,2.0,10,0.2
322586331,2,7,2.0,9,0.2222222222222222
322586632,1,9,1.0,10,0.1
322590822,7,3,3.0,10,0.3
322591904,9,1,1.0,10,0.1
322597730,6,24,6.0,30,0.2
322599227,1,8,1.0,9,0.1111111111111111
322600793,1,17,1.0,18,0.05555555555555555
322603205,2,8,2.0,10,0.2
322606380,2,8,2.0,10,0.2
322616260,1,9,1.0,10,0.1
322617825,5,4,4.0,9,0.4444444444444444
322631160,1,9,1.0,10,0.1
322633871,1,19,1.0,20,0.05
322643776,3,6,3.0,9,0.3333333333333333
322643782,3,6,3.0,9,0.3333333333333333
322645038,1,9,1.0,10,0.1
322651507,1,8,1.0,9,0.1111111111111111
322684552,2,6,2.0,8,0.25
322694509,1,8,1.0,9,0.1111111111111111
322738935,8,2,2.0,10,0.2
322741410,1,9,1.0,10,0.1
322759906,2,27,2.0,29,0.06896551724137931
322763160,1,8,1.0,9,0.1111111111111111
322777922,1,9,1.0,10,0.1
322790770,5,3,3.0,8,0.375
322791675,5,24,5.0,29,0.1724137931034483
322791815,6,2,2.0,8,0.25
322792426,1,9,1.0,10,0.1
322799002,6,2,2.0,8,0.25
322799903,7,2,2.0,9,0.2222222222222222
322800894,9,1,1.0,10,0.1
322801374,7,3,3.0,10,0.3
322801804,4,5,4.0,9,0.4444444444444444
322817576,7,2,2.0,9,0.2222222222222222
322822632,2,8,2.0,10,0.2
322852567,2,8,2.0,10,0.2
322867848,1,9,1.0,10,0.1
322919723,1,19,1.0,20,0.05
322928663,1,9,1.0,10,0.1
322939282,1,8,1.0,9,0.1111111111111111
322942416,1,8,1.0,9,0.1111111111111111
322953601,1,8,1.0,9,0.1111111111111111
322990386,1,9,1.0,10,0.1
323014209,1,7,1.0,8,0.125
323018568,1,9,1.0,10,0.1
323042455,1,7,1.0,8,0.125
323045384,3,7,3.0,10,0.3
323046308,1,9,1.0,10,0.1
323048990,1,9,1.0,10,0.1
323056855,1,9,1.0,10,0.1
323073329,1,8,1.0,9,0.1111111111111111
323075949,9,1,1.0,10,0.1
323118361,1,19,1.0,20,0.05
323120173,1,9,1.0,10,0.1
323147734,4,6,4.0,10,0.4
323168696,1,9,1.0,10,0.1
323169910,1,9,1.0,10,0.1
323180317,1,9,1.0,10,0.1
323187746,1,18,1.0,19,0.05263157894736842
323204210,5,15,5.0,20,0.25
323207590,3,7,3.0,10,0.3
323207810,4,6,4.0,10,0.4
323210058,4,6,4.0,10,0.4
323210569,3,6,3.0,9,0.3333333333333333
323211733,3,7,3.0,10,0.3
323217491,3,6,3.0,9,0.3333333333333333
323219826,5,5,5.0,10,0.5
323273991,8,1,1.0,9,0.1111111111111111
323274250,2,7,2.0,9,0.2222222222222222
323274323,1,9,1.0,10,0.1
323274395,4,6,4.0,10,0.4
323287664,1,19,1.0,20,0.05
323288751,2,8,2.0,10,0.2
323296399,7,2,2.0,9,0.2222222222222222
323326087,1,19,1.0,20,0.05
323356524,1,9,1.0,10,0.1
323393146,4,16,4.0,20,0.2
323408539,19,10,10.0,29,0.3448275862068966
323409534,1,9,1.0,10,0.1
323420262,4,6,4.0,10,0.4
323420513,3,6,3.0,9,0.3333333333333333
323440467,1,9,1.0,10,0.1
323447589,1,9,1.0,10,0.1
323448672,1,9,1.0,10,0.1
323453613,1,18,1.0,19,0.05263157894736842
323490860,2,8,2.0,10,0.2
323526445,1,7,1.0,8,0.125
323551719,1,19,1.0,20,0.05
323558588,4,6,4.0,10,0.4
323561142,2,8,2.0,10,0.2
323561990,3,7,3.0,10,0.3
323563456,1,9,1.0,10,0.1
323563774,1,9,1.0,10,0.1
323564835,3,16,3.0,19,0.15789473684210525
323570390,2,8,2.0,10,0.2
323592677,3,26,3.0,29,0.10344827586206896
323600854,7,3,3.0,10,0.3
323601811,5,4,4.0,9,0.4444444444444444
323602656,5,4,4.0,9,0.4444444444444444
323603111,19,9,9.0,28,0.32142857142857145
323603180,3,7,3.0,10,0.3
323603678,6,4,4.0,10,0.4
323603684,2,7,2.0,9,0.2222222222222222
323604029,4,6,4.0,10,0.4
323604250,1,8,1.0,9,0.1111111111111111
323618422,1,9,1.0,10,0.1
323631071,1,7,1.0,8,0.125
323631248,1,9,1.0,10,0.1
323631574,1,9,1.0,10,0.1
323632698,15,4,4.0,19,0.21052631578947367
323638754,3,6,3.0,9,0.3333333333333333
323639039,9,1,1.0,10,0.1
323639567,6,4,4.0,10,0.4
323674532,7,3,3.0,10,0.3
323675629,25,2,2.0,27,0.07407407407407407
323678342,7,2,2.0,9,0.2222222222222222
323678819,3,6,3.0,9,0.3333333333333333
323680779,8,2,2.0,10,0.2
323681145,2,8,2.0,10,0.2
323706672,4,6,4.0,10,0.4
323738830,1,8,1.0,9,0.1111111111111111
323740942,1,8,1.0,9,0.1111111111111111
323741909,1,9,1.0,10,0.1
323748006,1,7,1.0,8,0.125
323748337,1,8,1.0,9,0.1111111111111111
323749631,11,17,11.0,28,0.39285714285714285
323751958,3,6,3.0,9,0.3333333333333333
323752957,3,7,3.0,10,0.3
323753579,4,5,4.0,9,0.4444444444444444
323759361,9,1,1.0,10,0.1
323759527,9,1,1.0,10,0.1
323765562,25,1,1.0,26,0.038461538461538464
323768182,1,8,1.0,9,0.1111111111111111
323770531,2,8,2.0,10,0.2
323785064,1,8,1.0,9,0.1111111111111111
323807007,5,23,5.0,28,0.17857142857142858
323814942,2,8,2.0,10,0.2
323847357,3,6,3.0,9,0.3333333333333333
323848095,1,8,1.0,9,0.1111111111111111
323848317,8,2,2.0,10,0.2
323857465,6,14,6.0,20,0.3
323936892,1,9,1.0,10,0.1
323938999,3,15,3.0,18,0.16666666666666666
323939645,8,2,2.0,10,0.2
323949006,4,6,4.0,10,0.4
323953690,1,9,1.0,10,0.1
323977717,2,8,2.0,10,0.2
323980488,1,28,1.0,29,0.034482758620689655
323982366,2,8,2.0,10,0.2
323986875,2,7,2.0,9,0.2222222222222222
323989484,1,8,1.0,9,0.1111111111111111
323990675,6,3,3.0,9,0.3333333333333333
323990702,2,8,2.0,10,0.2
324000441,10,16,10.0,26,0.38461538461538464
324001177,5,4,4.0,9,0.4444444444444444
324001452,1,8,1.0,9,0.1111111111111111
324002299,6,4,4.0,10,0.4
324004370,7,21,7.0,28,0.25
324004875,1,9,1.0,10,0.1
324004903,2,7,2.0,9,0.2222222222222222
324005348,3,7,3.0,10,0.3
324006123,4,6,4.0,10,0.4
324007101,1,9,1.0,10,0.1
324011807,7,1,1.0,8,0.125
324012225,3,6,3.0,9,0.3333333333333333
324015406,4,6,4.0,10,0.4
324016311,1,9,1.0,10,0.1
324017316,2,26,2.0,28,0.07142857142857142
324018314,4,5,4.0,9,0.4444444444444444
324063061,1,9,1.0,10,0.1
324123654,2,6,2.0,8,0.25
324126711,9,20,9.0,29,0.3103448275862069
324130794,9,1,1.0,10,0.1
324135983,1,17,1.0,18,0.05555555555555555
324161470,1,9,1.0,10,0.1
324162566,1,9,1.0,10,0.1
324167303,4,6,4.0,10,0.4
324169025,1,9,1.0,10,0.1
324172270,1,8,1.0,9,0.1111111111111111
324172847,2,17,2.0,19,0.10526315789473684
324173225,2,6,2.0,8,0.25
324174790,2,8,2.0,10,0.2
324174977,1,9,1.0,10,0.1
324185321,3,7,3.0,10,0.3
324202448,1,19,1.0,20,0.05
324248656,2,17,2.0,19,0.10526315789473684
324316387,2,8,2.0,10,0.2
324331102,1,9,1.0,10,0.1
324334642,2,7,2.0,9,0.2222222222222222
324340940,3,6,3.0,9,0.3333333333333333
324345043,6,24,6.0,30,0.2
324347042,1,8,1.0,9,0.1111111111111111
324350689,1,8,1.0,9,0.1111111111111111
324365098,1,9,1.0,10,0.1
324367586,5,14,5.0,19,0.2631578947368421
324368343,8,1,1.0,9,0.1111111111111111
324375153,4,14,4.0,18,0.2222222222222222
324375543,9,1,1.0,10,0.1
324375648,10,17,10.0,27,0.37037037037037035
324409254,3,6,3.0,9,0.3333333333333333
324420803,4,4,4.0,8,0.5
324421761,5,5,5.0,10,0.5
324526296,3,16,3.0,19,0.15789473684210525
324530593,2,17,2.0,19,0.10526315789473684
324574689,9,1,1.0,10,0.1
324584702,2,17,2.0,19,0.10526315789473684
324601918,19,8,8.0,27,0.2962962962962963
324621475,1,9,1.0,10,0.1
324642532,2,8,2.0,10,0.2
324647789,3,13,3.0,16,0.1875
324683163,2,8,2.0,10,0.2
324694132,14,13,13.0,27,0.48148148148148145
324700472,1,8,1.0,9,0.1111111111111111
324702317,2,8,2.0,10,0.2
324726278,8,2,2.0,10,0.2
324738920,1,8,1.0,9,0.1111111111111111
324739598,5,5,5.0,10,0.5
324747870,9,1,1.0,10,0.1
324801213,23,4,4.0,27,0.14814814814814814
324802141,9,16,9.0,25,0.36
324802234,3,6,3.0,9,0.3333333333333333
324804348,3,7,3.0,10,0.3
324876933,1,19,1.0,20,0.05
324881204,1,9,1.0,10,0.1
324895196,2,17,2.0,19,0.10526315789473684
324912006,1,8,1.0,9,0.1111111111111111
324912301,1,8,1.0,9,0.1111111111111111
324975930,1,8,1.0,9,0.1111111111111111
324984364,5,4,4.0,9,0.4444444444444444
325001716,1,19,1.0,20,0.05
325006300,1,9,1.0,10,0.1
325007827,2,8,2.0,10,0.2
325023928,1,7,1.0,8,0.125
325024056,8,2,2.0,10,0.2
325026111,5,5,5.0,10,0.5
325026278,1,9,1.0,10,0.1
325039269,1,7,1.0,8,0.125
325057287,7,3,3.0,10,0.3
325118951,1,9,1.0,10,0.1
325171795,1,15,1.0,16,0.0625
325193402,2,8,2.0,10,0.2
325203390,7,3,3.0,10,0.3
325203588,8,11,8.0,19,0.42105263157894735
325232856,4,5,4.0,9,0.4444444444444444
325237278,1,8,1.0,9,0.1111111111111111
325245201,4,6,4.0,10,0.4
325254367,1,9,1.0,10,0.1
325255455,2,7,2.0,9,0.2222222222222222
325255815,2,8,2.0,10,0.2
325308646,1,9,1.0,10,0.1
325310601,8,1,1.0,9,0.1111111111111111
325311131,2,7,2.0,9,0.2222222222222222
325312390,5,24,5.0,29,0.1724137931034483
325313529,1,8,1.0,9,0.1111111111111111
325326263,4,4,4.0,8,0.5
325348752,8,1,1.0,9,0.1111111111111111
325385142,1,8,1.0,9,0.1111111111111111
325390231,2,17,2.0,19,0.10526315789473684
325414481,1,9,1.0,10,0.1
325489890,3,6,3.0,9,0.3333333333333333
325491573,6,3,3.0,9,0.3333333333333333
325491602,2,7,2.0,9,0.2222222222222222
325498535,7,2,2.0,9,0.2222222222222222
325532635,1,9,1.0,10,0.1
325533269,1,9,1.0,10,0.1
325536467,14,15,14.0,29,0.4827586206896552
325542155,4,6,4.0,10,0.4
325547151,3,16,3.0,19,0.15789473684210525
325547185,1,9,1.0,10,0.1
325547513,5,5,5.0,10,0.5
325548088,17,10,10.0,27,0.37037037037037035
325549691,8,1,1.0,9,0.1111111111111111
325562439,1,9,1.0,10,0.1
325569018,1,17,1.0,18,0.05555555555555555
325576481,1,9,1.0,10,0.1
325579042,9,1,1.0,10,0.1
325599961,1,9,1.0,10,0.1
325668254,1,19,1.0,20,0.05
325679673,2,8,2.0,10,0.2
325723396,1,9,1.0,10,0.1
325725301,2,8,2.0,10,0.2
325725427,5,5,5.0,10,0.5
325725690,1,18,1.0,19,0.05263157894736842
325731392,2,8,2.0,10,0.2
325741523,3,6,3.0,9,0.3333333333333333
325785422,6,2,2.0,8,0.25
325786933,3,6,3.0,9,0.3333333333333333
325827742,4,4,4.0,8,0.5
325838647,2,8,2.0,10,0.2
325847041,6,2,2.0,8,0.25
325880627,6,3,3.0,9,0.3333333333333333
325880782,6,4,4.0,10,0.4
325881394,6,4,4.0,10,0.4
325882448,1,8,1.0,9,0.1111111111111111
325882518,1,19,1.0,20,0.05
325882898,3,6,3.0,9,0.3333333333333333
325891115,2,8,2.0,10,0.2
325891375,22,5,5.0,27,0.18518518518518517
325895912,6,3,3.0,9,0.3333333333333333
325903310,7,2,2.0,9,0.2222222222222222
325903887,20,10,10.0,30,0.3333333333333333
325904384,9,1,1.0,10,0.1
325904476,6,3,3.0,9,0.3333333333333333
325904604,7,2,2.0,9,0.2222222222222222
325915505,3,6,3.0,9,0.3333333333333333
325924723,7,2,2.0,9,0.2222222222222222
325926069,9,1,1.0,10,0.1
325926883,4,6,4.0,10,0.4
325932678,2,16,2.0,18,0.1111111111111111
325936404,12,16,12.0,28,0.42857142857142855
325949459,1,8,1.0,9,0.1111111111111111
325966057,1,9,1.0,10,0.1
325978322,3,7,3.0,10,0.3
326000012,3,7,3.0,10,0.3
326005568,1,19,1.0,20,0.05
326038721,7,2,2.0,9,0.2222222222222222
326047983,3,7,3.0,10,0.3
326062726,8,2,2.0,10,0.2
326063048,29,1,1.0,30,0.03333333333333333
326063506,28,1,1.0,29,0.034482758620689655
326063695,29,1,1.0,30,0.03333333333333333
326068769,3,7,3.0,10,0.3
326086154,2,20,2.0,22,0.09090909090909091
326136608,1,9,1.0,10,0.1
326138556,4,22,4.0,26,0.15384615384615385
326152655,1,9,1.0,10,0.1
326154416,1,19,1.0,20,0.05
326185345,4,15,4.0,19,0.21052631578947367
326192387,1,8,1.0,9,0.1111111111111111
326239822,1,18,1.0,19,0.05263157894736842
326260268,5,5,5.0,10,0.5
326287155,1,9,1.0,10,0.1
326357975,1,8,1.0,9,0.1111111111111111
326363790,1,8,1.0,9,0.1111111111111111
326368090,4,6,4.0,10,0.4
326388041,4,6,4.0,10,0.4
326406595,8,2,2.0,10,0.2
326411549,1,17,1.0,18,0.05555555555555555
326427919,2,27,2.0,29,0.06896551724137931
326431637,6,3,3.0,9,0.3333333333333333
326449357,2,7,2.0,9,0.2222222222222222
326450888,6,3,3.0,9,0.3333333333333333
326493334,8,1,1.0,9,0.1111111111111111
326512807,3,6,3.0,9,0.3333333333333333
326519529,3,6,3.0,9,0.3333333333333333
326519753,12,17,12.0,29,0.41379310344827586
326526642,6,2,2.0,8,0.25
326539294,1,9,1.0,10,0.1
326541737,10,18,10.0,28,0.35714285714285715
326547109,6,4,4.0,10,0.4
326551982,1,8,1.0,9,0.1111111111111111
326566647,1,9,1.0,10,0.1
326570448,3,6,3.0,9,0.3333333333333333
326578002,1,7,1.0,8,0.125
326587260,1,9,1.0,10,0.1
326598156,1,19,1.0,20,0.05
326601979,1,8,1.0,9,0.1111111111111111
326614755,1,9,1.0,10,0.1
326640395,2,7,2.0,9,0.2222222222222222
326725254,4,15,4.0,19,0.21052631578947367
326759093,1,9,1.0,10,0.1
326776990,2,8,2.0,10,0.2
326781746,2,7,2.0,9,0.2222222222222222
326815068,2,6,2.0,8,0.25
326850745,1,9,1.0,10,0.1
326911097,7,3,3.0,10,0.3
326911256,2,6,2.0,8,0.25
326911391,1,8,1.0,9,0.1111111111111111
326911523,3,7,3.0,10,0.3
326911613,20,9,9.0,29,0.3103448275862069
326951685,2,18,2.0,20,0.1
327003615,1,18,1.0,19,0.05263157894736842
327052749,3,6,3.0,9,0.3333333333333333
327053241,11,19,11.0,30,0.36666666666666664
327081145,1,16,1.0,17,0.058823529411764705
327153376,1,19,1.0,20,0.05
327193918,1,9,1.0,10,0.1
327202900,2,8,2.0,10,0.2
327224062,8,2,2.0,10,0.2
327253463,1,7,1.0,8,0.125
327294790,8,11,8.0,19,0.42105263157894735
327337914,5,5,5.0,10,0.5
327340981,5,5,5.0,10,0.5
327377828,2,8,2.0,10,0.2
327388691,4,6,4.0,10,0.4
327398229,3,7,3.0,10,0.3
327404016,1,17,1.0,18,0.05555555555555555
327490581,1,9,1.0,10,0.1
327497361,1,9,1.0,10,0.1
327537566,2,8,2.0,10,0.2
327543938,1,9,1.0,10,0.1
327548887,3,6,3.0,9,0.3333333333333333
327556748,3,6,3.0,9,0.3333333333333333
327560619,3,7,3.0,10,0.3
327568068,5,5,5.0,10,0.5
327579731,2,7,2.0,9,0.2222222222222222
327581083,20,8,8.0,28,0.2857142857142857
327604032,1,9,1.0,10,0.1
327604793,2,8,2.0,10,0.2
327605929,1,8,1.0,9,0.1111111111111111
327616902,5,14,5.0,19,0.2631578947368421
327617070,1,9,1.0,10,0.1
327621343,1,17,1.0,18,0.05555555555555555
327668994,2,8,2.0,10,0.2
327688090,6,4,4.0,10,0.4
327694805,1,8,1.0,9,0.1111111111111111
327699699,5,5,5.0,10,0.5
327710341,5,3,3.0,8,0.375
327718415,17,10,10.0,27,0.37037037037037035
327725763,7,2,2.0,9,0.2222222222222222
327727784,2,8,2.0,10,0.2
327732651,9,1,1.0,10,0.1
327747453,7,12,7.0,19,0.3684210526315789
327763501,1,9,1.0,10,0.1
327763989,3,6,3.0,9,0.3333333333333333
327765524,1,7,1.0,8,0.125
327766830,1,29,1.0,30,0.03333333333333333
327766859,5,4,4.0,9,0.4444444444444444
327767699,9,1,1.0,10,0.1
327769273,8,1,1.0,9,0.1111111111111111
327770856,4,5,4.0,9,0.4444444444444444
327771101,7,2,2.0,9,0.2222222222222222
327809124,9,1,1.0,10,0.1
327809382,6,3,3.0,9,0.3333333333333333
327809712,2,7,2.0,9,0.2222222222222222
327814943,1,18,1.0,19,0.05263157894736842
327842735,2,8,2.0,10,0.2
327865678,6,4,4.0,10,0.4
327866572,5,5,5.0,10,0.5
327902494,1,25,1.0,26,0.038461538461538464
327902813,1,19,1.0,20,0.05
327913061,1,9,1.0,10,0.1
327916315,2,7,2.0,9,0.2222222222222222
327936424,4,4,4.0,8,0.5
327936595,1,9,1.0,10,0.1
327938510,1,7,1.0,8,0.125
327939040,1,8,1.0,9,0.1111111111111111
327940200,1,9,1.0,10,0.1
327961817,2,18,2.0,20,0.1
327969703,5,14,5.0,19,0.2631578947368421
327971017,2,8,2.0,10,0.2
327973636,4,5,4.0,9,0.4444444444444444
327977650,6,4,4.0,10,0.4
327978852,1,9,1.0,10,0.1
327981704,2,7,2.0,9,0.2222222222222222
327982124,2,7,2.0,9,0.2222222222222222
327982591,1,9,1.0,10,0.1
327983473,3,7,3.0,10,0.3
327983829,6,4,4.0,10,0.4
327986438,5,4,4.0,9,0.4444444444444444
327987177,4,23,4.0,27,0.14814814814814814
327987302,1,7,1.0,8,0.125
327989219,4,5,4.0,9,0.4444444444444444
327991459,24,5,5.0,29,0.1724137931034483
328010868,10,9,9.0,19,0.47368421052631576
328017064,24,6,6.0,30,0.2
328054509,1,18,1.0,19,0.05263157894736842
328074598,1,9,1.0,10,0.1
328075026,1,19,1.0,20,0.05
328075259,1,9,1.0,10,0.1
328088420,3,7,3.0,10,0.3
328090025,7,3,3.0,10,0.3
328091924,2,7,2.0,9,0.2222222222222222
328101783,9,1,1.0,10,0.1
328109637,1,8,1.0,9,0.1111111111111111
328112579,1,7,1.0,8,0.125
328140427,2,17,2.0,19,0.10526315789473684
328176704,1,9,1.0,10,0.1
328198080,5,4,4.0,9,0.4444444444444444
328198230,6,4,4.0,10,0.4
328198301,6,4,4.0,10,0.4
328205011,6,13,6.0,19,0.3157894736842105
328229589,3,6,3.0,9,0.3333333333333333
328238270,10,10,10.0,20,0.5
328240386,2,8,2.0,10,0.2
328274855,1,8,1.0,9,0.1111111111111111
328276961,18,1,1.0,19,0.05263157894736842
328289217,1,18,1.0,19,0.05263157894736842
328343129,1,7,1.0,8,0.125
328381962,2,8,2.0,10,0.2
328395415,1,9,1.0,10,0.1
328427822,1,18,1.0,19,0.05263157894736842
328430615,2,8,2.0,10,0.2
328449913,2,27,2.0,29,0.06896551724137931
328466889,1,9,1.0,10,0.1
328489651,3,6,3.0,9,0.3333333333333333
328491457,7,13,7.0,20,0.35
328496346,2,7,2.0,9,0.2222222222222222
328496591,3,6,3.0,9,0.3333333333333333
328496774,3,7,3.0,10,0.3
328501504,8,2,2.0,10,0.2
328503633,8,2,2.0,10,0.2
328503723,1,9,1.0,10,0.1
328515734,3,6,3.0,9,0.3333333333333333
328515856,7,2,2.0,9,0.2222222222222222
328517150,2,8,2.0,10,0.2
328517545,3,7,3.0,10,0.3
328519427,3,7,3.0,10,0.3
328519932,3,6,3.0,9,0.3333333333333333
328520090,1,18,1.0,19,0.05263157894736842
328522498,2,7,2.0,9,0.2222222222222222
328547430,2,8,2.0,10,0.2
328592711,1,9,1.0,10,0.1
328599660,6,4,4.0,10,0.4
328603238,2,8,2.0,10,0.2
328604126,1,9,1.0,10,0.1
328610983,1,9,1.0,10,0.1
328611731,2,8,2.0,10,0.2
328612214,3,6,3.0,9,0.3333333333333333
328612853,1,19,1.0,20,0.05
328614228,1,9,1.0,10,0.1
328622978,2,7,2.0,9,0.2222222222222222
328631489,1,18,1.0,19,0.05263157894736842
328643495,1,9,1.0,10,0.1
328667737,9,21,9.0,30,0.3
328668798,1,8,1.0,9,0.1111111111111111
328669067,1,8,1.0,9,0.1111111111111111
328685591,2,8,2.0,10,0.2
328708759,1,9,1.0,10,0.1
328710362,2,8,2.0,10,0.2
328719060,2,8,2.0,10,0.2
328723058,1,9,1.0,10,0.1
328724485,5,5,5.0,10,0.5
328727986,6,4,4.0,10,0.4
328729609,2,8,2.0,10,0.2
328731011,3,7,3.0,10,0.3
328737524,2,7,2.0,9,0.2222222222222222
328741724,1,9,1.0,10,0.1
328761976,3,7,3.0,10,0.3
328763609,2,8,2.0,10,0.2
328772840,5,13,5.0,18,0.2777777777777778
328799346,1,8,1.0,9,0.1111111111111111
328815228,1,8,1.0,9,0.1111111111111111
328818755,2,8,2.0,10,0.2
328821083,2,7,2.0,9,0.2222222222222222
328821132,2,7,2.0,9,0.2222222222222222
328827336,3,7,3.0,10,0.3
328847755,4,6,4.0,10,0.4
328855240,4,5,4.0,9,0.4444444444444444
328860873,5,5,5.0,10,0.5
328866033,1,7,1.0,8,0.125
328866155,5,5,5.0,10,0.5
328875738,2,8,2.0,10,0.2
328883041,5,5,5.0,10,0.5
328884229,1,7,1.0,8,0.125
328887093,1,9,1.0,10,0.1
328887146,5,5,5.0,10,0.5
328893328,5,22,5.0,27,0.18518518518518517
328894833,5,4,4.0,9,0.4444444444444444
328927675,2,7,2.0,9,0.2222222222222222
328932830,3,7,3.0,10,0.3
328964411,3,6,3.0,9,0.3333333333333333
328978084,6,4,4.0,10,0.4
328983801,4,5,4.0,9,0.4444444444444444
328986202,7,2,2.0,9,0.2222222222222222
328989621,7,3,3.0,10,0.3
328990798,9,1,1.0,10,0.1
328993186,9,1,1.0,10,0.1
328993279,6,4,4.0,10,0.4
329000565,8,2,2.0,10,0.2
329023979,7,3,3.0,10,0.3
329034709,1,9,1.0,10,0.1
329042319,4,5,4.0,9,0.4444444444444444
329042474,1,9,1.0,10,0.1
329050055,5,13,5.0,18,0.2777777777777778
329078505,1,9,1.0,10,0.1
329088096,2,17,2.0,19,0.10526315789473684
329117126,1,8,1.0,9,0.1111111111111111
329152756,7,3,3.0,10,0.3
329246168,2,8,2.0,10,0.2
329254035,1,7,1.0,8,0.125
329254702,9,1,1.0,10,0.1
329263668,9,1,1.0,10,0.1
329265428,1,9,1.0,10,0.1
329268889,2,17,2.0,19,0.10526315789473684
329270114,1,8,1.0,9,0.1111111111111111
329307642,4,5,4.0,9,0.4444444444444444
329313823,4,14,4.0,18,0.2222222222222222
329336820,2,8,2.0,10,0.2
329367194,2,7,2.0,9,0.2222222222222222
329370238,1,9,1.0,10,0.1
329377416,7,1,1.0,8,0.125
329379129,7,3,3.0,10,0.3
329379230,6,3,3.0,9,0.3333333333333333
329382709,6,4,4.0,10,0.4
329396018,1,8,1.0,9,0.1111111111111111
329425063,2,8,2.0,10,0.2
329426108,1,8,1.0,9,0.1111111111111111
329434182,4,6,4.0,10,0.4
329454508,3,7,3.0,10,0.3
329463946,2,18,2.0,20,0.1
329477742,3,7,3.0,10,0.3
329486455,1,9,1.0,10,0.1
329528642,1,19,1.0,20,0.05
329530679,2,18,2.0,20,0.1
329543965,1,9,1.0,10,0.1
329552854,1,9,1.0,10,0.1
329553232,2,17,2.0,19,0.10526315789473684
329562382,3,7,3.0,10,0.3
329567625,1,9,1.0,10,0.1
329570618,13,7,7.0,20,0.35
329573088,9,1,1.0,10,0.1
329597615,1,8,1.0,9,0.1111111111111111
329653467,4,6,4.0,10,0.4
329660961,1,9,1.0,10,0.1
329722153,1,17,1.0,18,0.05555555555555555
329723770,7,3,3.0,10,0.3
329735889,8,2,2.0,10,0.2
329760678,14,16,14.0,30,0.4666666666666667
329770032,5,5,5.0,10,0.5
329782156,2,8,2.0,10,0.2
329782560,3,24,3.0,27,0.1111111111111111
329784132,5,5,5.0,10,0.5
329788343,9,1,1.0,10,0.1
329792606,2,8,2.0,10,0.2
329801087,8,2,2.0,10,0.2
329810609,2,8,2.0,10,0.2
329889978,6,4,4.0,10,0.4
329915247,1,9,1.0,10,0.1
329938327,9,1,1.0,10,0.1
329954707,4,6,4.0,10,0.4
329955586,1,9,1.0,10,0.1
329956332,1,8,1.0,9,0.1111111111111111
329996267,1,9,1.0,10,0.1
330001143,7,3,3.0,10,0.3
330017783,3,5,3.0,8,0.375
330064954,26,2,2.0,28,0.07142857142857142
330069022,9,1,1.0,10,0.1
330071964,4,6,4.0,10,0.4
330072364,4,6,4.0,10,0.4
330079825,5,5,5.0,10,0.5
330079996,7,2,2.0,9,0.2222222222222222
330080060,3,6,3.0,9,0.3333333333333333
330085552,1,8,1.0,9,0.1111111111111111
330111197,3,6,3.0,9,0.3333333333333333
330119511,1,8,1.0,9,0.1111111111111111
330130633,8,2,2.0,10,0.2
330151035,1,8,1.0,9,0.1111111111111111
330177362,8,14,8.0,22,0.36363636363636365
330180479,1,9,1.0,10,0.1
330249015,4,5,4.0,9,0.4444444444444444
330252920,4,4,4.0,8,0.5
330263008,2,6,2.0,8,0.25
330326114,1,9,1.0,10,0.1
330364725,1,8,1.0,9,0.1111111111111111
330375983,7,2,2.0,9,0.2222222222222222
330427687,2,8,2.0,10,0.2
330475774,1,9,1.0,10,0.1
330489641,1,9,1.0,10,0.1
330507583,9,1,1.0,10,0.1
330517526,6,20,6.0,26,0.23076923076923078
330530357,2,8,2.0,10,0.2
330533941,3,7,3.0,10,0.3
330549707,1,8,1.0,9,0.1111111111111111
330584107,2,16,2.0,18,0.1111111111111111
330608877,1,9,1.0,10,0.1
330623519,8,2,2.0,10,0.2
330653026,6,4,4.0,10,0.4
330696962,1,9,1.0,10,0.1
330697105,1,9,1.0,10,0.1
330706449,1,8,1.0,9,0.1111111111111111
330713295,1,9,1.0,10,0.1
330749064,5,4,4.0,9,0.4444444444444444
330751524,1,9,1.0,10,0.1
330761790,2,8,2.0,10,0.2
330782569,1,19,1.0,20,0.05
330794756,11,7,7.0,18,0.3888888888888889
330795185,2,7,2.0,9,0.2222222222222222
330815595,4,6,4.0,10,0.4
330816115,5,4,4.0,9,0.4444444444444444
330840698,2,8,2.0,10,0.2
330843122,1,9,1.0,10,0.1
330909061,2,7,2.0,9,0.2222222222222222
330911431,10,8,8.0,18,0.4444444444444444
330911870,2,8,2.0,10,0.2
330928110,2,8,2.0,10,0.2
330929547,3,5,3.0,8,0.375
330933900,1,8,1.0,9,0.1111111111111111
330952478,1,9,1.0,10,0.1
330959660,7,3,3.0,10,0.3
330961874,1,9,1.0,10,0.1
330964536,3,7,3.0,10,0.3
330964724,1,28,1.0,29,0.034482758620689655
330965816,2,8,2.0,10,0.2
331007129,1,9,1.0,10,0.1
331020899,1,8,1.0,9,0.1111111111111111
331022284,2,7,2.0,9,0.2222222222222222
331031981,2,8,2.0,10,0.2
331061690,2,18,2.0,20,0.1
331080650,6,4,4.0,10,0.4
331091962,1,9,1.0,10,0.1
331100213,3,6,3.0,9,0.3333333333333333
331103370,5,4,4.0,9,0.4444444444444444
331119142,1,7,1.0,8,0.125
331127632,1,18,1.0,19,0.05263157894736842
331148887,2,8,2.0,10,0.2
331149895,21,6,6.0,27,0.2222222222222222
331150971,2,8,2.0,10,0.2
331151574,1,9,1.0,10,0.1
331154532,1,9,1.0,10,0.1
331175503,6,3,3.0,9,0.3333333333333333
331176361,1,19,1.0,20,0.05
331177724,1,9,1.0,10,0.1
331177797,3,7,3.0,10,0.3
331179256,1,9,1.0,10,0.1
331179730,13,6,6.0,19,0.3157894736842105
331189303,3,6,3.0,9,0.3333333333333333
331206116,3,7,3.0,10,0.3
331206470,6,4,4.0,10,0.4
331206876,6,4,4.0,10,0.4
331207607,1,19,1.0,20,0.05
331208508,8,2,2.0,10,0.2
331223739,1,8,1.0,9,0.1111111111111111
331226930,2,17,2.0,19,0.10526315789473684
331265350,12,6,6.0,18,0.3333333333333333
331278153,4,26,4.0,30,0.13333333333333333
331284356,2,7,2.0,9,0.2222222222222222
331288067,1,7,1.0,8,0.125
331293135,3,6,3.0,9,0.3333333333333333
331293196,1,8,1.0,9,0.1111111111111111
331297262,4,5,4.0,9,0.4444444444444444
331300366,4,14,4.0,18,0.2222222222222222
331311704,2,18,2.0,20,0.1
331314084,4,5,4.0,9,0.4444444444444444
331326947,6,3,3.0,9,0.3333333333333333
331330193,2,18,2.0,20,0.1
331347343,6,3,3.0,9,0.3333333333333333
331379812,2,8,2.0,10,0.2
331389175,3,6,3.0,9,0.3333333333333333
331422145,6,3,3.0,9,0.3333333333333333
331422316,3,7,3.0,10,0.3
331422458,1,9,1.0,10,0.1
331422584,19,7,7.0,26,0.2692307692307692
331436934,6,3,3.0,9,0.3333333333333333
331437706,4,6,4.0,10,0.4
331463043,4,15,4.0,19,0.21052631578947367
331495574,1,9,1.0,10,0.1
331549059,8,1,1.0,9,0.1111111111111111
331551039,2,7,2.0,9,0.2222222222222222
331560977,1,9,1.0,10,0.1
331561081,5,5,5.0,10,0.5
331569130,5,5,5.0,10,0.5
331580606,9,18,9.0,27,0.3333333333333333
331609425,1,19,1.0,20,0.05
331650076,1,8,1.0,9,0.1111111111111111
331668529,2,8,2.0,10,0.2
331683874,6,4,4.0,10,0.4
331689882,3,7,3.0,10,0.3
331691034,2,8,2.0,10,0.2
331696583,2,7,2.0,9,0.2222222222222222
331704209,1,18,1.0,19,0.05263157894736842
331707454,10,15,10.0,25,0.4
331711625,2,17,2.0,19,0.10526315789473684
331722481,2,8,2.0,10,0.2
331733974,1,19,1.0,20,0.05
331745800,5,5,5.0,10,0.5
331746422,1,8,1.0,9,0.1111111111111111
331790154,1,8,1.0,9,0.1111111111111111
331795853,3,7,3.0,10,0.3
331798369,1,8,1.0,9,0.1111111111111111
331806946,1,18,1.0,19,0.05263157894736842
331840407,2,8,2.0,10,0.2
331879797,2,8,2.0,10,0.2
331882167,4,6,4.0,10,0.4
331882749,1,9,1.0,10,0.1
331911785,3,6,3.0,9,0.3333333333333333
331923527,14,14,14.0,28,0.5
331934659,2,17,2.0,19,0.10526315789473684
331938281,5,14,5.0,19,0.2631578947368421
331946216,1,9,1.0,10,0.1
331960073,1,9,1.0,10,0.1
331967781,3,6,3.0,9,0.3333333333333333
332077341,1,9,1.0,10,0.1
332080476,7,3,3.0,10,0.3
332095371,2,8,2.0,10,0.2
332107910,1,9,1.0,10,0.1
332151277,1,19,1.0,20,0.05
332158147,1,8,1.0,9,0.1111111111111111
332186575,5,15,5.0,20,0.25
332190197,1,8,1.0,9,0.1111111111111111
332222672,1,8,1.0,9,0.1111111111111111
332244192,4,6,4.0,10,0.4
332251568,2,8,2.0,10,0.2
332282378,27,2,2.0,29,0.06896551724137931
332321192,1,8,1.0,9,0.1111111111111111
332374209,6,23,6.0,29,0.20689655172413793
332404618,6,4,4.0,10,0.4
332404880,4,6,4.0,10,0.4
332449617,2,8,2.0,10,0.2
332490107,6,14,6.0,20,0.3
332523986,2,7,2.0,9,0.2222222222222222
332540690,4,15,4.0,19,0.21052631578947367
332542298,4,6,4.0,10,0.4
332544601,3,7,3.0,10,0.3
332544788,3,7,3.0,10,0.3
332562091,5,5,5.0,10,0.5
332566754,1,18,1.0,19,0.05263157894736842
332589606,2,16,2.0,18,0.1111111111111111
332592857,6,3,3.0,9,0.3333333333333333
332593077,3,6,3.0,9,0.3333333333333333
332593809,7,3,3.0,10,0.3
332608583,4,6,4.0,10,0.4
332608752,8,1,1.0,9,0.1111111111111111
332609775,2,6,2.0,8,0.25
332687204,3,6,3.0,9,0.3333333333333333
332703045,4,4,4.0,8,0.5
332705336,1,26,1.0,27,0.037037037037037035
332705955,1,8,1.0,9,0.1111111111111111
332722430,1,27,1.0,28,0.03571428571428571
332752125,4,6,4.0,10,0.4
332753440,9,1,1.0,10,0.1
332759791,3,7,3.0,10,0.3
332778222,1,8,1.0,9,0.1111111111111111
332785643,2,17,2.0,19,0.10526315789473684
332793990,1,9,1.0,10,0.1
332798480,6,21,6.0,27,0.2222222222222222
332819018,5,4,4.0,9,0.4444444444444444
332821954,9,1,1.0,10,0.1
332822067,8,2,2.0,10,0.2
332836284,7,3,3.0,10,0.3
332836359,2,8,2.0,10,0.2
332836465,1,7,1.0,8,0.125
332836630,6,4,4.0,10,0.4
332857339,1,8,1.0,9,0.1111111111111111
332869041,2,7,2.0,9,0.2222222222222222
332869423,2,27,2.0,29,0.06896551724137931
332871236,4,16,4.0,20,0.2
332871930,1,9,1.0,10,0.1
332873194,4,5,4.0,9,0.4444444444444444
332875398,1,9,1.0,10,0.1
332875524,6,4,4.0,10,0.4
332893646,23,3,3.0,26,0.11538461538461539
332894427,5,5,5.0,10,0.5
332926771,1,7,1.0,8,0.125
332933569,5,4,4.0,9,0.4444444444444444
332934550,5,5,5.0,10,0.5
332935898,1,28,1.0,29,0.034482758620689655
332947621,1,8,1.0,9,0.1111111111111111
332952398,1,18,1.0,19,0.05263157894736842
332962581,5,5,5.0,10,0.5
332974169,1,9,1.0,10,0.1
332980446,8,2,2.0,10,0.2
332990090,16,12,12.0,28,0.42857142857142855
333000703,8,1,1.0,9,0.1111111111111111
333000898,8,1,1.0,9,0.1111111111111111
333001309,8,1,1.0,9,0.1111111111111111
333008937,3,16,3.0,19,0.15789473684210525
333009062,1,8,1.0,9,0.1111111111111111
333038214,3,7,3.0,10,0.3
333053530,2,8,2.0,10,0.2
333063669,9,1,1.0,10,0.1
333065865,1,9,1.0,10,0.1
333068574,1,9,1.0,10,0.1
333079833,1,9,1.0,10,0.1
333083286,3,7,3.0,10,0.3
333083909,8,1,1.0,9,0.1111111111111111
333090874,4,21,4.0,25,0.16
333125136,2,7,2.0,9,0.2222222222222222
333150192,1,18,1.0,19,0.05263157894736842
333185043,2,8,2.0,10,0.2
333188669,2,17,2.0,19,0.10526315789473684
333208830,6,3,3.0,9,0.3333333333333333
333221866,1,9,1.0,10,0.1
333269321,1,9,1.0,10,0.1
333274605,4,5,4.0,9,0.4444444444444444
333275625,3,6,3.0,9,0.3333333333333333
333276251,21,6,6.0,27,0.2222222222222222
333280854,1,9,1.0,10,0.1
333283793,6,4,4.0,10,0.4
333289682,1,9,1.0,10,0.1
333312730,2,8,2.0,10,0.2
333315947,1,9,1.0,10,0.1
333331916,1,8,1.0,9,0.1111111111111111
333347270,8,1,1.0,9,0.1111111111111111
333362886,1,9,1.0,10,0.1
333363283,1,8,1.0,9,0.1111111111111111
333374456,1,7,1.0,8,0.125
333376039,9,1,1.0,10,0.1
333391910,3,7,3.0,10,0.3
333425570,1,9,1.0,10,0.1
333452183,24,3,3.0,27,0.1111111111111111
333491023,1,9,1.0,10,0.1
333503405,3,7,3.0,10,0.3
333559718,1,9,1.0,10,0.1
333568537,1,9,1.0,10,0.1
333606080,3,6,3.0,9,0.3333333333333333
333651745,3,5,3.0,8,0.375
333680170,13,14,13.0,27,0.48148148148148145
333682057,6,4,4.0,10,0.4
333683053,8,2,2.0,10,0.2
333683519,3,6,3.0,9,0.3333333333333333
333697867,4,6,4.0,10,0.4
333714540,2,8,2.0,10,0.2
333715048,2,8,2.0,10,0.2
333715374,5,5,5.0,10,0.5
333740296,1,8,1.0,9,0.1111111111111111
333824345,1,8,1.0,9,0.1111111111111111
333827049,2,8,2.0,10,0.2
333866495,2,8,2.0,10,0.2
333874318,8,2,2.0,10,0.2
333879615,1,9,1.0,10,0.1
333884456,5,24,5.0,29,0.1724137931034483
333898888,1,17,1.0,18,0.05555555555555555
333899722,4,16,4.0,20,0.2
333901532,7,3,3.0,10,0.3
333914049,5,5,5.0,10,0.5
333932281,1,9,1.0,10,0.1
333968835,2,7,2.0,9,0.2222222222222222
333969016,4,6,4.0,10,0.4
333969369,5,4,4.0,9,0.4444444444444444
333971306,1,8,1.0,9,0.1111111111111111
333980601,1,19,1.0,20,0.05
334006913,4,4,4.0,8,0.5
334011689,2,8,2.0,10,0.2
334012528,1,7,1.0,8,0.125
334015715,1,24,1.0,25,0.04
334028317,1,9,1.0,10,0.1
334050480,1,9,1.0,10,0.1
334063120,6,2,2.0,8,0.25
334119655,3,6,3.0,9,0.3333333333333333
334120276,4,5,4.0,9,0.4444444444444444
334127959,1,8,1.0,9,0.1111111111111111
334129134,4,6,4.0,10,0.4
334155415,10,9,9.0,19,0.47368421052631576
334167614,2,7,2.0,9,0.2222222222222222
334199943,1,19,1.0,20,0.05
334204706,2,8,2.0,10,0.2
334284068,2,8,2.0,10,0.2
334291427,5,3,3.0,8,0.375
334299656,7,2,2.0,9,0.2222222222222222
334326020,2,8,2.0,10,0.2
334326757,1,9,1.0,10,0.1
334374465,1,8,1.0,9,0.1111111111111111
334382071,9,1,1.0,10,0.1
334390352,2,8,2.0,10,0.2
334499562,1,9,1.0,10,0.1
334533895,1,9,1.0,10,0.1
334536869,3,7,3.0,10,0.3
334549161,1,28,1.0,29,0.034482758620689655
334581800,1,9,1.0,10,0.1
334582363,3,7,3.0,10,0.3
334584027,5,4,4.0,9,0.4444444444444444
334585969,7,2,2.0,9,0.2222222222222222
334586635,8,2,2.0,10,0.2
334596803,2,8,2.0,10,0.2
334606612,3,7,3.0,10,0.3
334609028,2,8,2.0,10,0.2
334629976,6,2,2.0,8,0.25
334630631,9,1,1.0,10,0.1
334632260,1,9,1.0,10,0.1
334641426,9,1,1.0,10,0.1
334680760,1,9,1.0,10,0.1
334716908,5,13,5.0,18,0.2777777777777778
334735115,2,8,2.0,10,0.2
334740142,3,7,3.0,10,0.3
334781913,5,5,5.0,10,0.5
334803915,2,8,2.0,10,0.2
334804047,2,15,2.0,17,0.11764705882352941
334805948,2,8,2.0,10,0.2
334807781,2,7,2.0,9,0.2222222222222222
334812395,1,18,1.0,19,0.05263157894736842
334835659,2,8,2.0,10,0.2
334845508,3,7,3.0,10,0.3
334846844,2,8,2.0,10,0.2
334847051,7,12,7.0,19,0.3684210526315789
334849268,4,14,4.0,18,0.2222222222222222
334901408,2,7,2.0,9,0.2222222222222222
334910494,1,8,1.0,9,0.1111111111111111
335000027,7,13,7.0,20,0.35
335007902,15,14,14.0,29,0.4827586206896552
335026726,6,4,4.0,10,0.4
335029788,4,6,4.0,10,0.4
335031768,22,5,5.0,27,0.18518518518518517
335033555,3,7,3.0,10,0.3
335047036,2,8,2.0,10,0.2
335050683,1,9,1.0,10,0.1
335051293,3,6,3.0,9,0.3333333333333333
335053409,4,5,4.0,9,0.4444444444444444
335054942,7,2,2.0,9,0.2222222222222222
335076678,1,18,1.0,19,0.05263157894736842
335120550,2,8,2.0,10,0.2
335123112,2,8,2.0,10,0.2
335133254,2,28,2.0,30,0.06666666666666667
335136226,1,9,1.0,10,0.1
335138227,6,24,6.0,30,0.2
335162904,1,9,1.0,10,0.1
335165353,5,22,5.0,27,0.18518518518518517
335177069,7,3,3.0,10,0.3
335177336,1,9,1.0,10,0.1
335177681,6,3,3.0,9,0.3333333333333333
335178248,7,3,3.0,10,0.3
335219247,5,5,5.0,10,0.5
335219868,20,8,8.0,28,0.2857142857142857
335225060,2,8,2.0,10,0.2
335230661,6,3,3.0,9,0.3333333333333333
335231955,8,1,1.0,9,0.1111111111111111
335254285,8,2,2.0,10,0.2
335263469,1,8,1.0,9,0.1111111111111111
335267472,7,12,7.0,19,0.3684210526315789
335276313,22,6,6.0,28,0.21428571428571427
335315451,2,8,2.0,10,0.2
335321318,6,4,4.0,10,0.4
335337608,1,9,1.0,10,0.1
335340988,1,8,1.0,9,0.1111111111111111
335342787,2,7,2.0,9,0.2222222222222222
335348084,2,8,2.0,10,0.2
335360007,6,3,3.0,9,0.3333333333333333
335360163,8,2,2.0,10,0.2
335360252,5,5,5.0,10,0.5
335362693,1,19,1.0,20,0.05
335395899,1,7,1.0,8,0.125
335396331,6,2,2.0,8,0.25
335408021,3,5,3.0,8,0.375
335418604,2,7,2.0,9,0.2222222222222222
335419646,1,8,1.0,9,0.1111111111111111
335420250,1,8,1.0,9,0.1111111111111111
335420295,1,9,1.0,10,0.1
335435017,14,6,6.0,20,0.3
335531638,6,4,4.0,10,0.4
335532442,1,16,1.0,17,0.058823529411764705
335534484,5,5,5.0,10,0.5
335552279,2,8,2.0,10,0.2
335552348,6,2,2.0,8,0.25
335557835,2,16,2.0,18,0.1111111111111111
335595829,4,5,4.0,9,0.4444444444444444
335597064,21,3,3.0,24,0.125
335607769,1,18,1.0,19,0.05263157894736842
335610802,6,4,4.0,10,0.4
335612184,4,6,4.0,10,0.4
335618124,5,14,5.0,19,0.2631578947368421
335621742,4,6,4.0,10,0.4
335636884,2,7,2.0,9,0.2222222222222222
335637038,4,4,4.0,8,0.5
335685573,1,18,1.0,19,0.05263157894736842
335698062,6,3,3.0,9,0.3333333333333333
335714572,1,18,1.0,19,0.05263157894736842
335725324,1,19,1.0,20,0.05
335752748,7,2,2.0,9,0.2222222222222222
335766796,2,8,2.0,10,0.2
335785997,5,5,5.0,10,0.5
335788415,1,19,1.0,20,0.05
335828660,1,9,1.0,10,0.1
335831189,3,7,3.0,10,0.3
335836926,1,18,1.0,19,0.05263157894736842
335838264,2,8,2.0,10,0.2
335854768,2,8,2.0,10,0.2
335863298,1,9,1.0,10,0.1
335866111,1,7,1.0,8,0.125
335910823,2,17,2.0,19,0.10526315789473684
335918683,1,9,1.0,10,0.1
335919544,3,17,3.0,20,0.15
335919902,1,8,1.0,9,0.1111111111111111
335924231,1,9,1.0,10,0.1
335934266,6,4,4.0,10,0.4
335945675,4,5,4.0,9,0.4444444444444444
335947020,2,8,2.0,10,0.2
335947950,2,8,2.0,10,0.2
335966699,2,8,2.0,10,0.2
335991469,3,6,3.0,9,0.3333333333333333
335991792,1,18,1.0,19,0.05263157894736842
335993228,1,9,1.0,10,0.1
336017754,1,9,1.0,10,0.1
336020508,1,8,1.0,9,0.1111111111111111
336051245,2,17,2.0,19,0.10526315789473684
336062722,5,5,5.0,10,0.5
336073760,2,8,2.0,10,0.2
336104493,9,1,1.0,10,0.1
336121809,8,2,2.0,10,0.2
336127543,8,2,2.0,10,0.2
336135905,6,3,3.0,9,0.3333333333333333
336138184,8,1,1.0,9,0.1111111111111111
336138900,20,8,8.0,28,0.2857142857142857
336164353,1,18,1.0,19,0.05263157894736842
336169342,1,9,1.0,10,0.1
336173262,5,4,4.0,9,0.4444444444444444
336176774,3,7,3.0,10,0.3
336183149,1,8,1.0,9,0.1111111111111111
336183392,6,4,4.0,10,0.4
336184453,7,3,3.0,10,0.3
336186340,1,9,1.0,10,0.1
336200783,1,9,1.0,10,0.1
336218056,1,9,1.0,10,0.1
336222371,1,9,1.0,10,0.1
336239590,3,16,3.0,19,0.15789473684210525
336251590,1,8,1.0,9,0.1111111111111111
336269213,1,9,1.0,10,0.1
336288462,1,9,1.0,10,0.1
336359022,4,16,4.0,20,0.2
336415879,2,16,2.0,18,0.1111111111111111
336426378,2,8,2.0,10,0.2
336434399,2,8,2.0,10,0.2
336436819,5,4,4.0,9,0.4444444444444444
336440368,2,8,2.0,10,0.2
336442439,3,6,3.0,9,0.3333333333333333
336446539,1,9,1.0,10,0.1
336458975,2,7,2.0,9,0.2222222222222222
336466896,2,7,2.0,9,0.2222222222222222
336469321,1,9,1.0,10,0.1
336474446,3,7,3.0,10,0.3
336474920,1,9,1.0,10,0.1
336477485,7,2,2.0,9,0.2222222222222222
336480826,5,5,5.0,10,0.5
336482978,15,12,12.0,27,0.4444444444444444
336484666,1,8,1.0,9,0.1111111111111111
336510868,4,6,4.0,10,0.4
336530389,2,17,2.0,19,0.10526315789473684
336538656,1,7,1.0,8,0.125
336543667,2,8,2.0,10,0.2
336545599,1,18,1.0,19,0.05263157894736842
336546506,1,9,1.0,10,0.1
336562926,1,9,1.0,10,0.1
336579045,1,19,1.0,20,0.05
336581518,1,9,1.0,10,0.1
336582693,2,8,2.0,10,0.2
336590573,2,18,2.0,20,0.1
336610984,1,9,1.0,10,0.1
336617301,3,7,3.0,10,0.3
336622303,1,9,1.0,10,0.1
336622627,3,7,3.0,10,0.3
336622989,7,2,2.0,9,0.2222222222222222
336632467,1,9,1.0,10,0.1
336640214,1,9,1.0,10,0.1
336649102,1,8,1.0,9,0.1111111111111111
336655228,2,7,2.0,9,0.2222222222222222
336667532,1,8,1.0,9,0.1111111111111111
336680319,1,9,1.0,10,0.1
336684300,1,17,1.0,18,0.05555555555555555
336710731,1,17,1.0,18,0.05555555555555555
336817595,3,6,3.0,9,0.3333333333333333
336827791,6,4,4.0,10,0.4
336848345,1,9,1.0,10,0.1
336868242,6,3,3.0,9,0.3333333333333333
336869071,3,6,3.0,9,0.3333333333333333
336894905,9,1,1.0,10,0.1
336906991,1,19,1.0,20,0.05
336909459,1,7,1.0,8,0.125
336968209,6,23,6.0,29,0.20689655172413793
337005758,4,6,4.0,10,0.4
337015288,1,18,1.0,19,0.05263157894736842
337045574,1,9,1.0,10,0.1
337074863,3,7,3.0,10,0.3
337091348,3,15,3.0,18,0.16666666666666666
337093938,6,3,3.0,9,0.3333333333333333
337097901,3,7,3.0,10,0.3
337104780,2,8,2.0,10,0.2
337105684,9,11,9.0,20,0.45
337109803,1,7,1.0,8,0.125
337115885,1,9,1.0,10,0.1
337116472,1,9,1.0,10,0.1
337118021,2,7,2.0,9,0.2222222222222222
337124498,2,8,2.0,10,0.2
337157640,6,13,6.0,19,0.3157894736842105
337181038,1,28,1.0,29,0.034482758620689655
337182653,4,6,4.0,10,0.4
337184401,2,7,2.0,9,0.2222222222222222
337194761,3,16,3.0,19,0.15789473684210525
337204904,1,9,1.0,10,0.1
337206885,3,7,3.0,10,0.3
337207011,12,17,12.0,29,0.41379310344827586
337224730,1,9,1.0,10,0.1
337227304,27,3,3.0,30,0.1
337228381,1,9,1.0,10,0.1
337281982,22,6,6.0,28,0.21428571428571427
337285529,5,5,5.0,10,0.5
337285968,1,8,1.0,9,0.1111111111111111
337287480,7,3,3.0,10,0.3
337292909,3,6,3.0,9,0.3333333333333333
337293630,1,27,1.0,28,0.03571428571428571
337294985,1,9,1.0,10,0.1
337297955,6,14,6.0,20,0.3
337306163,8,2,2.0,10,0.2
337311743,1,9,1.0,10,0.1
337362993,2,8,2.0,10,0.2
337366185,2,7,2.0,9,0.2222222222222222
337384386,3,7,3.0,10,0.3
337417721,1,9,1.0,10,0.1
337418395,1,9,1.0,10,0.1
337421510,1,19,1.0,20,0.05
337442798,1,18,1.0,19,0.05263157894736842
337461166,1,9,1.0,10,0.1
337461933,4,6,4.0,10,0.4
337482975,1,18,1.0,19,0.05263157894736842
337489754,1,9,1.0,10,0.1
337534642,2,8,2.0,10,0.2
337537257,1,9,1.0,10,0.1
337540276,1,9,1.0,10,0.1
337548585,2,8,2.0,10,0.2
337555514,3,7,3.0,10,0.3
337568283,5,4,4.0,9,0.4444444444444444
337576877,5,5,5.0,10,0.5
337579896,2,7,2.0,9,0.2222222222222222
337581605,1,8,1.0,9,0.1111111111111111
337596795,5,5,5.0,10,0.5
337601153,6,4,4.0,10,0.4
337604649,7,3,3.0,10,0.3
337639467,1,9,1.0,10,0.1
337647145,9,1,1.0,10,0.1
337653960,9,1,1.0,10,0.1
337661430,1,9,1.0,10,0.1
337686342,6,4,4.0,10,0.4
337686574,6,4,4.0,10,0.4
337692753,2,7,2.0,9,0.2222222222222222
337774375,1,19,1.0,20,0.05
337848540,6,4,4.0,10,0.4
337850371,1,9,1.0,10,0.1
337861842,5,22,5.0,27,0.18518518518518517
337865482,1,9,1.0,10,0.1
337865965,1,8,1.0,9,0.1111111111111111
337870367,5,4,4.0,9,0.4444444444444444
337920864,7,3,3.0,10,0.3
337947606,1,9,1.0,10,0.1
337976297,8,1,1.0,9,0.1111111111111111
338004349,1,8,1.0,9,0.1111111111111111
338005696,2,8,2.0,10,0.2
338029299,1,9,1.0,10,0.1
338038063,2,8,2.0,10,0.2
338040859,3,7,3.0,10,0.3
338045395,2,8,2.0,10,0.2
338047320,1,9,1.0,10,0.1
338051799,1,9,1.0,10,0.1
338058389,1,9,1.0,10,0.1
338059631,2,7,2.0,9,0.2222222222222222
338064947,1,8,1.0,9,0.1111111111111111
338069413,19,10,10.0,29,0.3448275862068966
338078449,3,24,3.0,27,0.1111111111111111
338079855,2,16,2.0,18,0.1111111111111111
338082678,4,14,4.0,18,0.2222222222222222
338092145,8,2,2.0,10,0.2
338111723,6,4,4.0,10,0.4
338156951,4,6,4.0,10,0.4
338158258,1,9,1.0,10,0.1
338179637,2,17,2.0,19,0.10526315789473684
338205078,1,8,1.0,9,0.1111111111111111
338216791,10,10,10.0,20,0.5
338229036,1,8,1.0,9,0.1111111111111111
338243143,1,8,1.0,9,0.1111111111111111
338273893,1,9,1.0,10,0.1
338279801,2,6,2.0,8,0.25
338285604,5,3,3.0,8,0.375
338293598,2,8,2.0,10,0.2
338296840,1,9,1.0,10,0.1
338304252,1,19,1.0,20,0.05
338306576,1,18,1.0,19,0.05263157894736842
338378548,2,17,2.0,19,0.10526315789473684
338389390,2,8,2.0,10,0.2
338401256,11,9,9.0,20,0.45
338415194,1,9,1.0,10,0.1
338418454,3,7,3.0,10,0.3
338450789,2,8,2.0,10,0.2
338450962,8,1,1.0,9,0.1111111111111111
338453088,2,8,2.0,10,0.2
338460015,15,4,4.0,19,0.21052631578947367
338460104,6,21,6.0,27,0.2222222222222222
338460518,3,7,3.0,10,0.3
338460969,1,9,1.0,10,0.1
338461176,7,2,2.0,9,0.2222222222222222
338465325,5,3,3.0,8,0.375
338466167,23,6,6.0,29,0.20689655172413793
338466186,6,3,3.0,9,0.3333333333333333
338473366,9,1,1.0,10,0.1
338499149,1,17,1.0,18,0.05555555555555555
338519430,1,9,1.0,10,0.1
338521277,5,5,5.0,10,0.5
338521604,3,7,3.0,10,0.3
338521794,5,5,5.0,10,0.5
338529525,1,8,1.0,9,0.1111111111111111
338529849,5,5,5.0,10,0.5
338530430,6,4,4.0,10,0.4
338535987,5,5,5.0,10,0.5
338538721,3,6,3.0,9,0.3333333333333333
338540430,2,8,2.0,10,0.2
338540502,4,6,4.0,10,0.4
338568308,1,9,1.0,10,0.1
338584011,2,8,2.0,10,0.2
338601691,3,7,3.0,10,0.3
338602665,4,4,4.0,8,0.5
338602729,6,3,3.0,9,0.3333333333333333
338629800,1,19,1.0,20,0.05
338636815,1,9,1.0,10,0.1
338638751,4,4,4.0,8,0.5
338646720,1,18,1.0,19,0.05263157894736842
338647201,7,1,1.0,8,0.125
338679878,8,1,1.0,9,0.1111111111111111
338680166,4,5,4.0,9,0.4444444444444444
338686644,5,5,5.0,10,0.5
338700980,1,9,1.0,10,0.1
338712743,2,8,2.0,10,0.2
338727225,1,8,1.0,9,0.1111111111111111
338736395,1,9,1.0,10,0.1
338751798,1,8,1.0,9,0.1111111111111111
338752247,1,18,1.0,19,0.05263157894736842
338799800,2,8,2.0,10,0.2
338808191,1,9,1.0,10,0.1
338826493,1,9,1.0,10,0.1
338848584,1,7,1.0,8,0.125
338865612,2,8,2.0,10,0.2
338876134,4,5,4.0,9,0.4444444444444444
338881286,8,1,1.0,9,0.1111111111111111
338882256,1,9,1.0,10,0.1
338884132,2,27,2.0,29,0.06896551724137931
338884314,16,13,13.0,29,0.4482758620689655
338884685,8,2,2.0,10,0.2
338887343,1,9,1.0,10,0.1
338891758,5,4,4.0,9,0.4444444444444444
338897101,1,8,1.0,9,0.1111111111111111
338900075,4,5,4.0,9,0.4444444444444444
338907836,3,7,3.0,10,0.3
338932730,2,7,2.0,9,0.2222222222222222
338936379,5,3,3.0,8,0.375
338936890,7,3,3.0,10,0.3
338944449,1,8,1.0,9,0.1111111111111111
338944707,5,23,5.0,28,0.17857142857142858
338944800,3,7,3.0,10,0.3
338952482,7,3,3.0,10,0.3
338956425,8,2,2.0,10,0.2
338980519,1,8,1.0,9,0.1111111111111111
338993249,2,8,2.0,10,0.2
338998634,4,5,4.0,9,0.4444444444444444
339007727,2,7,2.0,9,0.2222222222222222
339008387,1,8,1.0,9,0.1111111111111111
339011166,1,9,1.0,10,0.1
339012272,5,5,5.0,10,0.5
339013391,2,7,2.0,9,0.2222222222222222
339019006,1,8,1.0,9,0.1111111111111111
339021496,2,8,2.0,10,0.2
339030678,2,17,2.0,19,0.10526315789473684
339059864,1,8,1.0,9,0.1111111111111111
339063341,1,8,1.0,9,0.1111111111111111
339092183,1,8,1.0,9,0.1111111111111111
339106069,4,5,4.0,9,0.4444444444444444
339119830,17,11,11.0,28,0.39285714285714285
339124733,1,8,1.0,9,0.1111111111111111
339151787,1,7,1.0,8,0.125
339161505,1,9,1.0,10,0.1
339168767,3,7,3.0,10,0.3
339168917,2,7,2.0,9,0.2222222222222222
339177996,4,6,4.0,10,0.4
339183511,8,2,2.0,10,0.2
339203406,2,8,2.0,10,0.2
339208293,1,18,1.0,19,0.05263157894736842
339209871,1,9,1.0,10,0.1
339216713,9,1,1.0,10,0.1
339217563,4,6,4.0,10,0.4
339247938,4,24,4.0,28,0.14285714285714285
339249120,6,4,4.0,10,0.4
339254126,2,17,2.0,19,0.10526315789473684
339264492,3,5,3.0,8,0.375
339264664,18,11,11.0,29,0.3793103448275862
339264688,3,7,3.0,10,0.3
339264722,22,6,6.0,28,0.21428571428571427
339265245,3,6,3.0,9,0.3333333333333333
339265369,21,8,8.0,29,0.27586206896551724
339265508,4,5,4.0,9,0.4444444444444444
339298420,4,6,4.0,10,0.4
339301573,1,9,1.0,10,0.1
339302918,1,9,1.0,10,0.1
339320376,5,5,5.0,10,0.5
339325407,5,5,5.0,10,0.5
339326668,2,8,2.0,10,0.2
339337556,1,17,1.0,18,0.05555555555555555
339339018,2,8,2.0,10,0.2
339348544,2,17,2.0,19,0.10526315789473684
339355216,2,17,2.0,19,0.10526315789473684
339361229,2,27,2.0,29,0.06896551724137931
339369497,9,1,1.0,10,0.1
339379922,1,8,1.0,9,0.1111111111111111
339380189,4,6,4.0,10,0.4
339380587,1,18,1.0,19,0.05263157894736842
339386027,2,6,2.0,8,0.25
339388257,2,8,2.0,10,0.2
339390625,2,7,2.0,9,0.2222222222222222
339391021,7,13,7.0,20,0.35
339392348,3,7,3.0,10,0.3
339395906,3,5,3.0,8,0.375
339396449,6,3,3.0,9,0.3333333333333333
339396997,4,6,4.0,10,0.4
339398090,4,6,4.0,10,0.4
339400748,1,9,1.0,10,0.1
339415868,4,5,4.0,9,0.4444444444444444
339419390,3,6,3.0,9,0.3333333333333333
339425161,1,8,1.0,9,0.1111111111111111
339438419,2,8,2.0,10,0.2
339461383,4,6,4.0,10,0.4
339478276,26,2,2.0,28,0.07142857142857142
339478966,27,3,3.0,30,0.1
339483513,1,9,1.0,10,0.1
339502205,3,7,3.0,10,0.3
339518898,6,2,2.0,8,0.25
339532123,1,9,1.0,10,0.1
339533890,1,9,1.0,10,0.1
339563398,6,12,6.0,18,0.3333333333333333
339569143,9,1,1.0,10,0.1
339570354,2,15,2.0,17,0.11764705882352941
339571971,9,1,1.0,10,0.1
339636476,7,2,2.0,9,0.2222222222222222
339647539,1,9,1.0,10,0.1
339648366,1,18,1.0,19,0.05263157894736842
339772117,2,8,2.0,10,0.2
339777122,2,7,2.0,9,0.2222222222222222
339780886,8,18,8.0,26,0.3076923076923077
339783757,2,8,2.0,10,0.2
339795822,8,1,1.0,9,0.1111111111111111
339808108,15,13,13.0,28,0.4642857142857143
339808748,6,4,4.0,10,0.4
339812515,1,9,1.0,10,0.1
339812776,2,7,2.0,9,0.2222222222222222
339814484,1,7,1.0,8,0.125
339823333,8,1,1.0,9,0.1111111111111111
339827633,4,6,4.0,10,0.4
339835246,8,2,2.0,10,0.2
339857756,2,7,2.0,9,0.2222222222222222
339882026,4,6,4.0,10,0.4
339889699,1,9,1.0,10,0.1
339900668,6,4,4.0,10,0.4
339904687,8,1,1.0,9,0.1111111111111111
339910883,4,6,4.0,10,0.4
339910980,7,3,3.0,10,0.3
339912115,9,1,1.0,10,0.1
339930621,2,8,2.0,10,0.2
339937034,7,2,2.0,9,0.2222222222222222
339959227,4,5,4.0,9,0.4444444444444444
339984141,1,9,1.0,10,0.1
339997909,6,12,6.0,18,0.3333333333333333
340005545,2,8,2.0,10,0.2
340018172,7,3,3.0,10,0.3
340025809,2,8,2.0,10,0.2
340036237,5,5,5.0,10,0.5
340036724,1,8,1.0,9,0.1111111111111111
340037895,1,9,1.0,10,0.1
340048567,1,18,1.0,19,0.05263157894736842
340063809,16,14,14.0,30,0.4666666666666667
340155493,5,5,5.0,10,0.5
340155971,4,6,4.0,10,0.4
340156369,8,2,2.0,10,0.2
340173148,1,7,1.0,8,0.125
340186425,3,7,3.0,10,0.3
340195049,5,4,4.0,9,0.4444444444444444
340198057,3,7,3.0,10,0.3
340213471,1,9,1.0,10,0.1
340217345,4,15,4.0,19,0.21052631578947367
340238795,7,2,2.0,9,0.2222222222222222
340239973,19,9,9.0,28,0.32142857142857145
340240431,2,17,2.0,19,0.10526315789473684
340241099,1,9,1.0,10,0.1
340243201,7,2,2.0,9,0.2222222222222222
340250120,4,6,4.0,10,0.4
340253690,8,2,2.0,10,0.2
340286510,2,7,2.0,9,0.2222222222222222
340306922,3,7,3.0,10,0.3
340346902,1,9,1.0,10,0.1
340362057,15,5,5.0,20,0.25
340362418,3,7,3.0,10,0.3
340379599,2,7,2.0,9,0.2222222222222222
340380116,1,9,1.0,10,0.1
340405022,8,2,2.0,10,0.2
340407841,3,16,3.0,19,0.15789473684210525
340422538,1,18,1.0,19,0.05263157894736842
340451002,1,8,1.0,9,0.1111111111111111
340488775,8,2,2.0,10,0.2
340491803,3,6,3.0,9,0.3333333333333333
340501665,15,5,5.0,20,0.25
340528046,3,15,3.0,18,0.16666666666666666
340548735,1,8,1.0,9,0.1111111111111111
340600861,1,8,1.0,9,0.1111111111111111
340658063,9,19,9.0,28,0.32142857142857145
340681313,8,1,1.0,9,0.1111111111111111
340682233,5,5,5.0,10,0.5
340682307,3,5,3.0,8,0.375
340701136,9,1,1.0,10,0.1
340708743,3,7,3.0,10,0.3
340767298,10,10,10.0,20,0.5
340782857,5,5,5.0,10,0.5
340783344,2,7,2.0,9,0.2222222222222222
340796151,4,6,4.0,10,0.4
340815599,7,2,2.0,9,0.2222222222222222
340829042,2,7,2.0,9,0.2222222222222222
340830128,8,11,8.0,19,0.42105263157894735
340834673,9,1,1.0,10,0.1
340835125,9,1,1.0,10,0.1
340845423,4,6,4.0,10,0.4
340868026,1,18,1.0,19,0.05263157894736842
340932847,2,8,2.0,10,0.2
340933219,1,9,1.0,10,0.1
340934823,4,4,4.0,8,0.5
340937040,1,9,1.0,10,0.1
340937510,2,8,2.0,10,0.2
340938682,2,7,2.0,9,0.2222222222222222
340943287,5,3,3.0,8,0.375
340945001,1,9,1.0,10,0.1
340946338,1,9,1.0,10,0.1
340967161,2,7,2.0,9,0.2222222222222222
340968901,1,19,1.0,20,0.05
340979506,1,9,1.0,10,0.1
341004635,1,19,1.0,20,0.05
341030596,1,8,1.0,9,0.1111111111111111
341047769,9,1,1.0,10,0.1
341050099,2,7,2.0,9,0.2222222222222222
341061025,1,17,1.0,18,0.05555555555555555
341061073,1,9,1.0,10,0.1
341066882,7,3,3.0,10,0.3
341085828,8,1,1.0,9,0.1111111111111111
341086349,3,7,3.0,10,0.3
341089904,1,8,1.0,9,0.1111111111111111
341096602,2,7,2.0,9,0.2222222222222222
341133510,2,7,2.0,9,0.2222222222222222
341147328,6,3,3.0,9,0.3333333333333333
341147638,2,8,2.0,10,0.2
341147939,7,3,3.0,10,0.3
341151962,7,3,3.0,10,0.3
341185748,25,3,3.0,28,0.10714285714285714
341186581,9,1,1.0,10,0.1
341186992,25,4,4.0,29,0.13793103448275862
341195313,1,9,1.0,10,0.1
341209899,1,7,1.0,8,0.125
341255162,3,7,3.0,10,0.3
341279663,1,8,1.0,9,0.1111111111111111
341279776,1,8,1.0,9,0.1111111111111111
341281355,9,1,1.0,10,0.1
341284501,5,4,4.0,9,0.4444444444444444
341286064,3,7,3.0,10,0.3
341287483,2,8,2.0,10,0.2
341315692,2,8,2.0,10,0.2
341328994,5,5,5.0,10,0.5
341334916,7,21,7.0,28,0.25
341335699,2,8,2.0,10,0.2
341337497,1,9,1.0,10,0.1
341338703,1,9,1.0,10,0.1
341340072,5,5,5.0,10,0.5
341372986,3,6,3.0,9,0.3333333333333333
341376771,1,9,1.0,10,0.1
341384409,8,2,2.0,10,0.2
341399882,6,20,6.0,26,0.23076923076923078
341400312,1,9,1.0,10,0.1
341402378,1,28,1.0,29,0.034482758620689655
341413098,1,8,1.0,9,0.1111111111111111
341414041,7,21,7.0,28,0.25
341415202,6,3,3.0,9,0.3333333333333333
341415422,8,1,1.0,9,0.1111111111111111
341420421,1,9,1.0,10,0.1
341424849,2,6,2.0,8,0.25
341425236,7,1,1.0,8,0.125
341425437,4,6,4.0,10,0.4
341425610,3,7,3.0,10,0.3
341425734,3,6,3.0,9,0.3333333333333333
341426492,9,1,1.0,10,0.1
341432173,1,9,1.0,10,0.1
341432308,1,29,1.0,30,0.03333333333333333
341432334,2,7,2.0,9,0.2222222222222222
341433064,3,6,3.0,9,0.3333333333333333
341434466,1,27,1.0,28,0.03571428571428571
341458337,3,7,3.0,10,0.3
341459129,3,7,3.0,10,0.3
341462599,8,1,1.0,9,0.1111111111111111
341485470,3,16,3.0,19,0.15789473684210525
341494956,2,18,2.0,20,0.1
341502046,1,8,1.0,9,0.1111111111111111
341502134,2,8,2.0,10,0.2
341503227,1,7,1.0,8,0.125
341506391,1,7,1.0,8,0.125
341555634,2,8,2.0,10,0.2
341556858,1,9,1.0,10,0.1
341557745,8,2,2.0,10,0.2
341576002,1,8,1.0,9,0.1111111111111111
341580392,1,9,1.0,10,0.1
341586991,1,18,1.0,19,0.05263157894736842
341594726,1,9,1.0,10,0.1
341603136,3,7,3.0,10,0.3
341608167,8,2,2.0,10,0.2
341608554,5,5,5.0,10,0.5
341611822,1,9,1.0,10,0.1
341648239,1,8,1.0,9,0.1111111111111111
341650411,3,7,3.0,10,0.3
341650523,4,6,4.0,10,0.4
341652475,3,7,3.0,10,0.3
341652695,6,2,2.0,8,0.25
341683664,6,11,6.0,17,0.35294117647058826
341684327,5,4,4.0,9,0.4444444444444444
341690498,6,3,3.0,9,0.3333333333333333
341695132,1,8,1.0,9,0.1111111111111111
341695414,2,8,2.0,10,0.2
341695984,2,8,2.0,10,0.2
341703976,1,8,1.0,9,0.1111111111111111
341738711,1,8,1.0,9,0.1111111111111111
341740401,2,8,2.0,10,0.2
341747182,6,23,6.0,29,0.20689655172413793
341774596,1,8,1.0,9,0.1111111111111111
341775648,7,20,7.0,27,0.25925925925925924
341786217,1,7,1.0,8,0.125
341849803,1,7,1.0,8,0.125
341857054,21,5,5.0,26,0.19230769230769232
341857118,9,1,1.0,10,0.1
341857203,10,14,10.0,24,0.4166666666666667
341857295,6,2,2.0,8,0.25
341865307,18,1,1.0,19,0.05263157894736842
341907179,6,4,4.0,10,0.4
341944794,5,4,4.0,9,0.4444444444444444
341990179,1,19,1.0,20,0.05
342007307,2,6,2.0,8,0.25
342007968,2,7,2.0,9,0.2222222222222222
342033723,3,7,3.0,10,0.3
342039808,6,3,3.0,9,0.3333333333333333
342043298,4,6,4.0,10,0.4
342088124,9,1,1.0,10,0.1
342127971,5,4,4.0,9,0.4444444444444444
342135096,1,8,1.0,9,0.1111111111111111
342177916,6,4,4.0,10,0.4
342212724,3,7,3.0,10,0.3
342237351,9,1,1.0,10,0.1
342241150,2,7,2.0,9,0.2222222222222222
342241602,1,8,1.0,9,0.1111111111111111
342261558,8,2,2.0,10,0.2
342261678,9,1,1.0,10,0.1
342266002,1,8,1.0,9,0.1111111111111111
342289355,1,9,1.0,10,0.1
342304165,2,18,2.0,20,0.1
342305861,3,17,3.0,20,0.15
342334684,4,15,4.0,19,0.21052631578947367
342348732,1,9,1.0,10,0.1
342358457,2,6,2.0,8,0.25
342360895,1,19,1.0,20,0.05
342418929,23,5,5.0,28,0.17857142857142858
342419965,8,2,2.0,10,0.2
342452871,2,8,2.0,10,0.2
342471077,2,8,2.0,10,0.2
342476994,3,6,3.0,9,0.3333333333333333
342477676,4,25,4.0,29,0.13793103448275862
342478044,1,8,1.0,9,0.1111111111111111
342484797,1,9,1.0,10,0.1
342502093,1,9,1.0,10,0.1
342505727,1,8,1.0,9,0.1111111111111111
342507865,1,8,1.0,9,0.1111111111111111
342509975,4,5,4.0,9,0.4444444444444444
342510951,2,8,2.0,10,0.2
342516933,2,8,2.0,10,0.2
342517932,4,5,4.0,9,0.4444444444444444
342519321,2,8,2.0,10,0.2
342521281,4,5,4.0,9,0.4444444444444444
342523302,5,4,4.0,9,0.4444444444444444
342525627,4,6,4.0,10,0.4
342531408,8,2,2.0,10,0.2
342533435,22,4,4.0,26,0.15384615384615385
342535142,8,1,1.0,9,0.1111111111111111
342550866,1,18,1.0,19,0.05263157894736842
342588694,1,9,1.0,10,0.1
342594292,1,9,1.0,10,0.1
342595795,1,7,1.0,8,0.125
342616216,3,6,3.0,9,0.3333333333333333
342638064,2,8,2.0,10,0.2
342651462,8,2,2.0,10,0.2
342676122,1,8,1.0,9,0.1111111111111111
342698627,2,8,2.0,10,0.2
342785415,1,8,1.0,9,0.1111111111111111
342804447,3,7,3.0,10,0.3
342804956,1,28,1.0,29,0.034482758620689655
342824811,1,9,1.0,10,0.1
342828164,5,4,4.0,9,0.4444444444444444
342830173,4,24,4.0,28,0.14285714285714285
342846991,2,7,2.0,9,0.2222222222222222
342848495,2,8,2.0,10,0.2
342849436,1,9,1.0,10,0.1
342859560,2,7,2.0,9,0.2222222222222222
342861099,2,6,2.0,8,0.25
342862106,6,4,4.0,10,0.4
342889350,1,9,1.0,10,0.1
342890023,3,6,3.0,9,0.3333333333333333
342890456,1,9,1.0,10,0.1
342891147,3,7,3.0,10,0.3
342933740,2,7,2.0,9,0.2222222222222222
342951447,8,2,2.0,10,0.2
342997905,1,7,1.0,8,0.125
343018252,1,9,1.0,10,0.1
343022462,8,2,2.0,10,0.2
343022762,2,7,2.0,9,0.2222222222222222
343023839,2,8,2.0,10,0.2
343029240,8,1,1.0,9,0.1111111111111111
343030633,1,28,1.0,29,0.034482758620689655
343030719,1,9,1.0,10,0.1
343032183,4,6,4.0,10,0.4
343032502,2,7,2.0,9,0.2222222222222222
343034476,3,6,3.0,9,0.3333333333333333
343034627,4,6,4.0,10,0.4
343034988,6,2,2.0,8,0.25
343036776,1,9,1.0,10,0.1
343059275,1,9,1.0,10,0.1
343068982,2,8,2.0,10,0.2
343083270,1,9,1.0,10,0.1
343083976,2,8,2.0,10,0.2
343084629,1,9,1.0,10,0.1
343084796,3,7,3.0,10,0.3
343097092,8,2,2.0,10,0.2
343209710,8,1,1.0,9,0.1111111111111111
343209720,9,1,1.0,10,0.1
343246239,2,7,2.0,9,0.2222222222222222
343246664,1,8,1.0,9,0.1111111111111111
343246895,1,9,1.0,10,0.1
343247741,3,5,3.0,8,0.375
343247917,2,7,2.0,9,0.2222222222222222
343248117,1,9,1.0,10,0.1
343248391,2,8,2.0,10,0.2
343274054,3,6,3.0,9,0.3333333333333333
343274402,2,8,2.0,10,0.2
343284869,2,16,2.0,18,0.1111111111111111
343294128,7,3,3.0,10,0.3
343302985,2,8,2.0,10,0.2
343314014,3,7,3.0,10,0.3
343346800,3,6,3.0,9,0.3333333333333333
343365973,3,6,3.0,9,0.3333333333333333
343404614,6,2,2.0,8,0.25
343417964,4,6,4.0,10,0.4
343423838,4,6,4.0,10,0.4
343424093,2,7,2.0,9,0.2222222222222222
343438392,3,7,3.0,10,0.3
343442796,19,9,9.0,28,0.32142857142857145
343445891,1,17,1.0,18,0.05555555555555555
343447653,4,6,4.0,10,0.4
343463666,1,7,1.0,8,0.125
343467364,2,6,2.0,8,0.25
343467894,3,7,3.0,10,0.3
343468647,1,9,1.0,10,0.1
343479912,1,9,1.0,10,0.1
343484307,9,1,1.0,10,0.1
343494424,3,7,3.0,10,0.3
343494495,2,7,2.0,9,0.2222222222222222
343503049,1,8,1.0,9,0.1111111111111111
343504817,24,4,4.0,28,0.14285714285714285
343507727,2,8,2.0,10,0.2
343517258,6,3,3.0,9,0.3333333333333333
343519927,8,2,2.0,10,0.2
343527777,1,9,1.0,10,0.1
343577404,1,9,1.0,10,0.1
343583940,9,1,1.0,10,0.1
343584406,5,5,5.0,10,0.5
343589467,1,17,1.0,18,0.05555555555555555
343595438,2,7,2.0,9,0.2222222222222222
343596451,6,4,4.0,10,0.4
343613244,12,14,12.0,26,0.46153846153846156
343623956,8,12,8.0,20,0.4
343663320,3,7,3.0,10,0.3
343664277,1,9,1.0,10,0.1
343667583,4,5,4.0,9,0.4444444444444444
343683330,3,16,3.0,19,0.15789473684210525
343684437,2,7,2.0,9,0.2222222222222222
343689594,3,7,3.0,10,0.3
343752595,9,9,9.0,18,0.5
343755075,1,8,1.0,9,0.1111111111111111
343774656,2,8,2.0,10,0.2
343787169,9,1,1.0,10,0.1
343792797,1,9,1.0,10,0.1
343815762,8,10,8.0,18,0.4444444444444444
343843764,1,18,1.0,19,0.05263157894736842
343964777,1,9,1.0,10,0.1
343991686,6,4,4.0,10,0.4
344020242,1,9,1.0,10,0.1
344028151,1,28,1.0,29,0.034482758620689655
344029617,3,7,3.0,10,0.3
344030213,1,9,1.0,10,0.1
344035297,1,8,1.0,9,0.1111111111111111
344040163,1,9,1.0,10,0.1
344059014,1,19,1.0,20,0.05
344076300,1,8,1.0,9,0.1111111111111111
344078006,1,9,1.0,10,0.1
344084031,1,9,1.0,10,0.1
344084515,1,9,1.0,10,0.1
344089818,1,9,1.0,10,0.1
344126287,1,8,1.0,9,0.1111111111111111
344134319,1,15,1.0,16,0.0625
344138164,1,19,1.0,20,0.05
344164353,8,1,1.0,9,0.1111111111111111
344182503,1,8,1.0,9,0.1111111111111111
344192854,1,9,1.0,10,0.1
344237932,1,9,1.0,10,0.1
344241202,1,9,1.0,10,0.1
344246102,4,5,4.0,9,0.4444444444444444
344252822,3,15,3.0,18,0.16666666666666666
344253480,1,9,1.0,10,0.1
344263132,2,7,2.0,9,0.2222222222222222
344281971,3,5,3.0,8,0.375
344284230,4,15,4.0,19,0.21052631578947367
344289137,1,7,1.0,8,0.125
344290069,1,19,1.0,20,0.05
344293071,1,9,1.0,10,0.1
344296323,1,9,1.0,10,0.1
344299684,1,7,1.0,8,0.125
344319206,1,8,1.0,9,0.1111111111111111
344351249,3,6,3.0,9,0.3333333333333333
344400933,2,8,2.0,10,0.2
344408144,1,7,1.0,8,0.125
344408435,1,8,1.0,9,0.1111111111111111
344418463,2,8,2.0,10,0.2
344433816,8,19,8.0,27,0.2962962962962963
344439205,6,4,4.0,10,0.4
344445179,1,19,1.0,20,0.05
344458296,7,1,1.0,8,0.125
344462775,5,5,5.0,10,0.5
344487137,1,8,1.0,9,0.1111111111111111
344495021,5,25,5.0,30,0.16666666666666666
344508334,2,17,2.0,19,0.10526315789473684
344511267,3,7,3.0,10,0.3
344514652,1,7,1.0,8,0.125
344517356,3,7,3.0,10,0.3
344538180,1,7,1.0,8,0.125
344538610,4,15,4.0,19,0.21052631578947367
344567624,1,8,1.0,9,0.1111111111111111
344572078,3,7,3.0,10,0.3
344579736,1,8,1.0,9,0.1111111111111111
344583994,22,5,5.0,27,0.18518518518518517
344584567,1,14,1.0,15,0.06666666666666667
344613426,5,5,5.0,10,0.5
344642121,2,18,2.0,20,0.1
344669464,9,19,9.0,28,0.32142857142857145
344702536,1,9,1.0,10,0.1
344704234,6,4,4.0,10,0.4
344718982,6,4,4.0,10,0.4
344735719,2,8,2.0,10,0.2
344740941,8,2,2.0,10,0.2
344747716,2,27,2.0,29,0.06896551724137931
344758003,6,4,4.0,10,0.4
344820205,3,17,3.0,20,0.15
344828605,7,3,3.0,10,0.3
344832380,1,9,1.0,10,0.1
344837663,2,7,2.0,9,0.2222222222222222
344838019,7,21,7.0,28,0.25
344840829,2,28,2.0,30,0.06666666666666667
344841022,2,8,2.0,10,0.2
344844260,5,5,5.0,10,0.5
344899252,4,16,4.0,20,0.2
344903052,1,9,1.0,10,0.1
344922357,2,8,2.0,10,0.2
344923883,1,9,1.0,10,0.1
344931308,2,8,2.0,10,0.2
344952261,5,4,4.0,9,0.4444444444444444
344956110,18,9,9.0,27,0.3333333333333333
344979700,5,5,5.0,10,0.5
344979998,4,5,4.0,9,0.4444444444444444
344980461,1,7,1.0,8,0.125
344984710,1,8,1.0,9,0.1111111111111111
345005527,3,7,3.0,10,0.3
345005870,5,4,4.0,9,0.4444444444444444
345008182,1,9,1.0,10,0.1
345014685,5,4,4.0,9,0.4444444444444444
345043407,1,18,1.0,19,0.05263157894736842
345043812,26,2,2.0,28,0.07142857142857142
345047468,4,5,4.0,9,0.4444444444444444
345060929,2,8,2.0,10,0.2
345062298,3,24,3.0,27,0.1111111111111111
345067700,1,9,1.0,10,0.1
345079340,2,8,2.0,10,0.2
345109090,2,7,2.0,9,0.2222222222222222
345128950,2,18,2.0,20,0.1
345140527,4,16,4.0,20,0.2
345143043,4,6,4.0,10,0.4
345143794,3,6,3.0,9,0.3333333333333333
345145342,1,8,1.0,9,0.1111111111111111
345153277,2,8,2.0,10,0.2
345190671,1,9,1.0,10,0.1
345226284,2,8,2.0,10,0.2
345235997,8,1,1.0,9,0.1111111111111111
345236120,9,1,1.0,10,0.1
345236189,7,1,1.0,8,0.125
345236887,8,2,2.0,10,0.2
345241394,1,8,1.0,9,0.1111111111111111
345258561,3,6,3.0,9,0.3333333333333333
345268650,1,8,1.0,9,0.1111111111111111
345283102,2,8,2.0,10,0.2
345285689,13,15,13.0,28,0.4642857142857143
345285706,8,2,2.0,10,0.2
345307287,5,4,4.0,9,0.4444444444444444
345354475,10,9,9.0,19,0.47368421052631576
345378352,1,9,1.0,10,0.1
345385320,1,9,1.0,10,0.1
345387484,1,9,1.0,10,0.1
345497793,4,6,4.0,10,0.4
345513322,1,9,1.0,10,0.1
345513642,2,8,2.0,10,0.2
345514404,1,8,1.0,9,0.1111111111111111
345525436,1,19,1.0,20,0.05
345560114,7,2,2.0,9,0.2222222222222222
345566391,1,9,1.0,10,0.1
345587549,3,7,3.0,10,0.3
345589300,6,4,4.0,10,0.4
345596757,9,1,1.0,10,0.1
345596815,9,1,1.0,10,0.1
345597048,8,1,1.0,9,0.1111111111111111
345607448,1,17,1.0,18,0.05555555555555555
345610210,3,7,3.0,10,0.3
345664860,2,16,2.0,18,0.1111111111111111
345670246,1,9,1.0,10,0.1
345671953,10,20,10.0,30,0.3333333333333333
345701752,1,19,1.0,20,0.05
345708180,1,18,1.0,19,0.05263157894736842
345728801,1,18,1.0,19,0.05263157894736842
345734377,3,21,3.0,24,0.125
345747027,2,7,2.0,9,0.2222222222222222
345754409,1,9,1.0,10,0.1
345754771,1,9,1.0,10,0.1
345755842,1,8,1.0,9,0.1111111111111111
345782925,3,17,3.0,20,0.15
345851163,1,7,1.0,8,0.125
345862997,3,16,3.0,19,0.15789473684210525
345864475,1,9,1.0,10,0.1
345883980,2,7,2.0,9,0.2222222222222222
345885032,4,6,4.0,10,0.4
345891978,2,8,2.0,10,0.2
345917440,7,2,2.0,9,0.2222222222222222
345926073,1,8,1.0,9,0.1111111111111111
345944256,2,7,2.0,9,0.2222222222222222
345944857,2,8,2.0,10,0.2
345962600,3,7,3.0,10,0.3
345963714,4,5,4.0,9,0.4444444444444444
345966195,5,4,4.0,9,0.4444444444444444
345966920,1,9,1.0,10,0.1
345972145,1,9,1.0,10,0.1
345973278,6,4,4.0,10,0.4
346031830,1,8,1.0,9,0.1111111111111111
346042747,3,5,3.0,8,0.375
346079189,2,8,2.0,10,0.2
346086600,2,8,2.0,10,0.2
346093272,1,7,1.0,8,0.125
346123832,1,9,1.0,10,0.1
346125588,1,9,1.0,10,0.1
346127811,1,8,1.0,9,0.1111111111111111
346162229,1,9,1.0,10,0.1
346179550,1,8,1.0,9,0.1111111111111111
346245332,5,14,5.0,19,0.2631578947368421
346293688,2,7,2.0,9,0.2222222222222222
346306244,1,8,1.0,9,0.1111111111111111
346314308,2,18,2.0,20,0.1
346368837,1,9,1.0,10,0.1
346433069,18,9,9.0,27,0.3333333333333333
346433656,1,19,1.0,20,0.05
346449358,1,9,1.0,10,0.1
346475418,1,9,1.0,10,0.1
346482524,1,9,1.0,10,0.1
346501422,9,1,1.0,10,0.1
346553420,11,17,11.0,28,0.39285714285714285
346554597,3,6,3.0,9,0.3333333333333333
346555778,1,9,1.0,10,0.1
346558079,7,21,7.0,28,0.25
346563514,2,8,2.0,10,0.2
346563660,1,9,1.0,10,0.1
346585617,1,9,1.0,10,0.1
346598973,3,5,3.0,8,0.375
346604980,1,9,1.0,10,0.1
346611401,2,8,2.0,10,0.2
346611751,1,9,1.0,10,0.1
346638760,1,18,1.0,19,0.05263157894736842
346641482,2,6,2.0,8,0.25
346641598,5,5,5.0,10,0.5
346641670,6,4,4.0,10,0.4
346641762,5,4,4.0,9,0.4444444444444444
346674529,1,9,1.0,10,0.1
346683360,1,18,1.0,19,0.05263157894736842
346703667,2,17,2.0,19,0.10526315789473684
346743831,1,8,1.0,9,0.1111111111111111
346766784,1,9,1.0,10,0.1
346769031,1,8,1.0,9,0.1111111111111111
346793958,2,17,2.0,19,0.10526315789473684
346831798,1,7,1.0,8,0.125
346842182,8,2,2.0,10,0.2
346929778,1,9,1.0,10,0.1
346932956,3,6,3.0,9,0.3333333333333333
346950980,3,5,3.0,8,0.375
346956641,2,14,2.0,16,0.125
346980566,1,9,1.0,10,0.1
347001036,4,6,4.0,10,0.4
347003407,3,5,3.0,8,0.375
347013759,1,8,1.0,9,0.1111111111111111
347030634,3,7,3.0,10,0.3
347030773,6,4,4.0,10,0.4
347031592,1,18,1.0,19,0.05263157894736842
347034073,2,6,2.0,8,0.25
347084293,1,9,1.0,10,0.1
347102005,6,3,3.0,9,0.3333333333333333
347103708,3,7,3.0,10,0.3
347112685,2,18,2.0,20,0.1
347175513,1,8,1.0,9,0.1111111111111111
347175679,3,6,3.0,9,0.3333333333333333
347177267,1,9,1.0,10,0.1
347178402,1,9,1.0,10,0.1
347179593,2,7,2.0,9,0.2222222222222222
347181200,8,22,8.0,30,0.26666666666666666
347187960,3,7,3.0,10,0.3
347196849,1,28,1.0,29,0.034482758620689655
347206854,1,8,1.0,9,0.1111111111111111
347211350,1,8,1.0,9,0.1111111111111111
347221298,1,7,1.0,8,0.125
347230824,1,9,1.0,10,0.1
347233373,1,8,1.0,9,0.1111111111111111
347234194,6,4,4.0,10,0.4
347235383,4,6,4.0,10,0.4
347237040,7,2,2.0,9,0.2222222222222222
347237662,5,4,4.0,9,0.4444444444444444
347239512,1,7,1.0,8,0.125
347240677,1,9,1.0,10,0.1
347261120,2,17,2.0,19,0.10526315789473684
347269741,1,9,1.0,10,0.1
347297505,6,4,4.0,10,0.4
347297567,2,8,2.0,10,0.2
347302492,6,3,3.0,9,0.3333333333333333
347350020,2,7,2.0,9,0.2222222222222222
347351633,2,7,2.0,9,0.2222222222222222
347381739,2,7,2.0,9,0.2222222222222222
347384070,5,5,5.0,10,0.5
347425265,3,7,3.0,10,0.3
347426207,3,7,3.0,10,0.3
347439414,1,9,1.0,10,0.1
347492792,3,5,3.0,8,0.375
347518122,1,9,1.0,10,0.1
347579539,4,4,4.0,8,0.5
347614192,6,23,6.0,29,0.20689655172413793
347615447,1,9,1.0,10,0.1
347643011,2,8,2.0,10,0.2
347645416,1,9,1.0,10,0.1
347674794,5,4,4.0,9,0.4444444444444444
347762028,1,8,1.0,9,0.1111111111111111
347766331,1,7,1.0,8,0.125
347767586,1,18,1.0,19,0.05263157894736842
347777229,9,1,1.0,10,0.1
347778068,27,3,3.0,30,0.1
347780909,5,4,4.0,9,0.4444444444444444
347792395,4,5,4.0,9,0.4444444444444444
347792443,3,6,3.0,9,0.3333333333333333
347821872,1,8,1.0,9,0.1111111111111111
347867085,1,8,1.0,9,0.1111111111111111
347887642,5,5,5.0,10,0.5
347887727,6,4,4.0,10,0.4
347890314,7,2,2.0,9,0.2222222222222222
347891023,7,1,1.0,8,0.125
347894333,8,2,2.0,10,0.2
347896283,2,8,2.0,10,0.2
347951889,2,8,2.0,10,0.2
347963981,2,8,2.0,10,0.2
347964451,1,9,1.0,10,0.1
347968049,9,1,1.0,10,0.1
347968225,9,1,1.0,10,0.1
348022371,1,9,1.0,10,0.1
348066566,2,16,2.0,18,0.1111111111111111
348085105,4,6,4.0,10,0.4
348113377,2,7,2.0,9,0.2222222222222222
348133093,3,7,3.0,10,0.3
348148773,1,8,1.0,9,0.1111111111111111
348148790,1,9,1.0,10,0.1
348177576,1,9,1.0,10,0.1
348207550,1,9,1.0,10,0.1
348219316,7,2,2.0,9,0.2222222222222222
348219883,19,5,5.0,24,0.20833333333333334
348257422,5,12,5.0,17,0.29411764705882354
348270674,2,17,2.0,19,0.10526315789473684
348283515,4,16,4.0,20,0.2
348299125,4,5,4.0,9,0.4444444444444444
348299655,19,9,9.0,28,0.32142857142857145
348300305,1,8,1.0,9,0.1111111111111111
348301463,2,8,2.0,10,0.2
348303725,2,18,2.0,20,0.1
348362445,9,1,1.0,10,0.1
348389476,1,19,1.0,20,0.05
348407539,8,2,2.0,10,0.2
348416863,3,7,3.0,10,0.3
348417781,1,9,1.0,10,0.1
348419347,6,3,3.0,9,0.3333333333333333
348428900,1,9,1.0,10,0.1
348483502,4,6,4.0,10,0.4
348487242,2,8,2.0,10,0.2
348495360,12,16,12.0,28,0.42857142857142855
348497145,2,8,2.0,10,0.2
348533912,1,9,1.0,10,0.1
348549510,1,7,1.0,8,0.125
348550666,1,9,1.0,10,0.1
348563979,1,8,1.0,9,0.1111111111111111
348609332,1,8,1.0,9,0.1111111111111111
348611695,1,9,1.0,10,0.1
348621128,3,6,3.0,9,0.3333333333333333
348631297,7,3,3.0,10,0.3
348635770,1,9,1.0,10,0.1
348700170,3,7,3.0,10,0.3
348715424,5,5,5.0,10,0.5
348725597,9,1,1.0,10,0.1
348757289,8,1,1.0,9,0.1111111111111111
348758989,3,7,3.0,10,0.3
348759615,2,8,2.0,10,0.2
348768269,3,6,3.0,9,0.3333333333333333
348780116,2,6,2.0,8,0.25
348798935,8,2,2.0,10,0.2
348827475,3,6,3.0,9,0.3333333333333333
348829355,5,5,5.0,10,0.5
348853404,9,11,9.0,20,0.45
348881541,1,9,1.0,10,0.1
349028676,2,8,2.0,10,0.2
349029003,1,9,1.0,10,0.1
349030400,1,8,1.0,9,0.1111111111111111
349034823,2,8,2.0,10,0.2
349055029,25,4,4.0,29,0.13793103448275862
349057651,6,4,4.0,10,0.4
349062639,19,9,9.0,28,0.32142857142857145
349064077,7,3,3.0,10,0.3
349074241,1,7,1.0,8,0.125
349074556,5,5,5.0,10,0.5
349079661,2,7,2.0,9,0.2222222222222222
349135569,1,9,1.0,10,0.1
349138889,3,7,3.0,10,0.3
349152317,1,19,1.0,20,0.05
349153373,2,8,2.0,10,0.2
349154303,3,7,3.0,10,0.3
349164815,3,7,3.0,10,0.3
349166536,1,8,1.0,9,0.1111111111111111
349168134,2,7,2.0,9,0.2222222222222222
349191290,1,9,1.0,10,0.1
349205610,2,7,2.0,9,0.2222222222222222
349224948,1,9,1.0,10,0.1
349268178,1,9,1.0,10,0.1
349325417,2,8,2.0,10,0.2
349366607,1,17,1.0,18,0.05555555555555555
349382778,3,7,3.0,10,0.3
349390135,3,7,3.0,10,0.3
349478442,1,18,1.0,19,0.05263157894736842
349516076,1,7,1.0,8,0.125
349520106,7,3,3.0,10,0.3
349521253,1,9,1.0,10,0.1
349522741,1,9,1.0,10,0.1
349523810,3,7,3.0,10,0.3
349531053,8,2,2.0,10,0.2
349550955,4,5,4.0,9,0.4444444444444444
349555125,3,7,3.0,10,0.3
349568890,1,7,1.0,8,0.125
349591555,3,7,3.0,10,0.3
349600954,1,9,1.0,10,0.1
349613055,1,9,1.0,10,0.1
349618127,1,9,1.0,10,0.1
349677416,1,9,1.0,10,0.1
349741783,3,6,3.0,9,0.3333333333333333
349769224,9,1,1.0,10,0.1
349796348,1,8,1.0,9,0.1111111111111111
349812299,2,7,2.0,9,0.2222222222222222
349856228,3,7,3.0,10,0.3
349865105,1,9,1.0,10,0.1
349872453,1,18,1.0,19,0.05263157894736842
349904261,3,16,3.0,19,0.15789473684210525
349905554,3,6,3.0,9,0.3333333333333333
349913570,4,5,4.0,9,0.4444444444444444
349930926,3,6,3.0,9,0.3333333333333333
349945971,1,8,1.0,9,0.1111111111111111
349951913,2,7,2.0,9,0.2222222222222222
349990028,1,8,1.0,9,0.1111111111111111
350015831,1,8,1.0,9,0.1111111111111111
350054179,1,8,1.0,9,0.1111111111111111
350093962,2,6,2.0,8,0.25
350101051,3,7,3.0,10,0.3
350109333,1,19,1.0,20,0.05
350118025,7,3,3.0,10,0.3
350118581,5,4,4.0,9,0.4444444444444444
350131343,3,6,3.0,9,0.3333333333333333
350134125,1,27,1.0,28,0.03571428571428571
350150636,9,1,1.0,10,0.1
350185894,2,26,2.0,28,0.07142857142857142
350207675,2,7,2.0,9,0.2222222222222222
350226509,1,9,1.0,10,0.1
350232112,10,19,10.0,29,0.3448275862068966
350240149,3,7,3.0,10,0.3
350246349,7,2,2.0,9,0.2222222222222222
350270365,1,9,1.0,10,0.1
350272053,1,9,1.0,10,0.1
350300317,5,5,5.0,10,0.5
350300568,8,1,1.0,9,0.1111111111111111
350300989,7,2,2.0,9,0.2222222222222222
350301171,5,5,5.0,10,0.5
350336621,8,1,1.0,9,0.1111111111111111
350416629,2,8,2.0,10,0.2
350420528,1,9,1.0,10,0.1
350466449,21,6,6.0,27,0.2222222222222222
350475394,1,9,1.0,10,0.1
350504045,19,11,11.0,30,0.36666666666666664
350518148,1,9,1.0,10,0.1
350536004,1,9,1.0,10,0.1
350545058,1,9,1.0,10,0.1
350560749,15,5,5.0,20,0.25
350577662,9,1,1.0,10,0.1
350589460,1,9,1.0,10,0.1
350617652,6,2,2.0,8,0.25
350707793,1,18,1.0,19,0.05263157894736842
350718035,1,8,1.0,9,0.1111111111111111
350723824,1,8,1.0,9,0.1111111111111111
350788250,2,7,2.0,9,0.2222222222222222
350791410,1,9,1.0,10,0.1
350808074,3,7,3.0,10,0.3
350849516,3,7,3.0,10,0.3
350850070,4,6,4.0,10,0.4
350892926,6,3,3.0,9,0.3333333333333333
350893390,5,4,4.0,9,0.4444444444444444
350893761,7,2,2.0,9,0.2222222222222222
350899543,1,8,1.0,9,0.1111111111111111
350899617,7,2,2.0,9,0.2222222222222222
350916711,1,9,1.0,10,0.1
350927412,3,6,3.0,9,0.3333333333333333
350930075,1,9,1.0,10,0.1
350962451,1,16,1.0,17,0.058823529411764705
351007438,1,8,1.0,9,0.1111111111111111
351007758,9,1,1.0,10,0.1
351009033,4,26,4.0,30,0.13333333333333333
351049174,1,8,1.0,9,0.1111111111111111
351064978,6,4,4.0,10,0.4
351106179,1,9,1.0,10,0.1
351162645,3,6,3.0,9,0.3333333333333333
351170617,1,8,1.0,9,0.1111111111111111
351176058,5,5,5.0,10,0.5
351195562,1,9,1.0,10,0.1
351205793,2,8,2.0,10,0.2
351252625,5,3,3.0,8,0.375
351301843,8,1,1.0,9,0.1111111111111111
351302060,1,9,1.0,10,0.1
351306068,1,9,1.0,10,0.1
351320383,6,2,2.0,8,0.25
351341350,5,5,5.0,10,0.5
351342565,1,9,1.0,10,0.1
351350401,5,5,5.0,10,0.5
351367659,6,3,3.0,9,0.3333333333333333
351418394,6,2,2.0,8,0.25
351419122,2,7,2.0,9,0.2222222222222222
351419888,2,7,2.0,9,0.2222222222222222
351429042,2,18,2.0,20,0.1
351438353,6,4,4.0,10,0.4
351458431,7,2,2.0,9,0.2222222222222222
351460723,4,6,4.0,10,0.4
351464211,2,17,2.0,19,0.10526315789473684
351466871,1,9,1.0,10,0.1
351478001,3,6,3.0,9,0.3333333333333333
351493096,15,4,4.0,19,0.21052631578947367
351506532,1,9,1.0,10,0.1
351535445,5,5,5.0,10,0.5
351535603,2,8,2.0,10,0.2
351565254,1,8,1.0,9,0.1111111111111111
351567200,7,2,2.0,9,0.2222222222222222
351568568,5,3,3.0,8,0.375
351570666,5,5,5.0,10,0.5
351577012,1,8,1.0,9,0.1111111111111111
351578822,3,7,3.0,10,0.3
351579021,5,4,4.0,9,0.4444444444444444
351596249,1,18,1.0,19,0.05263157894736842
351609384,2,8,2.0,10,0.2
351616719,1,9,1.0,10,0.1
351626677,16,12,12.0,28,0.42857142857142855
351631405,2,8,2.0,10,0.2
351637286,2,8,2.0,10,0.2
351641667,8,2,2.0,10,0.2
351667510,4,6,4.0,10,0.4
351668470,1,9,1.0,10,0.1
351669818,7,3,3.0,10,0.3
351672089,9,1,1.0,10,0.1
351674697,4,5,4.0,9,0.4444444444444444
351680825,1,17,1.0,18,0.05555555555555555
351686996,1,9,1.0,10,0.1
351706940,2,8,2.0,10,0.2
351774436,2,8,2.0,10,0.2
351786040,4,6,4.0,10,0.4
351804479,2,8,2.0,10,0.2
351814769,2,7,2.0,9,0.2222222222222222
351823253,3,7,3.0,10,0.3
351845607,8,2,2.0,10,0.2
351885481,1,9,1.0,10,0.1
351890468,1,9,1.0,10,0.1
351900591,1,9,1.0,10,0.1
351903076,6,3,3.0,9,0.3333333333333333
351906979,3,7,3.0,10,0.3
351907564,3,6,3.0,9,0.3333333333333333
351910368,9,1,1.0,10,0.1
351911126,7,3,3.0,10,0.3
351930690,7,3,3.0,10,0.3
351945015,9,1,1.0,10,0.1
351948732,5,5,5.0,10,0.5
351949035,5,4,4.0,9,0.4444444444444444
351967864,1,9,1.0,10,0.1
351992329,7,1,1.0,8,0.125
352019167,1,18,1.0,19,0.05263157894736842
352020334,7,21,7.0,28,0.25
352024234,2,8,2.0,10,0.2
352025427,1,8,1.0,9,0.1111111111111111
352046279,5,5,5.0,10,0.5
352047671,5,5,5.0,10,0.5
352063715,6,4,4.0,10,0.4
352126511,1,9,1.0,10,0.1
352140975,2,8,2.0,10,0.2
352142830,3,5,3.0,8,0.375
352147348,2,8,2.0,10,0.2
352172434,1,8,1.0,9,0.1111111111111111
352173145,1,18,1.0,19,0.05263157894736842
352260312,5,4,4.0,9,0.4444444444444444
352292649,1,9,1.0,10,0.1
352304476,1,9,1.0,10,0.1
352330305,1,15,1.0,16,0.0625
352344495,3,7,3.0,10,0.3
352345171,1,9,1.0,10,0.1
352345723,1,9,1.0,10,0.1
352352943,1,8,1.0,9,0.1111111111111111
352383903,2,16,2.0,18,0.1111111111111111
352384630,2,27,2.0,29,0.06896551724137931
352433361,26,4,4.0,30,0.13333333333333333
352433461,9,1,1.0,10,0.1
352433544,8,1,1.0,9,0.1111111111111111
352433649,6,3,3.0,9,0.3333333333333333
352433807,5,5,5.0,10,0.5
352436201,28,2,2.0,30,0.06666666666666667
352473201,3,7,3.0,10,0.3
352476487,5,5,5.0,10,0.5
352492469,2,8,2.0,10,0.2
352514069,2,6,2.0,8,0.25
352521571,3,25,3.0,28,0.10714285714285714
352523661,1,9,1.0,10,0.1
352523718,4,5,4.0,9,0.4444444444444444
352524116,2,8,2.0,10,0.2
352524228,1,9,1.0,10,0.1
352525528,8,2,2.0,10,0.2
352558009,1,8,1.0,9,0.1111111111111111
352561877,2,8,2.0,10,0.2
352608180,1,19,1.0,20,0.05
352784371,4,4,4.0,8,0.5
352792500,4,13,4.0,17,0.23529411764705882
352797893,1,9,1.0,10,0.1
352805660,4,6,4.0,10,0.4
352852667,2,8,2.0,10,0.2
352853623,3,7,3.0,10,0.3
352855398,1,9,1.0,10,0.1
352858135,7,10,7.0,17,0.4117647058823529
352875273,3,7,3.0,10,0.3
352875847,1,18,1.0,19,0.05263157894736842
352891512,2,8,2.0,10,0.2
352906392,2,8,2.0,10,0.2
352913520,1,8,1.0,9,0.1111111111111111
352975919,3,7,3.0,10,0.3
352982504,26,2,2.0,28,0.07142857142857142
352983315,4,6,4.0,10,0.4
352988020,1,9,1.0,10,0.1
352989075,9,1,1.0,10,0.1
353037512,7,3,3.0,10,0.3
353048768,4,4,4.0,8,0.5
353048781,14,13,13.0,27,0.48148148148148145
353048815,3,7,3.0,10,0.3
353048820,4,6,4.0,10,0.4
353071227,2,7,2.0,9,0.2222222222222222
353071565,2,8,2.0,10,0.2
353075633,2,8,2.0,10,0.2
353130381,1,18,1.0,19,0.05263157894736842
353142977,8,2,2.0,10,0.2
353152893,7,3,3.0,10,0.3
353190868,4,6,4.0,10,0.4
353192723,1,17,1.0,18,0.05555555555555555
353212261,4,5,4.0,9,0.4444444444444444
353213503,1,8,1.0,9,0.1111111111111111
353247846,1,8,1.0,9,0.1111111111111111
353249978,6,4,4.0,10,0.4
353251783,2,8,2.0,10,0.2
353267520,3,7,3.0,10,0.3
353282358,2,8,2.0,10,0.2
353291825,18,12,12.0,30,0.4
353291925,1,8,1.0,9,0.1111111111111111
353308419,1,8,1.0,9,0.1111111111111111
353410573,2,8,2.0,10,0.2
353411582,1,7,1.0,8,0.125
353411730,3,5,3.0,8,0.375
353412440,8,22,8.0,30,0.26666666666666666
353416017,1,9,1.0,10,0.1
353420792,1,8,1.0,9,0.1111111111111111
353421254,1,8,1.0,9,0.1111111111111111
353423722,22,7,7.0,29,0.2413793103448276
353427676,5,4,4.0,9,0.4444444444444444
353429063,2,8,2.0,10,0.2
353429392,9,1,1.0,10,0.1
353429428,6,4,4.0,10,0.4
353429704,7,3,3.0,10,0.3
353434102,7,2,2.0,9,0.2222222222222222
353439393,6,4,4.0,10,0.4
353443335,2,8,2.0,10,0.2
353508153,5,4,4.0,9,0.4444444444444444
353564377,5,4,4.0,9,0.4444444444444444
353577462,2,8,2.0,10,0.2
353583623,3,6,3.0,9,0.3333333333333333
353590088,3,7,3.0,10,0.3
353590643,1,7,1.0,8,0.125
353592095,1,9,1.0,10,0.1
353595637,1,27,1.0,28,0.03571428571428571
353597841,3,5,3.0,8,0.375
353601646,1,9,1.0,10,0.1
353602290,1,18,1.0,19,0.05263157894736842
353620223,3,7,3.0,10,0.3
353659221,1,19,1.0,20,0.05
353659445,1,9,1.0,10,0.1
353680014,1,9,1.0,10,0.1
353680955,1,8,1.0,9,0.1111111111111111
353682189,4,6,4.0,10,0.4
353714150,1,9,1.0,10,0.1
353716964,6,4,4.0,10,0.4
353717295,8,21,8.0,29,0.27586206896551724
353723780,2,7,2.0,9,0.2222222222222222
353731894,24,5,5.0,29,0.1724137931034483
353739534,16,11,11.0,27,0.4074074074074074
353740983,4,5,4.0,9,0.4444444444444444
353741047,2,8,2.0,10,0.2
353750698,4,15,4.0,19,0.21052631578947367
353755294,9,1,1.0,10,0.1
353778477,1,9,1.0,10,0.1
353782718,1,7,1.0,8,0.125
353815500,4,15,4.0,19,0.21052631578947367
353825107,4,5,4.0,9,0.4444444444444444
353828621,4,5,4.0,9,0.4444444444444444
353829343,2,7,2.0,9,0.2222222222222222
353830009,3,7,3.0,10,0.3
353842888,2,7,2.0,9,0.2222222222222222
353843313,12,17,12.0,29,0.41379310344827586
353851648,1,17,1.0,18,0.05555555555555555
353861082,1,7,1.0,8,0.125
353862286,3,5,3.0,8,0.375
353867492,8,21,8.0,29,0.27586206896551724
353870825,1,19,1.0,20,0.05
353871577,1,9,1.0,10,0.1
353883046,26,4,4.0,30,0.13333333333333333
353898488,1,9,1.0,10,0.1
353956553,10,19,10.0,29,0.3448275862068966
353971442,9,1,1.0,10,0.1
353975604,1,9,1.0,10,0.1
354010288,1,9,1.0,10,0.1
354036581,9,1,1.0,10,0.1
354047938,1,9,1.0,10,0.1
354050160,2,8,2.0,10,0.2
354051103,5,5,5.0,10,0.5
354109128,1,9,1.0,10,0.1
354115354,1,8,1.0,9,0.1111111111111111
354129220,1,9,1.0,10,0.1
354201705,6,3,3.0,9,0.3333333333333333
354207036,2,27,2.0,29,0.06896551724137931
354207667,1,9,1.0,10,0.1
354210072,2,8,2.0,10,0.2
354231772,1,9,1.0,10,0.1
354272986,1,7,1.0,8,0.125
354277969,7,3,3.0,10,0.3
354279399,3,6,3.0,9,0.3333333333333333
354281260,2,7,2.0,9,0.2222222222222222
354292549,3,6,3.0,9,0.3333333333333333
354344732,4,6,4.0,10,0.4
354364104,2,17,2.0,19,0.10526315789473684
354369351,1,9,1.0,10,0.1
354384508,6,4,4.0,10,0.4
354417298,1,9,1.0,10,0.1
354424372,7,2,2.0,9,0.2222222222222222
354424648,4,26,4.0,30,0.13333333333333333
354443019,1,9,1.0,10,0.1
354446149,1,18,1.0,19,0.05263157894736842
354451436,8,2,2.0,10,0.2
354451836,4,6,4.0,10,0.4
354457918,2,7,2.0,9,0.2222222222222222
354470075,2,16,2.0,18,0.1111111111111111
354481252,8,2,2.0,10,0.2
354481451,8,2,2.0,10,0.2
354488948,1,9,1.0,10,0.1
354503247,8,2,2.0,10,0.2
354504741,1,8,1.0,9,0.1111111111111111
354529926,1,18,1.0,19,0.05263157894736842
354578199,6,4,4.0,10,0.4
354581474,1,18,1.0,19,0.05263157894736842
354612221,22,6,6.0,28,0.21428571428571427
354622380,4,5,4.0,9,0.4444444444444444
354628716,3,7,3.0,10,0.3
354633192,1,9,1.0,10,0.1
354634256,4,6,4.0,10,0.4
354635910,5,4,4.0,9,0.4444444444444444
354653903,1,9,1.0,10,0.1
354739537,1,8,1.0,9,0.1111111111111111
354753779,1,8,1.0,9,0.1111111111111111
354761663,6,13,6.0,19,0.3157894736842105
354762306,5,5,5.0,10,0.5
354770092,4,5,4.0,9,0.4444444444444444
354787235,6,4,4.0,10,0.4
354788583,1,9,1.0,10,0.1
354789962,2,18,2.0,20,0.1
354795348,8,1,1.0,9,0.1111111111111111
354799285,1,9,1.0,10,0.1
354808101,2,17,2.0,19,0.10526315789473684
354845147,1,9,1.0,10,0.1
354854216,3,7,3.0,10,0.3
354857388,1,9,1.0,10,0.1
354861027,6,4,4.0,10,0.4
354861311,3,7,3.0,10,0.3
354863912,1,9,1.0,10,0.1
354865734,6,4,4.0,10,0.4
354865941,1,8,1.0,9,0.1111111111111111
354868195,1,8,1.0,9,0.1111111111111111
354868412,8,1,1.0,9,0.1111111111111111
354883133,8,1,1.0,9,0.1111111111111111
354883785,2,8,2.0,10,0.2
354886090,3,6,3.0,9,0.3333333333333333
354929272,1,18,1.0,19,0.05263157894736842
354936362,1,18,1.0,19,0.05263157894736842
354939105,2,28,2.0,30,0.06666666666666667
354939977,1,7,1.0,8,0.125
354942105,5,4,4.0,9,0.4444444444444444
354942249,3,7,3.0,10,0.3
354944337,2,8,2.0,10,0.2
354962900,28,1,1.0,29,0.034482758620689655
354975794,9,1,1.0,10,0.1
355013827,1,8,1.0,9,0.1111111111111111
355027191,1,9,1.0,10,0.1
355042609,1,9,1.0,10,0.1
355052800,1,9,1.0,10,0.1
355055792,1,19,1.0,20,0.05
355069325,2,7,2.0,9,0.2222222222222222
355075642,1,8,1.0,9,0.1111111111111111
355090787,1,9,1.0,10,0.1
355096369,1,9,1.0,10,0.1
355106455,2,8,2.0,10,0.2
355125895,9,1,1.0,10,0.1
355221264,4,6,4.0,10,0.4
355222842,2,15,2.0,17,0.11764705882352941
355269865,3,5,3.0,8,0.375
355279566,4,16,4.0,20,0.2
355287444,1,7,1.0,8,0.125
355306660,5,5,5.0,10,0.5
355319924,2,18,2.0,20,0.1
355359379,2,7,2.0,9,0.2222222222222222
355422566,6,14,6.0,20,0.3
355468600,24,4,4.0,28,0.14285714285714285
355470947,4,6,4.0,10,0.4
355486229,6,3,3.0,9,0.3333333333333333
355486604,1,9,1.0,10,0.1
355487538,4,16,4.0,20,0.2
355506752,2,8,2.0,10,0.2
355574874,1,9,1.0,10,0.1
355594945,1,18,1.0,19,0.05263157894736842
355606499,2,7,2.0,9,0.2222222222222222
355636925,4,5,4.0,9,0.4444444444444444
355644736,28,1,1.0,29,0.034482758620689655
355652166,2,8,2.0,10,0.2
355653204,2,7,2.0,9,0.2222222222222222
355666232,2,7,2.0,9,0.2222222222222222
355669447,1,9,1.0,10,0.1
355671903,2,7,2.0,9,0.2222222222222222
355676273,1,18,1.0,19,0.05263157894736842
355681833,2,8,2.0,10,0.2
355693500,2,7,2.0,9,0.2222222222222222
355723588,5,4,4.0,9,0.4444444444444444
355738041,3,6,3.0,9,0.3333333333333333
355747515,1,18,1.0,19,0.05263157894736842
355758370,7,3,3.0,10,0.3
355762625,7,2,2.0,9,0.2222222222222222
355780286,1,9,1.0,10,0.1
355784871,2,7,2.0,9,0.2222222222222222
355830142,2,7,2.0,9,0.2222222222222222
355869275,7,12,7.0,19,0.3684210526315789
355908031,9,1,1.0,10,0.1
355939635,1,19,1.0,20,0.05
355969804,6,4,4.0,10,0.4
355971603,1,7,1.0,8,0.125
356009220,1,8,1.0,9,0.1111111111111111
356026467,5,25,5.0,30,0.16666666666666666
356048937,4,6,4.0,10,0.4
356053189,3,5,3.0,8,0.375
356063762,2,6,2.0,8,0.25
356066298,2,8,2.0,10,0.2
356088676,1,9,1.0,10,0.1
356089532,2,7,2.0,9,0.2222222222222222
356090979,1,19,1.0,20,0.05
356104509,11,18,11.0,29,0.3793103448275862
356107531,3,6,3.0,9,0.3333333333333333
356108087,1,19,1.0,20,0.05
356108275,1,9,1.0,10,0.1
356133274,1,8,1.0,9,0.1111111111111111
356138616,1,17,1.0,18,0.05555555555555555
356149310,3,7,3.0,10,0.3
356184554,5,5,5.0,10,0.5
356184795,3,7,3.0,10,0.3
356206657,2,8,2.0,10,0.2
356207065,2,7,2.0,9,0.2222222222222222
356222990,1,9,1.0,10,0.1
356225495,3,6,3.0,9,0.3333333333333333
356230435,1,17,1.0,18,0.05555555555555555
356242446,1,28,1.0,29,0.034482758620689655
356275561,6,3,3.0,9,0.3333333333333333
356282920,1,9,1.0,10,0.1
356309002,1,9,1.0,10,0.1
356314587,9,1,1.0,10,0.1
356314765,9,1,1.0,10,0.1
356391599,4,14,4.0,18,0.2222222222222222
356430268,2,17,2.0,19,0.10526315789473684
356460388,3,7,3.0,10,0.3
356489881,1,9,1.0,10,0.1
356491812,1,9,1.0,10,0.1
356556535,5,5,5.0,10,0.5
356580772,1,9,1.0,10,0.1
356584551,1,9,1.0,10,0.1
356587393,1,9,1.0,10,0.1
356601160,9,1,1.0,10,0.1
356602576,2,6,2.0,8,0.25
356604120,2,17,2.0,19,0.10526315789473684
356620493,2,7,2.0,9,0.2222222222222222
356626349,1,9,1.0,10,0.1
356626529,2,8,2.0,10,0.2
356643817,2,8,2.0,10,0.2
356650229,5,5,5.0,10,0.5
356650893,7,3,3.0,10,0.3
356705969,10,8,8.0,18,0.4444444444444444
356710719,2,8,2.0,10,0.2
356777376,5,5,5.0,10,0.5
356777935,2,8,2.0,10,0.2
356852906,4,5,4.0,9,0.4444444444444444
356865884,1,17,1.0,18,0.05555555555555555
356896934,3,7,3.0,10,0.3
356913300,21,8,8.0,29,0.27586206896551724
356918073,1,19,1.0,20,0.05
356928251,1,16,1.0,17,0.058823529411764705
356944187,1,9,1.0,10,0.1
356951665,1,8,1.0,9,0.1111111111111111
356959205,1,18,1.0,19,0.05263157894736842
356968992,5,5,5.0,10,0.5
356978387,1,9,1.0,10,0.1
356995942,1,9,1.0,10,0.1
357002976,2,8,2.0,10,0.2
357017959,1,8,1.0,9,0.1111111111111111
357025134,2,7,2.0,9,0.2222222222222222
357026180,2,8,2.0,10,0.2
357033834,3,7,3.0,10,0.3
357044462,5,4,4.0,9,0.4444444444444444
357047262,3,7,3.0,10,0.3
357047799,3,6,3.0,9,0.3333333333333333
357048095,1,9,1.0,10,0.1
357069554,2,8,2.0,10,0.2
357075644,1,9,1.0,10,0.1
357080468,3,7,3.0,10,0.3
357091676,8,1,1.0,9,0.1111111111111111
357094059,8,2,2.0,10,0.2
357130957,9,1,1.0,10,0.1
357139033,2,7,2.0,9,0.2222222222222222
357198632,7,3,3.0,10,0.3
357199881,1,9,1.0,10,0.1
357200135,1,28,1.0,29,0.034482758620689655
357200355,2,8,2.0,10,0.2
357201534,11,17,11.0,28,0.39285714285714285
357214002,3,7,3.0,10,0.3
357216068,8,2,2.0,10,0.2
357218722,2,6,2.0,8,0.25
357243546,2,8,2.0,10,0.2
357259555,6,3,3.0,9,0.3333333333333333
357302449,5,4,4.0,9,0.4444444444444444
357303493,1,8,1.0,9,0.1111111111111111
357304154,2,6,2.0,8,0.25
357313732,2,8,2.0,10,0.2
357319194,1,8,1.0,9,0.1111111111111111
357327166,1,9,1.0,10,0.1
357328444,1,9,1.0,10,0.1
357331602,1,9,1.0,10,0.1
357332404,1,7,1.0,8,0.125
357334251,1,9,1.0,10,0.1
357335467,9,19,9.0,28,0.32142857142857145
357384513,2,25,2.0,27,0.07407407407407407
357392255,2,8,2.0,10,0.2
357416250,2,7,2.0,9,0.2222222222222222
357451149,2,8,2.0,10,0.2
357508475,1,9,1.0,10,0.1
357512202,1,7,1.0,8,0.125
357590025,1,9,1.0,10,0.1
357651032,3,7,3.0,10,0.3
357658591,5,5,5.0,10,0.5
357666033,1,8,1.0,9,0.1111111111111111
357682551,1,8,1.0,9,0.1111111111111111
357692318,1,9,1.0,10,0.1
357735835,9,1,1.0,10,0.1
357736420,2,6,2.0,8,0.25
357737977,2,7,2.0,9,0.2222222222222222
357738443,3,6,3.0,9,0.3333333333333333
357738747,3,6,3.0,9,0.3333333333333333
357763874,2,8,2.0,10,0.2
357780413,1,9,1.0,10,0.1
357805283,2,6,2.0,8,0.25
357805976,4,6,4.0,10,0.4
357806228,5,5,5.0,10,0.5
357808515,8,1,1.0,9,0.1111111111111111
357810098,1,8,1.0,9,0.1111111111111111
357825872,1,19,1.0,20,0.05
357839024,2,8,2.0,10,0.2
357887945,1,19,1.0,20,0.05
357888363,1,7,1.0,8,0.125
357911237,1,18,1.0,19,0.05263157894736842
357930011,1,8,1.0,9,0.1111111111111111
357930141,9,1,1.0,10,0.1
357930431,6,3,3.0,9,0.3333333333333333
357948986,1,9,1.0,10,0.1
357966282,4,4,4.0,8,0.5
357987627,7,3,3.0,10,0.3
358026246,2,7,2.0,9,0.2222222222222222
358033635,1,19,1.0,20,0.05
358071541,8,2,2.0,10,0.2
358072152,2,8,2.0,10,0.2
358082695,5,5,5.0,10,0.5
358082983,8,2,2.0,10,0.2
358087733,1,9,1.0,10,0.1
358133117,5,4,4.0,9,0.4444444444444444
358134178,7,2,2.0,9,0.2222222222222222
358150395,2,7,2.0,9,0.2222222222222222
358157629,1,9,1.0,10,0.1
358157739,1,9,1.0,10,0.1
358158194,2,8,2.0,10,0.2
358209416,6,3,3.0,9,0.3333333333333333
358212145,3,6,3.0,9,0.3333333333333333
358220091,9,1,1.0,10,0.1
358222375,1,8,1.0,9,0.1111111111111111
358244175,1,9,1.0,10,0.1
358244557,7,2,2.0,9,0.2222222222222222
358246731,1,9,1.0,10,0.1
358257458,1,8,1.0,9,0.1111111111111111
358267544,1,7,1.0,8,0.125
358284419,5,4,4.0,9,0.4444444444444444
358326111,1,9,1.0,10,0.1
358349291,2,7,2.0,9,0.2222222222222222
358407960,4,5,4.0,9,0.4444444444444444
358466496,1,9,1.0,10,0.1
358466924,1,8,1.0,9,0.1111111111111111
358504833,3,7,3.0,10,0.3
358524308,1,9,1.0,10,0.1
358526204,6,4,4.0,10,0.4
358542716,5,5,5.0,10,0.5
358593661,17,12,12.0,29,0.41379310344827586
358601673,1,16,1.0,17,0.058823529411764705
358608908,2,7,2.0,9,0.2222222222222222
358613571,1,9,1.0,10,0.1
358616975,1,9,1.0,10,0.1
358702843,3,7,3.0,10,0.3
358712445,2,8,2.0,10,0.2
358719148,6,4,4.0,10,0.4
358721890,1,9,1.0,10,0.1
358738116,2,8,2.0,10,0.2
358738374,1,9,1.0,10,0.1
358743198,6,3,3.0,9,0.3333333333333333
358746864,4,6,4.0,10,0.4
358750062,3,17,3.0,20,0.15
358754848,2,7,2.0,9,0.2222222222222222
358756147,6,4,4.0,10,0.4
358786835,2,8,2.0,10,0.2
358790009,9,1,1.0,10,0.1
358790230,4,5,4.0,9,0.4444444444444444
358790554,7,3,3.0,10,0.3
358792774,1,8,1.0,9,0.1111111111111111
358801341,5,5,5.0,10,0.5
358828526,1,9,1.0,10,0.1
358839399,4,4,4.0,8,0.5
358846983,1,17,1.0,18,0.05555555555555555
358874576,1,9,1.0,10,0.1
358893025,2,7,2.0,9,0.2222222222222222
358899686,3,7,3.0,10,0.3
358910451,1,9,1.0,10,0.1
358922908,4,6,4.0,10,0.4
358927366,3,5,3.0,8,0.375
358947730,1,8,1.0,9,0.1111111111111111
358948968,1,9,1.0,10,0.1
358957054,1,8,1.0,9,0.1111111111111111
358982413,1,8,1.0,9,0.1111111111111111
358995250,6,3,3.0,9,0.3333333333333333
359071434,6,3,3.0,9,0.3333333333333333
359072536,9,1,1.0,10,0.1
359078740,7,3,3.0,10,0.3
359085781,5,5,5.0,10,0.5
359090963,1,9,1.0,10,0.1
359125884,3,7,3.0,10,0.3
359131907,2,8,2.0,10,0.2
359141278,2,8,2.0,10,0.2
359144341,1,9,1.0,10,0.1
359159056,3,6,3.0,9,0.3333333333333333
359161673,1,9,1.0,10,0.1
359169784,2,24,2.0,26,0.07692307692307693
359197214,2,7,2.0,9,0.2222222222222222
359204907,1,8,1.0,9,0.1111111111111111
359268182,1,15,1.0,16,0.0625
359291149,2,8,2.0,10,0.2
359299931,6,4,4.0,10,0.4
359307651,5,4,4.0,9,0.4444444444444444
359350449,5,5,5.0,10,0.5
359363374,5,4,4.0,9,0.4444444444444444
359363766,4,5,4.0,9,0.4444444444444444
359363917,5,3,3.0,8,0.375
359371409,5,4,4.0,9,0.4444444444444444
359378666,1,8,1.0,9,0.1111111111111111
359405098,5,5,5.0,10,0.5
359417386,5,5,5.0,10,0.5
359421644,1,8,1.0,9,0.1111111111111111
359433885,4,5,4.0,9,0.4444444444444444
359434586,1,8,1.0,9,0.1111111111111111
359436478,1,19,1.0,20,0.05
359438215,3,6,3.0,9,0.3333333333333333
359438286,2,26,2.0,28,0.07142857142857142
359457241,3,7,3.0,10,0.3
359464580,3,7,3.0,10,0.3
359470009,8,22,8.0,30,0.26666666666666666
359475647,3,7,3.0,10,0.3
359496328,1,9,1.0,10,0.1
359535000,1,8,1.0,9,0.1111111111111111
359571748,8,2,2.0,10,0.2
359607388,6,4,4.0,10,0.4
359610414,5,4,4.0,9,0.4444444444444444
359611501,3,6,3.0,9,0.3333333333333333
359613103,1,9,1.0,10,0.1
359613886,1,18,1.0,19,0.05263157894736842
359633129,2,17,2.0,19,0.10526315789473684
359640781,1,15,1.0,16,0.0625
359663009,1,8,1.0,9,0.1111111111111111
359683844,7,3,3.0,10,0.3
359714148,6,4,4.0,10,0.4
359714351,9,1,1.0,10,0.1
359717865,5,4,4.0,9,0.4444444444444444
359718343,1,8,1.0,9,0.1111111111111111
359748319,2,17,2.0,19,0.10526315789473684
359795383,1,9,1.0,10,0.1
359796002,3,6,3.0,9,0.3333333333333333
359798166,3,6,3.0,9,0.3333333333333333
359842314,8,2,2.0,10,0.2
359848283,9,1,1.0,10,0.1
359858334,1,9,1.0,10,0.1
359872366,3,7,3.0,10,0.3
359886535,4,6,4.0,10,0.4
359919551,1,7,1.0,8,0.125
359926005,1,8,1.0,9,0.1111111111111111
359939409,6,4,4.0,10,0.4
359940108,6,4,4.0,10,0.4
359940423,1,9,1.0,10,0.1
359942738,4,4,4.0,8,0.5
359943780,1,8,1.0,9,0.1111111111111111
359946457,5,5,5.0,10,0.5
359947909,1,8,1.0,9,0.1111111111111111
359949662,2,8,2.0,10,0.2
359958473,7,2,2.0,9,0.2222222222222222
359963134,5,24,5.0,29,0.1724137931034483
359963931,1,9,1.0,10,0.1
359974172,2,8,2.0,10,0.2
359976381,14,16,14.0,30,0.4666666666666667
359976897,1,9,1.0,10,0.1
359977597,1,9,1.0,10,0.1
359987594,9,1,1.0,10,0.1
359995318,5,4,4.0,9,0.4444444444444444
360027345,2,8,2.0,10,0.2
360027541,1,8,1.0,9,0.1111111111111111
360028576,2,8,2.0,10,0.2
360099682,1,9,1.0,10,0.1
360102346,1,8,1.0,9,0.1111111111111111
360109229,2,8,2.0,10,0.2
360122850,1,8,1.0,9,0.1111111111111111
360125295,7,12,7.0,19,0.3684210526315789
360157443,2,8,2.0,10,0.2
360174754,1,9,1.0,10,0.1
360261600,1,9,1.0,10,0.1
360312479,1,9,1.0,10,0.1
360387601,1,7,1.0,8,0.125
360388609,4,6,4.0,10,0.4
360390931,1,9,1.0,10,0.1
360399414,1,9,1.0,10,0.1
360435924,1,9,1.0,10,0.1
360436865,2,26,2.0,28,0.07142857142857142
360437051,1,9,1.0,10,0.1
360437677,4,6,4.0,10,0.4
360489246,2,17,2.0,19,0.10526315789473684
360498971,1,18,1.0,19,0.05263157894736842
360520330,5,3,3.0,8,0.375
360520972,7,3,3.0,10,0.3
360521261,4,5,4.0,9,0.4444444444444444
360521910,7,3,3.0,10,0.3
360534811,3,7,3.0,10,0.3
360572303,2,8,2.0,10,0.2
360576880,7,2,2.0,9,0.2222222222222222
360577302,4,6,4.0,10,0.4
360583429,1,9,1.0,10,0.1
360594419,9,1,1.0,10,0.1
360614030,2,7,2.0,9,0.2222222222222222
360660517,1,9,1.0,10,0.1
360668175,2,8,2.0,10,0.2
360668176,3,7,3.0,10,0.3
360672052,5,5,5.0,10,0.5
360675144,7,2,2.0,9,0.2222222222222222
360675934,8,2,2.0,10,0.2
360700289,1,28,1.0,29,0.034482758620689655
360724040,8,1,1.0,9,0.1111111111111111
360745473,5,5,5.0,10,0.5
360746839,1,9,1.0,10,0.1
360747455,7,3,3.0,10,0.3
360773758,9,1,1.0,10,0.1
360774791,7,2,2.0,9,0.2222222222222222
360775791,10,17,10.0,27,0.37037037037037035
360780064,1,7,1.0,8,0.125
360796635,1,16,1.0,17,0.058823529411764705
360797461,1,8,1.0,9,0.1111111111111111
360827360,1,8,1.0,9,0.1111111111111111
360830828,2,7,2.0,9,0.2222222222222222
360832532,5,5,5.0,10,0.5
360833845,9,1,1.0,10,0.1
360836624,1,9,1.0,10,0.1
360842838,8,1,1.0,9,0.1111111111111111
360844852,8,20,8.0,28,0.2857142857142857
360884677,3,7,3.0,10,0.3
360894742,4,5,4.0,9,0.4444444444444444
360915404,9,1,1.0,10,0.1
360915870,4,25,4.0,29,0.13793103448275862
360932525,1,8,1.0,9,0.1111111111111111
360938148,1,9,1.0,10,0.1
360949063,14,12,12.0,26,0.46153846153846156
360952211,1,9,1.0,10,0.1
361018287,1,9,1.0,10,0.1
361019102,1,9,1.0,10,0.1
361047472,2,8,2.0,10,0.2
361061722,5,5,5.0,10,0.5
361091194,5,13,5.0,18,0.2777777777777778
361105406,1,8,1.0,9,0.1111111111111111
361111698,2,8,2.0,10,0.2
361115229,1,8,1.0,9,0.1111111111111111
361138753,1,9,1.0,10,0.1
361166244,7,2,2.0,9,0.2222222222222222
361166334,2,8,2.0,10,0.2
361195691,1,9,1.0,10,0.1
361216538,1,8,1.0,9,0.1111111111111111
361221174,1,8,1.0,9,0.1111111111111111
361245794,1,9,1.0,10,0.1
361268936,22,3,3.0,25,0.12
361302382,4,25,4.0,29,0.13793103448275862
361309450,1,9,1.0,10,0.1
361317794,1,8,1.0,9,0.1111111111111111
361371187,6,4,4.0,10,0.4
361391165,1,9,1.0,10,0.1
361438580,1,8,1.0,9,0.1111111111111111
361438843,4,6,4.0,10,0.4
361444249,5,15,5.0,20,0.25
361444609,2,8,2.0,10,0.2
361467454,2,8,2.0,10,0.2
361470714,7,2,2.0,9,0.2222222222222222
361479430,1,7,1.0,8,0.125
361526160,3,16,3.0,19,0.15789473684210525
361527429,1,8,1.0,9,0.1111111111111111
361605184,1,9,1.0,10,0.1
361618013,4,5,4.0,9,0.4444444444444444
361618613,3,5,3.0,8,0.375
361618706,6,4,4.0,10,0.4
361635642,1,9,1.0,10,0.1
361638422,3,6,3.0,9,0.3333333333333333
361664492,3,25,3.0,28,0.10714285714285714
361673137,3,7,3.0,10,0.3
361673874,3,5,3.0,8,0.375
361680953,1,9,1.0,10,0.1
361693053,2,7,2.0,9,0.2222222222222222
361704593,9,1,1.0,10,0.1
361719917,3,7,3.0,10,0.3
361720573,2,8,2.0,10,0.2
361753211,1,8,1.0,9,0.1111111111111111
361762267,1,18,1.0,19,0.05263157894736842
361765467,17,8,8.0,25,0.32
361779038,2,7,2.0,9,0.2222222222222222
361781531,2,8,2.0,10,0.2
361792723,8,2,2.0,10,0.2
361804288,1,9,1.0,10,0.1
361804385,8,1,1.0,9,0.1111111111111111
361811471,4,6,4.0,10,0.4
361812703,1,9,1.0,10,0.1
361915173,3,7,3.0,10,0.3
361915468,1,16,1.0,17,0.058823529411764705
361938941,1,9,1.0,10,0.1
361943936,2,8,2.0,10,0.2
361956677,1,9,1.0,10,0.1
361997877,1,9,1.0,10,0.1
361998353,6,3,3.0,9,0.3333333333333333
361999961,7,3,3.0,10,0.3
362004854,1,9,1.0,10,0.1
362012565,5,5,5.0,10,0.5
362023856,1,8,1.0,9,0.1111111111111111
362026426,1,8,1.0,9,0.1111111111111111
362048527,11,9,9.0,20,0.45
362073687,6,4,4.0,10,0.4
362074677,3,5,3.0,8,0.375
362087282,2,7,2.0,9,0.2222222222222222
362113052,2,8,2.0,10,0.2
362115220,6,4,4.0,10,0.4
362116828,8,2,2.0,10,0.2
362118441,1,8,1.0,9,0.1111111111111111
362124102,4,6,4.0,10,0.4
362126092,5,5,5.0,10,0.5
362136707,6,4,4.0,10,0.4
362137791,4,6,4.0,10,0.4
362138222,4,5,4.0,9,0.4444444444444444
362138697,1,9,1.0,10,0.1
362155705,2,8,2.0,10,0.2
362157870,3,7,3.0,10,0.3
362158922,8,1,1.0,9,0.1111111111111111
362159472,7,10,7.0,17,0.4117647058823529
362159613,8,2,2.0,10,0.2
362159981,8,2,2.0,10,0.2
362160547,8,1,1.0,9,0.1111111111111111
362160736,21,8,8.0,29,0.27586206896551724
362160805,9,1,1.0,10,0.1
362181619,3,6,3.0,9,0.3333333333333333
362282870,1,9,1.0,10,0.1
362333135,2,7,2.0,9,0.2222222222222222
362356554,7,2,2.0,9,0.2222222222222222
362357683,1,7,1.0,8,0.125
362359234,1,8,1.0,9,0.1111111111111111
362368161,1,9,1.0,10,0.1
362374833,1,16,1.0,17,0.058823529411764705
362470779,2,8,2.0,10,0.2
362490731,9,1,1.0,10,0.1
362555402,2,7,2.0,9,0.2222222222222222
362570976,1,19,1.0,20,0.05
362597762,1,9,1.0,10,0.1
362598105,1,9,1.0,10,0.1
362623239,3,6,3.0,9,0.3333333333333333
362630682,2,7,2.0,9,0.2222222222222222
362635629,1,19,1.0,20,0.05
362667460,2,8,2.0,10,0.2
362686577,5,5,5.0,10,0.5
362687364,1,9,1.0,10,0.1
362699988,3,7,3.0,10,0.3
362710754,2,8,2.0,10,0.2
362717427,1,19,1.0,20,0.05
362736833,1,9,1.0,10,0.1
362739560,6,4,4.0,10,0.4
362741245,9,1,1.0,10,0.1
362741833,5,5,5.0,10,0.5
362747334,1,8,1.0,9,0.1111111111111111
362760129,1,7,1.0,8,0.125
362762408,1,25,1.0,26,0.038461538461538464
362771836,7,19,7.0,26,0.2692307692307692
362774426,6,4,4.0,10,0.4
362779208,1,9,1.0,10,0.1
362817034,2,7,2.0,9,0.2222222222222222
362824505,7,3,3.0,10,0.3
362838785,7,2,2.0,9,0.2222222222222222
362841629,1,8,1.0,9,0.1111111111111111
362847254,8,1,1.0,9,0.1111111111111111
362847848,2,8,2.0,10,0.2
362882627,2,16,2.0,18,0.1111111111111111
362903690,5,5,5.0,10,0.5
362908814,5,5,5.0,10,0.5
362908927,24,6,6.0,30,0.2
362909065,7,3,3.0,10,0.3
362970991,2,8,2.0,10,0.2
362985790,2,18,2.0,20,0.1
362990985,1,19,1.0,20,0.05
363000697,1,7,1.0,8,0.125
363022531,2,18,2.0,20,0.1
363026051,1,9,1.0,10,0.1
363033228,1,8,1.0,9,0.1111111111111111
363044928,2,27,2.0,29,0.06896551724137931
363048482,1,8,1.0,9,0.1111111111111111
363052938,1,19,1.0,20,0.05
363053742,4,5,4.0,9,0.4444444444444444
363164602,2,8,2.0,10,0.2
363165022,6,4,4.0,10,0.4
363183611,7,3,3.0,10,0.3
363184093,8,2,2.0,10,0.2
363188213,5,3,3.0,8,0.375
363234936,2,8,2.0,10,0.2
363238501,2,6,2.0,8,0.25
363247735,2,17,2.0,19,0.10526315789473684
363248716,1,17,1.0,18,0.05555555555555555
363248926,2,27,2.0,29,0.06896551724137931
363252739,1,8,1.0,9,0.1111111111111111
363252993,1,8,1.0,9,0.1111111111111111
363254496,3,7,3.0,10,0.3
363256542,7,2,2.0,9,0.2222222222222222
363269206,3,7,3.0,10,0.3
363271330,2,7,2.0,9,0.2222222222222222
363279864,2,17,2.0,19,0.10526315789473684
363292501,3,7,3.0,10,0.3
363294431,2,7,2.0,9,0.2222222222222222
363298619,7,12,7.0,19,0.3684210526315789
363304827,2,8,2.0,10,0.2
363379905,3,5,3.0,8,0.375
363400018,9,1,1.0,10,0.1
363406473,1,9,1.0,10,0.1
363442167,2,6,2.0,8,0.25
363442957,1,9,1.0,10,0.1
363499340,7,3,3.0,10,0.3
363499927,27,2,2.0,29,0.06896551724137931
363499995,7,2,2.0,9,0.2222222222222222
363540155,4,5,4.0,9,0.4444444444444444
363542223,2,8,2.0,10,0.2
363542316,7,3,3.0,10,0.3
363542617,7,2,2.0,9,0.2222222222222222
363543354,19,7,7.0,26,0.2692307692307692
363543472,9,1,1.0,10,0.1
363570555,1,9,1.0,10,0.1
363580148,1,9,1.0,10,0.1
363587686,2,8,2.0,10,0.2
363597680,3,7,3.0,10,0.3
363606771,4,25,4.0,29,0.13793103448275862
363607948,4,6,4.0,10,0.4
363610331,1,8,1.0,9,0.1111111111111111
363611380,3,7,3.0,10,0.3
363624817,2,6,2.0,8,0.25
363643601,7,2,2.0,9,0.2222222222222222
363647026,2,7,2.0,9,0.2222222222222222
363685876,8,2,2.0,10,0.2
363688365,5,4,4.0,9,0.4444444444444444
363735431,1,9,1.0,10,0.1
363741118,6,4,4.0,10,0.4
363744859,6,4,4.0,10,0.4
363763440,1,9,1.0,10,0.1
363765956,3,7,3.0,10,0.3
363776200,1,9,1.0,10,0.1
363776985,3,6,3.0,9,0.3333333333333333
363782403,1,9,1.0,10,0.1
363802406,13,16,13.0,29,0.4482758620689655
363804187,1,8,1.0,9,0.1111111111111111
363805176,7,3,3.0,10,0.3
363809183,4,6,4.0,10,0.4
363812714,1,8,1.0,9,0.1111111111111111
363814048,3,6,3.0,9,0.3333333333333333
363821529,1,9,1.0,10,0.1
363839407,2,8,2.0,10,0.2
363840042,3,7,3.0,10,0.3
363852083,1,7,1.0,8,0.125
363858317,1,9,1.0,10,0.1
363928926,1,9,1.0,10,0.1
363940933,2,8,2.0,10,0.2
363969146,4,6,4.0,10,0.4
363970358,1,9,1.0,10,0.1
363971090,1,7,1.0,8,0.125
363972008,16,11,11.0,27,0.4074074074074074
363972952,14,12,12.0,26,0.46153846153846156
363978087,7,20,7.0,27,0.25925925925925924
363984154,1,8,1.0,9,0.1111111111111111
363987967,2,8,2.0,10,0.2
363998130,2,8,2.0,10,0.2
364003701,1,8,1.0,9,0.1111111111111111
364007205,6,13,6.0,19,0.3157894736842105
364008394,1,9,1.0,10,0.1
364045362,4,15,4.0,19,0.21052631578947367
364076604,1,9,1.0,10,0.1
364079705,2,18,2.0,20,0.1
364083376,2,6,2.0,8,0.25
364085331,1,19,1.0,20,0.05
364100960,1,8,1.0,9,0.1111111111111111
364124690,1,8,1.0,9,0.1111111111111111
364136369,2,14,2.0,16,0.125
364145924,1,9,1.0,10,0.1
364146247,1,9,1.0,10,0.1
364148071,4,15,4.0,19,0.21052631578947367
364152947,1,18,1.0,19,0.05263157894736842
364154532,2,27,2.0,29,0.06896551724137931
364159183,25,2,2.0,27,0.07407407407407407
364189935,2,7,2.0,9,0.2222222222222222
364220342,6,4,4.0,10,0.4
364264243,1,9,1.0,10,0.1
364264780,1,8,1.0,9,0.1111111111111111
364268936,1,9,1.0,10,0.1
364271281,1,9,1.0,10,0.1
364271362,1,9,1.0,10,0.1
364271626,2,8,2.0,10,0.2
364286550,9,19,9.0,28,0.32142857142857145
364287097,4,6,4.0,10,0.4
364291767,5,4,4.0,9,0.4444444444444444
364327768,1,28,1.0,29,0.034482758620689655
364330408,8,2,2.0,10,0.2
364356012,1,9,1.0,10,0.1
364361061,1,8,1.0,9,0.1111111111111111
364400657,5,5,5.0,10,0.5
364401389,3,7,3.0,10,0.3
364403321,1,7,1.0,8,0.125
364418863,4,6,4.0,10,0.4
364419994,5,4,4.0,9,0.4444444444444444
364436412,4,6,4.0,10,0.4
364437701,1,9,1.0,10,0.1
364437917,4,5,4.0,9,0.4444444444444444
364438252,7,3,3.0,10,0.3
364453019,1,28,1.0,29,0.034482758620689655
364462421,2,8,2.0,10,0.2
364463419,7,3,3.0,10,0.3
364464837,1,9,1.0,10,0.1
364484031,1,16,1.0,17,0.058823529411764705
364485752,1,9,1.0,10,0.1
364486310,1,8,1.0,9,0.1111111111111111
364497322,2,8,2.0,10,0.2
364502258,2,8,2.0,10,0.2
364517005,2,8,2.0,10,0.2
364518071,4,6,4.0,10,0.4
364524538,1,9,1.0,10,0.1
364539627,1,8,1.0,9,0.1111111111111111
364541866,1,16,1.0,17,0.058823529411764705
364544884,5,4,4.0,9,0.4444444444444444
364547005,3,24,3.0,27,0.1111111111111111
364547287,1,19,1.0,20,0.05
364551028,3,6,3.0,9,0.3333333333333333
364563932,1,16,1.0,17,0.058823529411764705
364565644,1,9,1.0,10,0.1
364590713,7,23,7.0,30,0.23333333333333334
364594778,5,14,5.0,19,0.2631578947368421
364623520,2,7,2.0,9,0.2222222222222222
364649973,1,19,1.0,20,0.05
364653857,1,19,1.0,20,0.05
364716319,12,17,12.0,29,0.41379310344827586
364716680,1,8,1.0,9,0.1111111111111111
364717043,4,6,4.0,10,0.4
364718191,1,9,1.0,10,0.1
364740966,2,28,2.0,30,0.06666666666666667
364758609,9,1,1.0,10,0.1
364765664,2,8,2.0,10,0.2
364770724,2,8,2.0,10,0.2
364775938,6,4,4.0,10,0.4
364810641,8,2,2.0,10,0.2
364825380,1,9,1.0,10,0.1
364831961,2,8,2.0,10,0.2
364864622,1,8,1.0,9,0.1111111111111111
364864783,3,14,3.0,17,0.17647058823529413
364917948,6,13,6.0,19,0.3157894736842105
364921157,9,20,9.0,29,0.3103448275862069
364923852,3,5,3.0,8,0.375
364924417,6,4,4.0,10,0.4
364930958,24,4,4.0,28,0.14285714285714285
364946469,2,8,2.0,10,0.2
364951570,4,6,4.0,10,0.4
364954779,6,3,3.0,9,0.3333333333333333
364958455,1,9,1.0,10,0.1
364988178,1,18,1.0,19,0.05263157894736842
365015807,1,15,1.0,16,0.0625
365056888,4,6,4.0,10,0.4
365071202,1,9,1.0,10,0.1
365142040,1,18,1.0,19,0.05263157894736842
365166850,2,8,2.0,10,0.2
365174783,1,7,1.0,8,0.125
365191180,2,24,2.0,26,0.07692307692307693
365201113,1,29,1.0,30,0.03333333333333333
365201920,2,8,2.0,10,0.2
365202455,7,2,2.0,9,0.2222222222222222
365216766,9,1,1.0,10,0.1
365246542,1,19,1.0,20,0.05
365275541,8,20,8.0,28,0.2857142857142857
365306848,6,19,6.0,25,0.24
365340427,3,6,3.0,9,0.3333333333333333
365340914,5,5,5.0,10,0.5
365341181,8,2,2.0,10,0.2
365341365,9,1,1.0,10,0.1
365349566,1,19,1.0,20,0.05
365418998,1,7,1.0,8,0.125
365422299,4,6,4.0,10,0.4
365432609,2,8,2.0,10,0.2
365442218,1,9,1.0,10,0.1
365461510,9,1,1.0,10,0.1
365472877,6,3,3.0,9,0.3333333333333333
365473163,3,15,3.0,18,0.16666666666666666
365521747,2,7,2.0,9,0.2222222222222222
365543441,24,5,5.0,29,0.1724137931034483
365543954,25,4,4.0,29,0.13793103448275862
365544591,2,7,2.0,9,0.2222222222222222
365578947,3,7,3.0,10,0.3
365624170,5,5,5.0,10,0.5
365626845,1,8,1.0,9,0.1111111111111111
365628450,5,4,4.0,9,0.4444444444444444
365630448,5,5,5.0,10,0.5
365633539,2,8,2.0,10,0.2
365638220,4,6,4.0,10,0.4
365641304,5,4,4.0,9,0.4444444444444444
365643012,2,6,2.0,8,0.25
365701405,1,9,1.0,10,0.1
365702443,23,5,5.0,28,0.17857142857142858
365715747,13,6,6.0,19,0.3157894736842105
365736490,2,8,2.0,10,0.2
365737766,7,11,7.0,18,0.3888888888888889
365755530,9,1,1.0,10,0.1
365756295,1,9,1.0,10,0.1
365764845,1,9,1.0,10,0.1
365786086,1,9,1.0,10,0.1
365840478,1,18,1.0,19,0.05263157894736842
365934505,1,8,1.0,9,0.1111111111111111
365934713,1,8,1.0,9,0.1111111111111111
365948203,7,22,7.0,29,0.2413793103448276
365957062,1,8,1.0,9,0.1111111111111111
366043888,1,8,1.0,9,0.1111111111111111
366044191,1,8,1.0,9,0.1111111111111111
366053939,4,6,4.0,10,0.4
366093713,1,9,1.0,10,0.1
366094128,2,8,2.0,10,0.2
366099242,1,9,1.0,10,0.1
366107329,1,9,1.0,10,0.1
366109599,4,6,4.0,10,0.4
366156403,1,9,1.0,10,0.1
366177772,2,8,2.0,10,0.2
366179089,3,16,3.0,19,0.15789473684210525
366197360,1,8,1.0,9,0.1111111111111111
366198958,1,17,1.0,18,0.05555555555555555
366228255,1,8,1.0,9,0.1111111111111111
366231488,2,27,2.0,29,0.06896551724137931
366331413,3,16,3.0,19,0.15789473684210525
366333963,7,3,3.0,10,0.3
366334523,4,5,4.0,9,0.4444444444444444
366335487,5,5,5.0,10,0.5
366336312,2,8,2.0,10,0.2
366392754,3,7,3.0,10,0.3
366394909,5,5,5.0,10,0.5
366405863,2,26,2.0,28,0.07142857142857142
366406161,1,9,1.0,10,0.1
366406842,2,8,2.0,10,0.2
366408003,6,4,4.0,10,0.4
366417872,1,7,1.0,8,0.125
366436280,4,5,4.0,9,0.4444444444444444
366437229,25,4,4.0,29,0.13793103448275862
366437990,4,6,4.0,10,0.4
366438704,4,23,4.0,27,0.14814814814814814
366464585,2,8,2.0,10,0.2
366481239,1,9,1.0,10,0.1
366595195,1,18,1.0,19,0.05263157894736842
366597585,2,8,2.0,10,0.2
366607564,1,9,1.0,10,0.1
366610698,1,9,1.0,10,0.1
366617025,2,8,2.0,10,0.2
366622379,1,9,1.0,10,0.1
366668600,2,17,2.0,19,0.10526315789473684
366671527,3,6,3.0,9,0.3333333333333333
366672347,5,5,5.0,10,0.5
366703174,1,8,1.0,9,0.1111111111111111
366715044,2,8,2.0,10,0.2
366715269,3,6,3.0,9,0.3333333333333333
366724805,5,5,5.0,10,0.5
366730216,8,1,1.0,9,0.1111111111111111
366735751,1,8,1.0,9,0.1111111111111111
366795249,3,7,3.0,10,0.3
366799040,1,7,1.0,8,0.125
366815190,1,8,1.0,9,0.1111111111111111
366822863,1,9,1.0,10,0.1
366826386,3,5,3.0,8,0.375
366851078,1,8,1.0,9,0.1111111111111111
366883272,1,9,1.0,10,0.1
366885308,1,8,1.0,9,0.1111111111111111
366892905,7,2,2.0,9,0.2222222222222222
366912479,5,3,3.0,8,0.375
366929672,4,16,4.0,20,0.2
366930804,18,1,1.0,19,0.05263157894736842
366931171,6,2,2.0,8,0.25
366931364,8,2,2.0,10,0.2
366950529,1,8,1.0,9,0.1111111111111111
366991510,6,4,4.0,10,0.4
367050122,1,7,1.0,8,0.125
367057561,1,9,1.0,10,0.1
367060440,2,6,2.0,8,0.25
367129894,4,4,4.0,8,0.5
367139055,5,4,4.0,9,0.4444444444444444
367140169,1,9,1.0,10,0.1
367155280,1,9,1.0,10,0.1
367155412,4,6,4.0,10,0.4
367158961,8,2,2.0,10,0.2
367178677,1,16,1.0,17,0.058823529411764705
367202297,16,12,12.0,28,0.42857142857142855
367204751,3,6,3.0,9,0.3333333333333333
367276060,2,16,2.0,18,0.1111111111111111
367295904,25,3,3.0,28,0.10714285714285714
367304547,6,24,6.0,30,0.2
367364300,2,8,2.0,10,0.2
367406305,8,2,2.0,10,0.2
367407501,5,5,5.0,10,0.5
367409031,1,8,1.0,9,0.1111111111111111
367413435,4,5,4.0,9,0.4444444444444444
367417287,6,4,4.0,10,0.4
367425243,1,8,1.0,9,0.1111111111111111
367430647,1,8,1.0,9,0.1111111111111111
367431396,1,8,1.0,9,0.1111111111111111
367445211,1,8,1.0,9,0.1111111111111111
367446265,1,8,1.0,9,0.1111111111111111
367462256,7,3,3.0,10,0.3
367462431,3,7,3.0,10,0.3
367486206,2,7,2.0,9,0.2222222222222222
367495583,1,9,1.0,10,0.1
367499803,16,12,12.0,28,0.42857142857142855
367505059,3,7,3.0,10,0.3
367508778,8,2,2.0,10,0.2
367516226,16,14,14.0,30,0.4666666666666667
367517311,5,5,5.0,10,0.5
367539241,1,8,1.0,9,0.1111111111111111
367555382,4,6,4.0,10,0.4
367582083,7,3,3.0,10,0.3
367593084,3,6,3.0,9,0.3333333333333333
367600081,8,2,2.0,10,0.2
367600181,8,1,1.0,9,0.1111111111111111
367613824,5,4,4.0,9,0.4444444444444444
367642442,1,7,1.0,8,0.125
367645214,1,9,1.0,10,0.1
367647736,3,7,3.0,10,0.3
367664360,3,5,3.0,8,0.375
367672856,1,9,1.0,10,0.1
367675076,1,18,1.0,19,0.05263157894736842
367678856,1,8,1.0,9,0.1111111111111111
367718846,1,8,1.0,9,0.1111111111111111
367742144,4,5,4.0,9,0.4444444444444444
367742263,1,29,1.0,30,0.03333333333333333
367770764,15,13,13.0,28,0.4642857142857143
367773013,2,16,2.0,18,0.1111111111111111
367929795,3,6,3.0,9,0.3333333333333333
367930085,2,7,2.0,9,0.2222222222222222
367996338,1,9,1.0,10,0.1
368011230,2,8,2.0,10,0.2
368017822,2,7,2.0,9,0.2222222222222222
368027192,1,9,1.0,10,0.1
368046233,1,9,1.0,10,0.1
368048600,8,22,8.0,30,0.26666666666666666
368051038,9,1,1.0,10,0.1
368052369,3,6,3.0,9,0.3333333333333333
368058813,1,8,1.0,9,0.1111111111111111
368083048,4,4,4.0,8,0.5
368104105,3,6,3.0,9,0.3333333333333333
368114744,4,6,4.0,10,0.4
368142784,2,8,2.0,10,0.2
368146841,7,22,7.0,29,0.2413793103448276
368183452,1,17,1.0,18,0.05555555555555555
368202302,2,8,2.0,10,0.2
368221254,1,19,1.0,20,0.05
368226165,1,9,1.0,10,0.1
368234502,2,8,2.0,10,0.2
368239377,2,7,2.0,9,0.2222222222222222
368240115,1,9,1.0,10,0.1
368240515,1,19,1.0,20,0.05
368250027,3,7,3.0,10,0.3
368252269,1,18,1.0,19,0.05263157894736842
368270591,6,12,6.0,18,0.3333333333333333
368287478,4,13,4.0,17,0.23529411764705882
368307120,4,6,4.0,10,0.4
368326080,1,19,1.0,20,0.05
368331936,1,9,1.0,10,0.1
368379580,2,7,2.0,9,0.2222222222222222
368394055,1,7,1.0,8,0.125
368400273,2,17,2.0,19,0.10526315789473684
368405668,4,5,4.0,9,0.4444444444444444
368413564,2,7,2.0,9,0.2222222222222222
368427559,7,3,3.0,10,0.3
368427725,6,4,4.0,10,0.4
368480053,2,18,2.0,20,0.1
368495233,1,16,1.0,17,0.058823529411764705
368514776,2,8,2.0,10,0.2
368516753,1,8,1.0,9,0.1111111111111111
368519004,1,9,1.0,10,0.1
368521983,3,6,3.0,9,0.3333333333333333
368560549,1,19,1.0,20,0.05
368576584,5,5,5.0,10,0.5
368585688,2,18,2.0,20,0.1
368591176,1,17,1.0,18,0.05555555555555555
368597357,1,9,1.0,10,0.1
368679560,3,6,3.0,9,0.3333333333333333
368686958,26,3,3.0,29,0.10344827586206896
368690261,14,6,6.0,20,0.3
368690451,1,8,1.0,9,0.1111111111111111
368694402,3,6,3.0,9,0.3333333333333333
368695128,1,9,1.0,10,0.1
368715180,1,9,1.0,10,0.1
368724426,2,8,2.0,10,0.2
368759362,1,7,1.0,8,0.125
368759782,3,7,3.0,10,0.3
368791451,1,8,1.0,9,0.1111111111111111
368801671,1,27,1.0,28,0.03571428571428571
368806397,2,7,2.0,9,0.2222222222222222
368807802,1,9,1.0,10,0.1
368812963,5,4,4.0,9,0.4444444444444444
368814776,3,7,3.0,10,0.3
368827898,9,1,1.0,10,0.1
368870019,1,9,1.0,10,0.1
368877645,1,9,1.0,10,0.1
368881786,1,9,1.0,10,0.1
368883181,9,1,1.0,10,0.1
368883373,1,8,1.0,9,0.1111111111111111
368887538,3,7,3.0,10,0.3
368900033,4,26,4.0,30,0.13333333333333333
368909905,2,7,2.0,9,0.2222222222222222
368913895,8,1,1.0,9,0.1111111111111111
368943124,2,17,2.0,19,0.10526315789473684
368963543,1,8,1.0,9,0.1111111111111111
368966341,1,7,1.0,8,0.125
369010035,3,7,3.0,10,0.3
369023189,1,9,1.0,10,0.1
369120668,27,1,1.0,28,0.03571428571428571
369130079,1,9,1.0,10,0.1
369130186,1,9,1.0,10,0.1
369131287,1,19,1.0,20,0.05
369153440,9,1,1.0,10,0.1
369153649,1,9,1.0,10,0.1
369158858,8,2,2.0,10,0.2
369217612,7,1,1.0,8,0.125
369233523,1,9,1.0,10,0.1
369283095,2,8,2.0,10,0.2
369286380,1,8,1.0,9,0.1111111111111111
369327614,2,8,2.0,10,0.2
369361735,5,13,5.0,18,0.2777777777777778
369405123,1,8,1.0,9,0.1111111111111111
369412056,9,1,1.0,10,0.1
369414018,6,2,2.0,8,0.25
369455645,12,5,5.0,17,0.29411764705882354
369456503,4,5,4.0,9,0.4444444444444444
369457996,2,17,2.0,19,0.10526315789473684
369471522,6,4,4.0,10,0.4
369492276,6,3,3.0,9,0.3333333333333333
369501960,1,9,1.0,10,0.1
369542677,9,1,1.0,10,0.1
369559970,4,14,4.0,18,0.2222222222222222
369612546,7,3,3.0,10,0.3
369624396,6,4,4.0,10,0.4
369625250,1,18,1.0,19,0.05263157894736842
369635939,1,8,1.0,9,0.1111111111111111
369635945,2,7,2.0,9,0.2222222222222222
369641006,1,8,1.0,9,0.1111111111111111
369641377,2,8,2.0,10,0.2
369664557,2,8,2.0,10,0.2
369669911,3,7,3.0,10,0.3
369673444,1,7,1.0,8,0.125
369697059,1,8,1.0,9,0.1111111111111111
369709107,8,19,8.0,27,0.2962962962962963
369709943,3,25,3.0,28,0.10714285714285714
369710379,3,6,3.0,9,0.3333333333333333
369740922,1,28,1.0,29,0.034482758620689655
369749974,1,9,1.0,10,0.1
369784426,1,18,1.0,19,0.05263157894736842
369805548,1,7,1.0,8,0.125
369812901,3,7,3.0,10,0.3
369814938,1,7,1.0,8,0.125
369817270,2,25,2.0,27,0.07407407407407407
369818314,7,3,3.0,10,0.3
369824763,3,7,3.0,10,0.3
369833629,1,18,1.0,19,0.05263157894736842
369846006,3,5,3.0,8,0.375
369846192,7,1,1.0,8,0.125
369893012,4,5,4.0,9,0.4444444444444444
369893693,1,9,1.0,10,0.1
369896461,1,9,1.0,10,0.1
369923941,2,17,2.0,19,0.10526315789473684
369940847,1,9,1.0,10,0.1
369942292,5,5,5.0,10,0.5
369945773,3,24,3.0,27,0.1111111111111111
369949818,1,18,1.0,19,0.05263157894736842
369963775,1,9,1.0,10,0.1
369971221,3,22,3.0,25,0.12
369971680,9,1,1.0,10,0.1
369972041,5,3,3.0,8,0.375
369977110,1,7,1.0,8,0.125
369987922,2,18,2.0,20,0.1
369989891,1,9,1.0,10,0.1
369992183,1,9,1.0,10,0.1
370001331,1,8,1.0,9,0.1111111111111111
370002358,18,10,10.0,28,0.35714285714285715
370004346,1,9,1.0,10,0.1
370004916,5,23,5.0,28,0.17857142857142858
370018012,1,8,1.0,9,0.1111111111111111
370042365,4,6,4.0,10,0.4
370054886,2,18,2.0,20,0.1
370055948,5,15,5.0,20,0.25
370056491,4,4,4.0,8,0.5
370056668,3,7,3.0,10,0.3
370057038,1,9,1.0,10,0.1
370072016,3,6,3.0,9,0.3333333333333333
370123736,15,11,11.0,26,0.4230769230769231
370127472,3,16,3.0,19,0.15789473684210525
370149865,4,6,4.0,10,0.4
370172018,6,3,3.0,9,0.3333333333333333
370173361,4,6,4.0,10,0.4
370213417,1,9,1.0,10,0.1
370257081,7,21,7.0,28,0.25
370264490,3,16,3.0,19,0.15789473684210525
370316758,1,8,1.0,9,0.1111111111111111
370350698,1,9,1.0,10,0.1
370526076,1,8,1.0,9,0.1111111111111111
370542153,1,8,1.0,9,0.1111111111111111
370547905,6,4,4.0,10,0.4
370548282,6,4,4.0,10,0.4
370548420,1,8,1.0,9,0.1111111111111111
370554462,4,6,4.0,10,0.4
370568875,1,9,1.0,10,0.1
370585862,6,23,6.0,29,0.20689655172413793
370599624,2,18,2.0,20,0.1
370615555,1,8,1.0,9,0.1111111111111111
370663331,1,18,1.0,19,0.05263157894736842
370676074,1,18,1.0,19,0.05263157894736842
370691408,4,6,4.0,10,0.4
370706886,9,1,1.0,10,0.1
370723585,1,9,1.0,10,0.1
370824809,2,7,2.0,9,0.2222222222222222
370827155,2,24,2.0,26,0.07692307692307693
370828211,5,5,5.0,10,0.5
370828354,9,1,1.0,10,0.1
370829357,7,3,3.0,10,0.3
370833230,6,4,4.0,10,0.4
370848423,9,1,1.0,10,0.1
370864060,1,8,1.0,9,0.1111111111111111
370867995,2,8,2.0,10,0.2
370868909,1,8,1.0,9,0.1111111111111111
370877339,3,13,3.0,16,0.1875
371026435,2,7,2.0,9,0.2222222222222222
371030796,2,7,2.0,9,0.2222222222222222
371031191,3,5,3.0,8,0.375
371035484,3,7,3.0,10,0.3
371035536,1,9,1.0,10,0.1
371040934,1,8,1.0,9,0.1111111111111111
371090608,7,13,7.0,20,0.35
371092072,3,7,3.0,10,0.3
371094943,1,18,1.0,19,0.05263157894736842
371097386,3,6,3.0,9,0.3333333333333333
371105019,3,7,3.0,10,0.3
371112597,3,7,3.0,10,0.3
371112860,16,12,12.0,28,0.42857142857142855
371118088,1,9,1.0,10,0.1
371129105,2,8,2.0,10,0.2
371216631,1,9,1.0,10,0.1
371226800,2,8,2.0,10,0.2
371256000,6,4,4.0,10,0.4
371275754,3,7,3.0,10,0.3
371277229,3,7,3.0,10,0.3
371280147,1,9,1.0,10,0.1
371280475,5,5,5.0,10,0.5
371280782,1,9,1.0,10,0.1
371280867,12,16,12.0,28,0.42857142857142855
371290538,2,8,2.0,10,0.2
371290795,1,9,1.0,10,0.1
371298273,1,9,1.0,10,0.1
371319875,5,5,5.0,10,0.5
371380695,5,15,5.0,20,0.25
371403728,1,7,1.0,8,0.125
371415763,1,9,1.0,10,0.1
371443806,3,7,3.0,10,0.3
371464574,6,4,4.0,10,0.4
371517633,1,9,1.0,10,0.1
371519761,6,4,4.0,10,0.4
371520695,2,7,2.0,9,0.2222222222222222
371534517,1,9,1.0,10,0.1
371538742,1,8,1.0,9,0.1111111111111111
371614783,1,8,1.0,9,0.1111111111111111
371615101,5,4,4.0,9,0.4444444444444444
371626208,2,8,2.0,10,0.2
371627332,1,9,1.0,10,0.1
371635393,2,8,2.0,10,0.2
371639727,2,8,2.0,10,0.2
371684861,1,9,1.0,10,0.1
371695372,1,18,1.0,19,0.05263157894736842
371723943,1,9,1.0,10,0.1
371728668,2,27,2.0,29,0.06896551724137931
371776751,2,16,2.0,18,0.1111111111111111
371820142,1,9,1.0,10,0.1
371869947,2,8,2.0,10,0.2
371870526,3,7,3.0,10,0.3
371882680,2,7,2.0,9,0.2222222222222222
371915250,1,19,1.0,20,0.05
371985198,3,6,3.0,9,0.3333333333333333
372023345,2,8,2.0,10,0.2
372024461,1,9,1.0,10,0.1
372026307,18,12,12.0,30,0.4
372029115,4,6,4.0,10,0.4
372030297,1,8,1.0,9,0.1111111111111111
372036266,5,4,4.0,9,0.4444444444444444
372036398,1,9,1.0,10,0.1
372056868,9,1,1.0,10,0.1
372061114,1,9,1.0,10,0.1
372062379,6,4,4.0,10,0.4
372063398,2,8,2.0,10,0.2
372076161,1,9,1.0,10,0.1
372135851,4,4,4.0,8,0.5
372138894,4,6,4.0,10,0.4
372144759,7,2,2.0,9,0.2222222222222222
372150936,1,18,1.0,19,0.05263157894736842
372177512,1,9,1.0,10,0.1
372198279,1,7,1.0,8,0.125
372199219,1,9,1.0,10,0.1
372199748,5,14,5.0,19,0.2631578947368421
372201564,1,19,1.0,20,0.05
372203634,1,8,1.0,9,0.1111111111111111
372214702,7,3,3.0,10,0.3
372216017,2,8,2.0,10,0.2
372220095,3,6,3.0,9,0.3333333333333333
372241838,1,8,1.0,9,0.1111111111111111
372243420,1,9,1.0,10,0.1
372244906,3,6,3.0,9,0.3333333333333333
372246995,1,19,1.0,20,0.05
372251515,1,8,1.0,9,0.1111111111111111
372251704,1,8,1.0,9,0.1111111111111111
372257095,1,9,1.0,10,0.1
372257927,1,9,1.0,10,0.1
372268048,1,7,1.0,8,0.125
372297700,1,9,1.0,10,0.1
372301038,1,9,1.0,10,0.1
372302887,5,5,5.0,10,0.5
372326152,3,7,3.0,10,0.3
372333591,2,23,2.0,25,0.08
372334585,2,8,2.0,10,0.2
372334651,2,8,2.0,10,0.2
372335731,1,9,1.0,10,0.1
372343519,1,9,1.0,10,0.1
372389089,2,27,2.0,29,0.06896551724137931
372408089,2,16,2.0,18,0.1111111111111111
372414027,1,19,1.0,20,0.05
372414396,4,6,4.0,10,0.4
372427205,1,8,1.0,9,0.1111111111111111
372446607,1,8,1.0,9,0.1111111111111111
372446819,3,6,3.0,9,0.3333333333333333
372451977,1,8,1.0,9,0.1111111111111111
372477876,7,2,2.0,9,0.2222222222222222
372490892,8,2,2.0,10,0.2
372491007,6,4,4.0,10,0.4
372495957,8,2,2.0,10,0.2
372496162,3,7,3.0,10,0.3
372496360,7,2,2.0,9,0.2222222222222222
372496787,2,7,2.0,9,0.2222222222222222
372496962,1,9,1.0,10,0.1
372516347,16,13,13.0,29,0.4482758620689655
372518596,1,8,1.0,9,0.1111111111111111
372519606,4,4,4.0,8,0.5
372543211,2,8,2.0,10,0.2
372544734,2,7,2.0,9,0.2222222222222222
372545404,4,6,4.0,10,0.4
372558274,4,5,4.0,9,0.4444444444444444
372564212,1,8,1.0,9,0.1111111111111111
372566105,1,9,1.0,10,0.1
372617813,2,8,2.0,10,0.2
372617967,2,8,2.0,10,0.2
372621652,6,12,6.0,18,0.3333333333333333
372622482,1,8,1.0,9,0.1111111111111111
372625357,1,9,1.0,10,0.1
372625460,1,8,1.0,9,0.1111111111111111
372633049,1,7,1.0,8,0.125
372641266,1,19,1.0,20,0.05
372678800,2,7,2.0,9,0.2222222222222222
372689310,4,6,4.0,10,0.4
372691276,1,9,1.0,10,0.1
372755822,6,4,4.0,10,0.4
372757582,2,18,2.0,20,0.1
372759544,1,7,1.0,8,0.125
372777762,3,7,3.0,10,0.3
372811785,1,9,1.0,10,0.1
372821517,1,16,1.0,17,0.058823529411764705
372822304,15,13,13.0,28,0.4642857142857143
372823006,2,7,2.0,9,0.2222222222222222
372823125,1,7,1.0,8,0.125
372823372,2,6,2.0,8,0.25
372825582,3,7,3.0,10,0.3
372830591,8,2,2.0,10,0.2
372832526,2,7,2.0,9,0.2222222222222222
372832930,2,7,2.0,9,0.2222222222222222
372904721,1,9,1.0,10,0.1
372923728,1,8,1.0,9,0.1111111111111111
372927738,1,9,1.0,10,0.1
372934146,2,8,2.0,10,0.2
372946443,1,9,1.0,10,0.1
372964579,9,1,1.0,10,0.1
372995651,1,9,1.0,10,0.1
372997147,1,9,1.0,10,0.1
373008997,7,2,2.0,9,0.2222222222222222
373023586,1,7,1.0,8,0.125
373029268,3,7,3.0,10,0.3
373030996,1,9,1.0,10,0.1
373031736,1,9,1.0,10,0.1
373033403,6,12,6.0,18,0.3333333333333333
373047811,9,1,1.0,10,0.1
373049263,5,5,5.0,10,0.5
373049384,4,6,4.0,10,0.4
373071002,1,9,1.0,10,0.1
373081014,2,24,2.0,26,0.07692307692307693
373090536,1,7,1.0,8,0.125
373099296,1,8,1.0,9,0.1111111111111111
373122653,2,8,2.0,10,0.2
373125851,1,9,1.0,10,0.1
373129653,2,8,2.0,10,0.2
373167952,1,8,1.0,9,0.1111111111111111
373168872,6,22,6.0,28,0.21428571428571427
373274043,1,9,1.0,10,0.1
373291952,1,7,1.0,8,0.125
373294039,4,5,4.0,9,0.4444444444444444
373296560,1,9,1.0,10,0.1
373302273,2,17,2.0,19,0.10526315789473684
373309206,1,8,1.0,9,0.1111111111111111
373344044,8,2,2.0,10,0.2
373359830,2,8,2.0,10,0.2
373378598,2,8,2.0,10,0.2
373402684,1,9,1.0,10,0.1
373405972,2,7,2.0,9,0.2222222222222222
373422718,2,26,2.0,28,0.07142857142857142
373439485,1,9,1.0,10,0.1
373470512,1,17,1.0,18,0.05555555555555555
373493641,4,5,4.0,9,0.4444444444444444
373500342,6,4,4.0,10,0.4
373501278,4,5,4.0,9,0.4444444444444444
373501728,2,7,2.0,9,0.2222222222222222
373504772,3,26,3.0,29,0.10344827586206896
373504777,1,9,1.0,10,0.1
373514166,1,9,1.0,10,0.1
373517230,3,6,3.0,9,0.3333333333333333
373544329,1,9,1.0,10,0.1
373560800,1,7,1.0,8,0.125
373569937,8,2,2.0,10,0.2
373570023,17,12,12.0,29,0.41379310344827586
373574621,1,9,1.0,10,0.1
373577839,1,9,1.0,10,0.1
373581837,2,7,2.0,9,0.2222222222222222
373582485,2,7,2.0,9,0.2222222222222222
373617078,8,2,2.0,10,0.2
373617216,7,21,7.0,28,0.25
373617378,1,9,1.0,10,0.1
373637852,1,9,1.0,10,0.1
373646724,25,2,2.0,27,0.07407407407407407
373664689,2,18,2.0,20,0.1
373674981,8,2,2.0,10,0.2
373675310,3,6,3.0,9,0.3333333333333333
373675828,5,5,5.0,10,0.5
373676046,3,6,3.0,9,0.3333333333333333
373676253,22,3,3.0,25,0.12
373676805,3,7,3.0,10,0.3
373677303,5,5,5.0,10,0.5
373678838,1,9,1.0,10,0.1
373680639,2,8,2.0,10,0.2
373683146,1,9,1.0,10,0.1
373683574,1,9,1.0,10,0.1
373684835,1,8,1.0,9,0.1111111111111111
373684889,2,7,2.0,9,0.2222222222222222
373688652,2,8,2.0,10,0.2
373740148,1,9,1.0,10,0.1
373783184,1,8,1.0,9,0.1111111111111111
373785051,3,7,3.0,10,0.3
373795004,6,14,6.0,20,0.3
373797309,2,26,2.0,28,0.07142857142857142
373801814,1,8,1.0,9,0.1111111111111111
373804691,3,6,3.0,9,0.3333333333333333
373809043,1,9,1.0,10,0.1
373835750,1,9,1.0,10,0.1
373858573,1,9,1.0,10,0.1
373876416,1,8,1.0,9,0.1111111111111111
373879026,2,18,2.0,20,0.1
373888175,1,9,1.0,10,0.1
373889025,3,6,3.0,9,0.3333333333333333
373890401,8,2,2.0,10,0.2
373899763,2,6,2.0,8,0.25
373909854,2,7,2.0,9,0.2222222222222222
373912051,1,18,1.0,19,0.05263157894736842
373950936,2,7,2.0,9,0.2222222222222222
373956846,5,3,3.0,8,0.375
373957352,7,3,3.0,10,0.3
373980039,7,3,3.0,10,0.3
373983291,6,3,3.0,9,0.3333333333333333
373984410,1,19,1.0,20,0.05
373999082,2,8,2.0,10,0.2
374034473,2,8,2.0,10,0.2
374035641,8,1,1.0,9,0.1111111111111111
374036385,3,7,3.0,10,0.3
374037483,2,8,2.0,10,0.2
374041274,4,15,4.0,19,0.21052631578947367
374045802,7,3,3.0,10,0.3
374046116,2,18,2.0,20,0.1
374046967,1,7,1.0,8,0.125
374047325,6,3,3.0,9,0.3333333333333333
374053725,8,1,1.0,9,0.1111111111111111
374056999,1,9,1.0,10,0.1
374062541,1,8,1.0,9,0.1111111111111111
374065009,3,7,3.0,10,0.3
374070228,2,8,2.0,10,0.2
374072422,1,9,1.0,10,0.1
374084479,1,9,1.0,10,0.1
374085245,1,8,1.0,9,0.1111111111111111
374086468,1,9,1.0,10,0.1
374093586,1,9,1.0,10,0.1
374119370,1,18,1.0,19,0.05263157894736842
374120397,5,5,5.0,10,0.5
374120590,6,2,2.0,8,0.25
374132202,4,23,4.0,27,0.14814814814814814
374147861,9,1,1.0,10,0.1
374148324,7,3,3.0,10,0.3
374169693,1,9,1.0,10,0.1
374197508,4,15,4.0,19,0.21052631578947367
374211987,1,9,1.0,10,0.1
374214251,1,9,1.0,10,0.1
374214546,3,7,3.0,10,0.3
374217506,26,4,4.0,30,0.13333333333333333
374233691,2,8,2.0,10,0.2
374234672,1,7,1.0,8,0.125
374234878,7,3,3.0,10,0.3
374235044,3,7,3.0,10,0.3
374235208,4,6,4.0,10,0.4
374238093,1,9,1.0,10,0.1
374243747,5,5,5.0,10,0.5
374247565,1,9,1.0,10,0.1
374273629,6,3,3.0,9,0.3333333333333333
374277061,3,7,3.0,10,0.3
374290815,1,8,1.0,9,0.1111111111111111
374292101,2,7,2.0,9,0.2222222222222222
374292466,5,5,5.0,10,0.5
374293258,2,8,2.0,10,0.2
374294155,2,8,2.0,10,0.2
374294250,6,4,4.0,10,0.4
374299653,1,9,1.0,10,0.1
374312521,1,9,1.0,10,0.1
374318273,2,8,2.0,10,0.2
374322561,4,25,4.0,29,0.13793103448275862
374322791,1,8,1.0,9,0.1111111111111111
374325009,1,9,1.0,10,0.1
374326758,3,7,3.0,10,0.3
374352515,1,28,1.0,29,0.034482758620689655
374370360,1,9,1.0,10,0.1
374372308,1,8,1.0,9,0.1111111111111111
374385869,3,16,3.0,19,0.15789473684210525
374398217,1,18,1.0,19,0.05263157894736842
374398991,1,9,1.0,10,0.1
374399425,2,7,2.0,9,0.2222222222222222
374408751,8,2,2.0,10,0.2
374410767,5,24,5.0,29,0.1724137931034483
374414382,1,9,1.0,10,0.1
374417049,1,9,1.0,10,0.1
374455153,2,7,2.0,9,0.2222222222222222
374460573,22,5,5.0,27,0.18518518518518517
374460756,1,9,1.0,10,0.1
374472471,1,8,1.0,9,0.1111111111111111
374473203,2,8,2.0,10,0.2
374498624,5,14,5.0,19,0.2631578947368421
374523078,5,15,5.0,20,0.25
374555362,4,5,4.0,9,0.4444444444444444
374572281,1,28,1.0,29,0.034482758620689655
374572928,9,1,1.0,10,0.1
374574299,1,9,1.0,10,0.1
374585067,3,7,3.0,10,0.3
374586311,1,9,1.0,10,0.1
374590990,1,8,1.0,9,0.1111111111111111
374594760,8,2,2.0,10,0.2
374625551,2,28,2.0,30,0.06666666666666667
374662444,1,8,1.0,9,0.1111111111111111
374689067,3,7,3.0,10,0.3
374693929,6,4,4.0,10,0.4
374719856,1,8,1.0,9,0.1111111111111111
374732366,1,8,1.0,9,0.1111111111111111
374758484,8,2,2.0,10,0.2
374759416,24,5,5.0,29,0.1724137931034483
374766030,3,6,3.0,9,0.3333333333333333
374767559,2,7,2.0,9,0.2222222222222222
374778356,1,18,1.0,19,0.05263157894736842
374780777,1,9,1.0,10,0.1
374800609,5,5,5.0,10,0.5
374919154,1,19,1.0,20,0.05
374957933,2,16,2.0,18,0.1111111111111111
374982891,2,8,2.0,10,0.2
374983469,7,3,3.0,10,0.3
374983999,4,6,4.0,10,0.4
374995620,1,9,1.0,10,0.1
375049453,1,8,1.0,9,0.1111111111111111
375065922,5,5,5.0,10,0.5
375082629,8,1,1.0,9,0.1111111111111111
375083320,9,1,1.0,10,0.1
375090661,2,8,2.0,10,0.2
375113862,1,7,1.0,8,0.125
375117365,1,9,1.0,10,0.1
375157867,8,1,1.0,9,0.1111111111111111
375190336,1,8,1.0,9,0.1111111111111111
375193826,8,2,2.0,10,0.2
375245473,2,8,2.0,10,0.2
375245527,5,5,5.0,10,0.5
375245721,2,7,2.0,9,0.2222222222222222
375245804,4,6,4.0,10,0.4
375245882,5,5,5.0,10,0.5
375252446,3,6,3.0,9,0.3333333333333333
375267075,1,8,1.0,9,0.1111111111111111
375273440,5,23,5.0,28,0.17857142857142858
375273664,5,24,5.0,29,0.1724137931034483
375276005,6,23,6.0,29,0.20689655172413793
375279961,1,8,1.0,9,0.1111111111111111
375317122,1,9,1.0,10,0.1
375317678,4,4,4.0,8,0.5
375345642,2,8,2.0,10,0.2
375369059,4,5,4.0,9,0.4444444444444444
375369671,2,7,2.0,9,0.2222222222222222
375373743,2,26,2.0,28,0.07142857142857142
375384340,1,9,1.0,10,0.1
375447134,3,16,3.0,19,0.15789473684210525
375455821,6,4,4.0,10,0.4
375457005,2,8,2.0,10,0.2
375471123,1,19,1.0,20,0.05
375480892,1,18,1.0,19,0.05263157894736842
375537453,2,8,2.0,10,0.2
375559555,2,8,2.0,10,0.2
375600354,11,16,11.0,27,0.4074074074074074
375600650,4,6,4.0,10,0.4
375603340,1,8,1.0,9,0.1111111111111111
375625364,1,9,1.0,10,0.1
375648821,2,8,2.0,10,0.2
375651796,13,15,13.0,28,0.4642857142857143
375651883,6,4,4.0,10,0.4
375659814,1,18,1.0,19,0.05263157894736842
375677340,2,18,2.0,20,0.1
375678103,2,8,2.0,10,0.2
375745414,1,9,1.0,10,0.1
375760638,4,23,4.0,27,0.14814814814814814
375784975,1,8,1.0,9,0.1111111111111111
375787520,7,1,1.0,8,0.125
375791831,8,2,2.0,10,0.2
375798859,1,7,1.0,8,0.125
375823164,2,6,2.0,8,0.25
375823440,1,9,1.0,10,0.1
375830793,1,8,1.0,9,0.1111111111111111
375830855,8,1,1.0,9,0.1111111111111111
375906226,1,8,1.0,9,0.1111111111111111
375919722,8,2,2.0,10,0.2
375926782,4,4,4.0,8,0.5
375976573,1,8,1.0,9,0.1111111111111111
375983818,1,19,1.0,20,0.05
375991859,6,2,2.0,8,0.25
375993162,27,3,3.0,30,0.1
375996867,1,8,1.0,9,0.1111111111111111
376074219,8,2,2.0,10,0.2
376111052,1,8,1.0,9,0.1111111111111111
376147204,3,7,3.0,10,0.3
376164843,6,4,4.0,10,0.4
376189331,6,4,4.0,10,0.4
376218492,1,9,1.0,10,0.1
376222359,1,8,1.0,9,0.1111111111111111
376271870,1,9,1.0,10,0.1
376273682,4,6,4.0,10,0.4
376285774,1,19,1.0,20,0.05
376300568,1,7,1.0,8,0.125
376321431,3,6,3.0,9,0.3333333333333333
376327123,8,11,8.0,19,0.42105263157894735
376330683,5,5,5.0,10,0.5
376353417,1,19,1.0,20,0.05
376359027,3,7,3.0,10,0.3
376368074,2,8,2.0,10,0.2
376385700,1,9,1.0,10,0.1
376385741,9,1,1.0,10,0.1
376409025,7,3,3.0,10,0.3
376409552,2,8,2.0,10,0.2
376409692,4,6,4.0,10,0.4
376429206,11,15,11.0,26,0.4230769230769231
376429688,1,8,1.0,9,0.1111111111111111
376434277,1,9,1.0,10,0.1
376454309,2,7,2.0,9,0.2222222222222222
376468166,3,7,3.0,10,0.3
376468743,2,8,2.0,10,0.2
376474556,9,1,1.0,10,0.1
376485839,4,6,4.0,10,0.4
376492882,1,9,1.0,10,0.1
376495563,1,7,1.0,8,0.125
376498924,1,9,1.0,10,0.1
376501042,1,17,1.0,18,0.05555555555555555
376522823,1,8,1.0,9,0.1111111111111111
376529771,2,8,2.0,10,0.2
376531111,2,6,2.0,8,0.25
376537522,9,1,1.0,10,0.1
376545427,2,7,2.0,9,0.2222222222222222
376567626,7,3,3.0,10,0.3
376586722,6,4,4.0,10,0.4
376605400,1,8,1.0,9,0.1111111111111111
376658952,1,19,1.0,20,0.05
376677141,2,16,2.0,18,0.1111111111111111
376680926,1,9,1.0,10,0.1
376692491,1,8,1.0,9,0.1111111111111111
376693962,1,9,1.0,10,0.1
376705652,2,17,2.0,19,0.10526315789473684
376713354,3,6,3.0,9,0.3333333333333333
376740005,1,8,1.0,9,0.1111111111111111
376741417,1,9,1.0,10,0.1
376743879,5,25,5.0,30,0.16666666666666666
376744435,4,6,4.0,10,0.4
376765596,1,7,1.0,8,0.125
376777347,3,7,3.0,10,0.3
376806923,5,24,5.0,29,0.1724137931034483
376810450,1,9,1.0,10,0.1
376847717,4,15,4.0,19,0.21052631578947367
376853014,5,14,5.0,19,0.2631578947368421
376858469,1,8,1.0,9,0.1111111111111111
376869028,1,8,1.0,9,0.1111111111111111
376886367,5,14,5.0,19,0.2631578947368421
376907334,1,9,1.0,10,0.1
376954935,1,16,1.0,17,0.058823529411764705
376960268,6,3,3.0,9,0.3333333333333333
376961883,1,9,1.0,10,0.1
376963360,1,9,1.0,10,0.1
376972453,9,1,1.0,10,0.1
376996709,29,1,1.0,30,0.03333333333333333
376997375,1,19,1.0,20,0.05
377019774,1,19,1.0,20,0.05
377020246,1,9,1.0,10,0.1
377027785,9,1,1.0,10,0.1
377041336,5,5,5.0,10,0.5
377042097,2,7,2.0,9,0.2222222222222222
377042364,7,3,3.0,10,0.3
377064677,1,9,1.0,10,0.1
377066744,9,1,1.0,10,0.1
377095463,10,10,10.0,20,0.5
377126615,3,7,3.0,10,0.3
377139282,4,14,4.0,18,0.2222222222222222
377141006,3,6,3.0,9,0.3333333333333333
377143049,7,3,3.0,10,0.3
377146396,8,2,2.0,10,0.2
377146526,1,9,1.0,10,0.1
377152594,5,5,5.0,10,0.5
377154219,1,9,1.0,10,0.1
377196066,26,3,3.0,29,0.10344827586206896
377236279,4,6,4.0,10,0.4
377254896,1,9,1.0,10,0.1
377257164,1,9,1.0,10,0.1
377323201,5,4,4.0,9,0.4444444444444444
377323443,6,3,3.0,9,0.3333333333333333
377323573,6,2,2.0,8,0.25
377323748,17,10,10.0,27,0.37037037037037035
377325951,6,4,4.0,10,0.4
377326428,4,6,4.0,10,0.4
377326715,1,19,1.0,20,0.05
377327540,1,9,1.0,10,0.1
377330495,4,14,4.0,18,0.2222222222222222
377369409,9,1,1.0,10,0.1
377371879,7,3,3.0,10,0.3
377375357,7,3,3.0,10,0.3
377375669,3,7,3.0,10,0.3
377389086,3,7,3.0,10,0.3
377405092,5,3,3.0,8,0.375
377414283,2,8,2.0,10,0.2
377414759,1,18,1.0,19,0.05263157894736842
377436515,1,9,1.0,10,0.1
377449234,1,9,1.0,10,0.1
377451094,1,9,1.0,10,0.1
377459663,2,8,2.0,10,0.2
377479995,1,9,1.0,10,0.1
377480133,14,16,14.0,30,0.4666666666666667
377480361,1,9,1.0,10,0.1
377481425,1,8,1.0,9,0.1111111111111111
377481701,4,6,4.0,10,0.4
377491718,2,7,2.0,9,0.2222222222222222
377492237,4,5,4.0,9,0.4444444444444444
377492304,4,5,4.0,9,0.4444444444444444
377492541,1,9,1.0,10,0.1
377494562,3,7,3.0,10,0.3
377528979,1,17,1.0,18,0.05555555555555555
377532900,1,9,1.0,10,0.1
377554746,5,23,5.0,28,0.17857142857142858
377575635,2,7,2.0,9,0.2222222222222222
377603491,2,7,2.0,9,0.2222222222222222
377609282,3,5,3.0,8,0.375
377609321,6,4,4.0,10,0.4
377694722,12,14,12.0,26,0.46153846153846156
377694727,5,3,3.0,8,0.375
377823173,1,9,1.0,10,0.1
377824590,1,19,1.0,20,0.05
377830506,1,8,1.0,9,0.1111111111111111
377836259,1,7,1.0,8,0.125
377837303,3,7,3.0,10,0.3
377838600,14,15,14.0,29,0.4827586206896552
377839730,4,6,4.0,10,0.4
377842502,8,21,8.0,29,0.27586206896551724
377842703,9,1,1.0,10,0.1
377845884,1,17,1.0,18,0.05555555555555555
377853224,2,8,2.0,10,0.2
377854283,4,6,4.0,10,0.4
377854973,2,6,2.0,8,0.25
377863484,1,9,1.0,10,0.1
377864202,3,7,3.0,10,0.3
377906121,2,8,2.0,10,0.2
377959990,1,9,1.0,10,0.1
378030353,3,16,3.0,19,0.15789473684210525
378030390,1,8,1.0,9,0.1111111111111111
378057657,3,15,3.0,18,0.16666666666666666
378065922,1,19,1.0,20,0.05
378104606,4,6,4.0,10,0.4
378118120,4,4,4.0,8,0.5
378119799,4,5,4.0,9,0.4444444444444444
378143208,6,3,3.0,9,0.3333333333333333
378195503,1,9,1.0,10,0.1
378202448,1,9,1.0,10,0.1
378226627,3,7,3.0,10,0.3
378242607,1,9,1.0,10,0.1
378244233,3,7,3.0,10,0.3
378244835,2,18,2.0,20,0.1
378249046,2,8,2.0,10,0.2
378268389,1,9,1.0,10,0.1
378285582,4,16,4.0,20,0.2
378334056,2,8,2.0,10,0.2
378336031,4,6,4.0,10,0.4
378336233,6,3,3.0,9,0.3333333333333333
378337033,13,14,13.0,27,0.48148148148148145
378436752,2,6,2.0,8,0.25
378439707,1,8,1.0,9,0.1111111111111111
378449507,1,8,1.0,9,0.1111111111111111
378453272,1,9,1.0,10,0.1
378455686,1,17,1.0,18,0.05555555555555555
378501960,7,3,3.0,10,0.3
378504010,2,28,2.0,30,0.06666666666666667
378504630,3,7,3.0,10,0.3
378551523,2,8,2.0,10,0.2
378554435,1,9,1.0,10,0.1
378590296,5,4,4.0,9,0.4444444444444444
378624661,1,8,1.0,9,0.1111111111111111
378625929,5,5,5.0,10,0.5
378633166,4,5,4.0,9,0.4444444444444444
378664813,9,1,1.0,10,0.1
378768366,8,2,2.0,10,0.2
378775979,8,2,2.0,10,0.2
378785247,5,5,5.0,10,0.5
378793303,2,8,2.0,10,0.2
378821013,1,8,1.0,9,0.1111111111111111
378824877,9,1,1.0,10,0.1
378828275,1,9,1.0,10,0.1
378830880,1,8,1.0,9,0.1111111111111111
378831852,3,7,3.0,10,0.3
378832203,3,7,3.0,10,0.3
378833108,2,8,2.0,10,0.2
378833757,2,8,2.0,10,0.2
378835489,4,6,4.0,10,0.4
378837885,1,9,1.0,10,0.1
378839373,2,8,2.0,10,0.2
378840111,3,5,3.0,8,0.375
378859602,2,17,2.0,19,0.10526315789473684
378871210,1,18,1.0,19,0.05263157894736842
378889338,4,4,4.0,8,0.5
378894783,1,9,1.0,10,0.1
378907773,7,3,3.0,10,0.3
378916452,9,1,1.0,10,0.1
378922613,1,8,1.0,9,0.1111111111111111
378933412,1,9,1.0,10,0.1
378970763,2,8,2.0,10,0.2
379019602,1,8,1.0,9,0.1111111111111111
379050696,1,8,1.0,9,0.1111111111111111
379119001,9,1,1.0,10,0.1
379127098,1,9,1.0,10,0.1
379135313,9,1,1.0,10,0.1
379136013,20,8,8.0,28,0.2857142857142857
379136428,4,6,4.0,10,0.4
379136520,1,9,1.0,10,0.1
379156426,5,5,5.0,10,0.5
379157984,7,3,3.0,10,0.3
379165499,1,9,1.0,10,0.1
379190593,1,9,1.0,10,0.1
379214261,1,9,1.0,10,0.1
379244267,3,7,3.0,10,0.3
379264571,1,7,1.0,8,0.125
379267769,4,6,4.0,10,0.4
379273774,1,8,1.0,9,0.1111111111111111
379278302,1,8,1.0,9,0.1111111111111111
379304161,2,6,2.0,8,0.25
379307761,4,5,4.0,9,0.4444444444444444
379307983,9,1,1.0,10,0.1
379323048,1,17,1.0,18,0.05555555555555555
379360772,8,1,1.0,9,0.1111111111111111
379361887,1,26,1.0,27,0.037037037037037035
379361962,9,1,1.0,10,0.1
379388930,3,7,3.0,10,0.3
379389552,5,14,5.0,19,0.2631578947368421
379391078,1,17,1.0,18,0.05555555555555555
379397458,1,27,1.0,28,0.03571428571428571
379397758,3,7,3.0,10,0.3
379401495,3,7,3.0,10,0.3
379401595,3,7,3.0,10,0.3
379403953,3,7,3.0,10,0.3
379406654,4,6,4.0,10,0.4
379409110,3,6,3.0,9,0.3333333333333333
379409393,1,7,1.0,8,0.125
379412453,1,9,1.0,10,0.1
379417557,4,6,4.0,10,0.4
379424354,2,8,2.0,10,0.2
379424465,2,7,2.0,9,0.2222222222222222
379431384,2,7,2.0,9,0.2222222222222222
379431811,2,6,2.0,8,0.25
379454860,7,12,7.0,19,0.3684210526315789
379465497,2,8,2.0,10,0.2
379471221,3,16,3.0,19,0.15789473684210525
379475694,1,8,1.0,9,0.1111111111111111
379480233,2,7,2.0,9,0.2222222222222222
379484587,2,16,2.0,18,0.1111111111111111
379484948,20,6,6.0,26,0.23076923076923078
379485254,6,2,2.0,8,0.25
379485583,2,8,2.0,10,0.2
379488116,4,5,4.0,9,0.4444444444444444
379529179,3,17,3.0,20,0.15
379532589,1,9,1.0,10,0.1
379544320,5,5,5.0,10,0.5
379545211,2,8,2.0,10,0.2
379551206,2,7,2.0,9,0.2222222222222222
379552763,5,5,5.0,10,0.5
379553145,2,6,2.0,8,0.25
379568536,1,7,1.0,8,0.125
379575834,4,23,4.0,27,0.14814814814814814
379586772,5,5,5.0,10,0.5
379586826,7,2,2.0,9,0.2222222222222222
379608272,1,9,1.0,10,0.1
379616103,3,7,3.0,10,0.3
379619090,2,7,2.0,9,0.2222222222222222
379629575,1,9,1.0,10,0.1
379707615,1,8,1.0,9,0.1111111111111111
379716807,25,2,2.0,27,0.07407407407407407
379722253,1,8,1.0,9,0.1111111111111111
379722512,4,6,4.0,10,0.4
379722762,2,8,2.0,10,0.2
379795536,1,9,1.0,10,0.1
379831256,4,15,4.0,19,0.21052631578947367
379838647,2,14,2.0,16,0.125
379842325,2,8,2.0,10,0.2
379843646,1,29,1.0,30,0.03333333333333333
379843848,4,5,4.0,9,0.4444444444444444
379844203,1,9,1.0,10,0.1
379847880,4,15,4.0,19,0.21052631578947367
379848742,5,4,4.0,9,0.4444444444444444
379848843,5,5,5.0,10,0.5
379860144,1,8,1.0,9,0.1111111111111111
379871798,4,6,4.0,10,0.4
379894195,1,9,1.0,10,0.1
379898596,5,5,5.0,10,0.5
379900708,1,9,1.0,10,0.1
379922086,1,8,1.0,9,0.1111111111111111
380003440,3,7,3.0,10,0.3
380009978,5,5,5.0,10,0.5
380038034,1,9,1.0,10,0.1
380080041,9,1,1.0,10,0.1
380080455,7,3,3.0,10,0.3
380083219,4,6,4.0,10,0.4
380085819,9,1,1.0,10,0.1
380088413,2,8,2.0,10,0.2
380102760,2,8,2.0,10,0.2
380103382,4,6,4.0,10,0.4
380103694,4,5,4.0,9,0.4444444444444444
380104199,4,5,4.0,9,0.4444444444444444
380104267,7,3,3.0,10,0.3
380104676,2,8,2.0,10,0.2
380105001,1,9,1.0,10,0.1
380105292,13,17,13.0,30,0.43333333333333335
380108140,1,9,1.0,10,0.1
380110737,1,27,1.0,28,0.03571428571428571
380112367,8,2,2.0,10,0.2
380130289,5,5,5.0,10,0.5
380134744,6,4,4.0,10,0.4
380135249,2,8,2.0,10,0.2
380142665,1,18,1.0,19,0.05263157894736842
380144530,1,9,1.0,10,0.1
380147506,1,7,1.0,8,0.125
380165130,1,9,1.0,10,0.1
380181289,5,4,4.0,9,0.4444444444444444
380182411,4,5,4.0,9,0.4444444444444444
380183617,4,6,4.0,10,0.4
380183985,9,20,9.0,29,0.3103448275862069
380200558,1,19,1.0,20,0.05
380228457,2,7,2.0,9,0.2222222222222222
380231025,1,9,1.0,10,0.1
380231514,1,9,1.0,10,0.1
380232243,1,7,1.0,8,0.125
380236558,1,8,1.0,9,0.1111111111111111
380258697,2,8,2.0,10,0.2
380297098,7,3,3.0,10,0.3
380314946,1,9,1.0,10,0.1
380345857,9,1,1.0,10,0.1
380349913,6,23,6.0,29,0.20689655172413793
380351354,1,9,1.0,10,0.1
380363674,1,9,1.0,10,0.1
380402904,4,5,4.0,9,0.4444444444444444
380428874,4,5,4.0,9,0.4444444444444444
380435110,1,9,1.0,10,0.1
380435542,6,4,4.0,10,0.4
380435635,1,7,1.0,8,0.125
380435840,12,17,12.0,29,0.41379310344827586
380437086,1,9,1.0,10,0.1
380438557,1,8,1.0,9,0.1111111111111111
380445437,1,19,1.0,20,0.05
380496795,7,3,3.0,10,0.3
380514692,3,6,3.0,9,0.3333333333333333
380522272,1,18,1.0,19,0.05263157894736842
380533513,1,9,1.0,10,0.1
380560653,3,6,3.0,9,0.3333333333333333
380567788,3,16,3.0,19,0.15789473684210525
380588019,8,1,1.0,9,0.1111111111111111
380588321,6,3,3.0,9,0.3333333333333333
380590400,8,1,1.0,9,0.1111111111111111
380630642,1,7,1.0,8,0.125
380644084,4,6,4.0,10,0.4
380650617,1,8,1.0,9,0.1111111111111111
380661763,1,9,1.0,10,0.1
380674321,8,2,2.0,10,0.2
380709777,3,17,3.0,20,0.15
380713879,2,8,2.0,10,0.2
380716257,6,4,4.0,10,0.4
380716370,1,18,1.0,19,0.05263157894736842
380724030,2,8,2.0,10,0.2
380799306,4,5,4.0,9,0.4444444444444444
380799359,1,7,1.0,8,0.125
380806523,1,9,1.0,10,0.1
380837347,3,6,3.0,9,0.3333333333333333
380872672,1,9,1.0,10,0.1
380878835,1,9,1.0,10,0.1
380879447,4,5,4.0,9,0.4444444444444444
380884517,5,3,3.0,8,0.375
380911201,1,15,1.0,16,0.0625
380934600,1,9,1.0,10,0.1
380934860,1,9,1.0,10,0.1
380950497,3,7,3.0,10,0.3
380954333,8,1,1.0,9,0.1111111111111111
380972211,1,9,1.0,10,0.1
380992291,2,7,2.0,9,0.2222222222222222
381000714,3,7,3.0,10,0.3
381002755,1,9,1.0,10,0.1
381007823,3,7,3.0,10,0.3
381009316,2,8,2.0,10,0.2
381009920,3,7,3.0,10,0.3
381010327,1,7,1.0,8,0.125
381030192,1,9,1.0,10,0.1
381064403,1,9,1.0,10,0.1
381067146,2,17,2.0,19,0.10526315789473684
381083216,11,8,8.0,19,0.42105263157894735
381095755,1,9,1.0,10,0.1
381144689,13,7,7.0,20,0.35
381164037,3,15,3.0,18,0.16666666666666666
381174390,5,3,3.0,8,0.375
381191013,12,8,8.0,20,0.4
381196126,3,7,3.0,10,0.3
381198541,1,9,1.0,10,0.1
381202255,1,8,1.0,9,0.1111111111111111
381204587,2,7,2.0,9,0.2222222222222222
381214236,10,17,10.0,27,0.37037037037037035
381217680,1,8,1.0,9,0.1111111111111111
381232176,3,7,3.0,10,0.3
381241952,3,7,3.0,10,0.3
381242897,4,5,4.0,9,0.4444444444444444
381243443,8,1,1.0,9,0.1111111111111111
381252690,2,8,2.0,10,0.2
381256713,1,8,1.0,9,0.1111111111111111
381265621,1,9,1.0,10,0.1
381308273,6,2,2.0,8,0.25
381312648,1,19,1.0,20,0.05
381321952,1,9,1.0,10,0.1
381326635,1,9,1.0,10,0.1
381347820,7,3,3.0,10,0.3
381348182,1,8,1.0,9,0.1111111111111111
381348963,2,7,2.0,9,0.2222222222222222
381362729,1,8,1.0,9,0.1111111111111111
381373501,1,9,1.0,10,0.1
381389807,6,3,3.0,9,0.3333333333333333
381500517,1,19,1.0,20,0.05
381579046,2,8,2.0,10,0.2
381582344,1,19,1.0,20,0.05
381591297,1,7,1.0,8,0.125
381640868,2,8,2.0,10,0.2
381646423,6,2,2.0,8,0.25
381666842,9,21,9.0,30,0.3
381710299,1,19,1.0,20,0.05
381713097,2,7,2.0,9,0.2222222222222222
381721503,1,9,1.0,10,0.1
381764045,3,7,3.0,10,0.3
381785304,6,2,2.0,8,0.25
381789217,6,4,4.0,10,0.4
381830937,7,2,2.0,9,0.2222222222222222
381858101,4,26,4.0,30,0.13333333333333333
381884822,7,3,3.0,10,0.3
381897664,2,8,2.0,10,0.2
381934173,1,9,1.0,10,0.1
381982030,1,8,1.0,9,0.1111111111111111
382016279,1,9,1.0,10,0.1
382070871,5,5,5.0,10,0.5
382075978,4,15,4.0,19,0.21052631578947367
382085321,1,8,1.0,9,0.1111111111111111
382125318,1,9,1.0,10,0.1
382133237,1,19,1.0,20,0.05
382160505,1,9,1.0,10,0.1
382167343,1,9,1.0,10,0.1
382193700,9,1,1.0,10,0.1
382206741,2,6,2.0,8,0.25
382223378,17,11,11.0,28,0.39285714285714285
382277847,2,8,2.0,10,0.2
382303299,8,1,1.0,9,0.1111111111111111
382303654,1,9,1.0,10,0.1
382311420,1,19,1.0,20,0.05
382316733,1,9,1.0,10,0.1
382327606,1,9,1.0,10,0.1
382328891,6,4,4.0,10,0.4
382367449,5,5,5.0,10,0.5
382391539,1,8,1.0,9,0.1111111111111111
382400700,5,5,5.0,10,0.5
382401082,5,5,5.0,10,0.5
382405146,1,17,1.0,18,0.05555555555555555
382407156,1,9,1.0,10,0.1
382514529,1,9,1.0,10,0.1
382516106,1,8,1.0,9,0.1111111111111111
382521875,7,2,2.0,9,0.2222222222222222
382526986,7,3,3.0,10,0.3
382549384,3,6,3.0,9,0.3333333333333333
382561620,2,8,2.0,10,0.2
382573364,8,2,2.0,10,0.2
382578979,4,4,4.0,8,0.5
382581968,3,6,3.0,9,0.3333333333333333
382582458,1,8,1.0,9,0.1111111111111111
382583137,9,1,1.0,10,0.1
382585034,19,4,4.0,23,0.17391304347826086
382585306,4,5,4.0,9,0.4444444444444444
382585608,6,4,4.0,10,0.4
382606128,6,4,4.0,10,0.4
382607592,8,2,2.0,10,0.2
382649719,7,2,2.0,9,0.2222222222222222
382651607,1,7,1.0,8,0.125
382652330,1,8,1.0,9,0.1111111111111111
382653668,2,7,2.0,9,0.2222222222222222
382654049,1,9,1.0,10,0.1
382665464,1,8,1.0,9,0.1111111111111111
382713341,1,9,1.0,10,0.1
382725198,5,5,5.0,10,0.5
382726076,3,7,3.0,10,0.3
382736788,8,2,2.0,10,0.2
382739056,1,9,1.0,10,0.1
382739306,1,9,1.0,10,0.1
382758241,7,3,3.0,10,0.3
382758567,7,3,3.0,10,0.3
382758814,3,7,3.0,10,0.3
382759634,3,6,3.0,9,0.3333333333333333
382762701,1,19,1.0,20,0.05
382767884,1,19,1.0,20,0.05
382775504,2,18,2.0,20,0.1
382795532,1,17,1.0,18,0.05555555555555555
382838031,5,5,5.0,10,0.5
382839007,5,5,5.0,10,0.5
382840327,5,3,3.0,8,0.375
382840356,1,8,1.0,9,0.1111111111111111
382875304,3,15,3.0,18,0.16666666666666666
382908095,2,6,2.0,8,0.25
382920081,1,9,1.0,10,0.1
382948679,1,8,1.0,9,0.1111111111111111
382949672,5,5,5.0,10,0.5
382957296,2,8,2.0,10,0.2
382957363,1,16,1.0,17,0.058823529411764705
382957805,4,5,4.0,9,0.4444444444444444
382958216,2,7,2.0,9,0.2222222222222222
382961490,7,3,3.0,10,0.3
382964422,3,6,3.0,9,0.3333333333333333
382968835,1,9,1.0,10,0.1
382978341,1,9,1.0,10,0.1
383003859,1,9,1.0,10,0.1
383036104,1,8,1.0,9,0.1111111111111111
383037889,1,15,1.0,16,0.0625
383037911,1,7,1.0,8,0.125
383046771,1,9,1.0,10,0.1
383063541,4,6,4.0,10,0.4
383067928,1,9,1.0,10,0.1
383098816,1,9,1.0,10,0.1
383108702,2,7,2.0,9,0.2222222222222222
383194622,1,9,1.0,10,0.1
383236749,2,6,2.0,8,0.25
383239615,2,8,2.0,10,0.2
383241906,2,8,2.0,10,0.2
383373156,2,7,2.0,9,0.2222222222222222
383376442,1,9,1.0,10,0.1
383387993,1,9,1.0,10,0.1
383388790,1,9,1.0,10,0.1
383389047,8,21,8.0,29,0.27586206896551724
383390038,1,19,1.0,20,0.05
383407046,5,4,4.0,9,0.4444444444444444
383408142,6,3,3.0,9,0.3333333333333333
383423637,1,8,1.0,9,0.1111111111111111
383424240,4,6,4.0,10,0.4
383449420,1,9,1.0,10,0.1
383492345,6,3,3.0,9,0.3333333333333333
383504426,7,3,3.0,10,0.3
383525220,8,20,8.0,28,0.2857142857142857
383525318,8,2,2.0,10,0.2
383539886,1,9,1.0,10,0.1
383558545,8,1,1.0,9,0.1111111111111111
383594052,6,4,4.0,10,0.4
383600931,2,8,2.0,10,0.2
383604023,7,12,7.0,19,0.3684210526315789
383605154,2,6,2.0,8,0.25
383651895,1,8,1.0,9,0.1111111111111111
383674019,1,17,1.0,18,0.05555555555555555
383709942,1,8,1.0,9,0.1111111111111111
383721510,4,6,4.0,10,0.4
383722889,2,8,2.0,10,0.2
383723462,1,8,1.0,9,0.1111111111111111
383723724,1,9,1.0,10,0.1
383736875,1,9,1.0,10,0.1
383756872,6,11,6.0,17,0.35294117647058826
383807560,1,19,1.0,20,0.05
383813025,6,3,3.0,9,0.3333333333333333
383817077,1,9,1.0,10,0.1
383824320,1,9,1.0,10,0.1
383833235,5,14,5.0,19,0.2631578947368421
383841223,3,6,3.0,9,0.3333333333333333
383842208,1,8,1.0,9,0.1111111111111111
383850710,9,1,1.0,10,0.1
383851236,8,2,2.0,10,0.2
383879732,1,18,1.0,19,0.05263157894736842
383898036,1,9,1.0,10,0.1
383899374,1,29,1.0,30,0.03333333333333333
383915301,1,9,1.0,10,0.1
383915751,1,9,1.0,10,0.1
383916574,2,18,2.0,20,0.1
383921415,1,9,1.0,10,0.1
383926750,4,6,4.0,10,0.4
383934984,3,7,3.0,10,0.3
383939709,7,2,2.0,9,0.2222222222222222
383941088,9,19,9.0,28,0.32142857142857145
383953218,1,8,1.0,9,0.1111111111111111
383964596,1,18,1.0,19,0.05263157894736842
383974633,1,7,1.0,8,0.125
383974654,2,8,2.0,10,0.2
383980397,3,7,3.0,10,0.3
383993121,2,8,2.0,10,0.2
384000782,5,5,5.0,10,0.5
384014728,1,9,1.0,10,0.1
384024183,2,7,2.0,9,0.2222222222222222
384024352,3,7,3.0,10,0.3
384064080,1,9,1.0,10,0.1
384090590,3,7,3.0,10,0.3
384102271,4,5,4.0,9,0.4444444444444444
384105665,1,8,1.0,9,0.1111111111111111
384106474,3,6,3.0,9,0.3333333333333333
384126422,4,6,4.0,10,0.4
384129495,3,7,3.0,10,0.3
384129930,2,8,2.0,10,0.2
384132076,7,1,1.0,8,0.125
384135381,2,8,2.0,10,0.2
384137748,24,6,6.0,30,0.2
384151156,22,3,3.0,25,0.12
384179300,8,1,1.0,9,0.1111111111111111
384179794,20,9,9.0,29,0.3103448275862069
384194368,9,1,1.0,10,0.1
384197926,1,9,1.0,10,0.1
384204304,2,7,2.0,9,0.2222222222222222
384205086,2,7,2.0,9,0.2222222222222222
384205264,2,8,2.0,10,0.2
384206277,3,15,3.0,18,0.16666666666666666
384206697,1,15,1.0,16,0.0625
384210057,7,2,2.0,9,0.2222222222222222
384214493,3,7,3.0,10,0.3
384233644,2,27,2.0,29,0.06896551724137931
384234264,5,24,5.0,29,0.1724137931034483
384235916,2,8,2.0,10,0.2
384287854,6,3,3.0,9,0.3333333333333333
384302898,1,7,1.0,8,0.125
384303468,4,5,4.0,9,0.4444444444444444
384357842,7,3,3.0,10,0.3
384363897,2,7,2.0,9,0.2222222222222222
384476375,4,4,4.0,8,0.5
384483177,1,9,1.0,10,0.1
384502761,3,7,3.0,10,0.3
384519043,5,5,5.0,10,0.5
384524321,1,17,1.0,18,0.05555555555555555
384527936,2,7,2.0,9,0.2222222222222222
384543081,2,8,2.0,10,0.2
384565745,2,8,2.0,10,0.2
384594263,2,8,2.0,10,0.2
384595021,1,9,1.0,10,0.1
384599667,1,9,1.0,10,0.1
384599801,1,19,1.0,20,0.05
384601881,1,8,1.0,9,0.1111111111111111
384604843,1,8,1.0,9,0.1111111111111111
384641353,1,9,1.0,10,0.1
384642367,1,9,1.0,10,0.1
384668634,2,8,2.0,10,0.2
384670059,7,21,7.0,28,0.25
384672324,7,3,3.0,10,0.3
384678663,18,6,6.0,24,0.25
384686952,3,5,3.0,8,0.375
384690857,1,9,1.0,10,0.1
384709571,1,7,1.0,8,0.125
384793813,2,8,2.0,10,0.2
384830869,4,5,4.0,9,0.4444444444444444
384832099,1,7,1.0,8,0.125
384855998,4,5,4.0,9,0.4444444444444444
384859524,3,6,3.0,9,0.3333333333333333
384860204,5,4,4.0,9,0.4444444444444444
384860631,1,18,1.0,19,0.05263157894736842
384861527,2,8,2.0,10,0.2
384873370,2,8,2.0,10,0.2
384876972,5,5,5.0,10,0.5
384891465,2,8,2.0,10,0.2
384893202,1,7,1.0,8,0.125
384893848,2,8,2.0,10,0.2
384896543,1,9,1.0,10,0.1
384902494,2,7,2.0,9,0.2222222222222222
384905582,6,4,4.0,10,0.4
384909329,3,7,3.0,10,0.3
384911714,1,9,1.0,10,0.1
384913308,7,3,3.0,10,0.3
384913490,1,7,1.0,8,0.125
384914559,3,7,3.0,10,0.3
384915442,9,1,1.0,10,0.1
384918225,2,8,2.0,10,0.2
384919554,1,8,1.0,9,0.1111111111111111
384923082,2,8,2.0,10,0.2
384923168,2,17,2.0,19,0.10526315789473684
384924865,10,18,10.0,28,0.35714285714285715
384934696,1,16,1.0,17,0.058823529411764705
384944741,2,8,2.0,10,0.2
384947477,2,8,2.0,10,0.2
384952490,1,9,1.0,10,0.1
384979469,5,3,3.0,8,0.375
384980075,1,9,1.0,10,0.1
384989905,1,18,1.0,19,0.05263157894736842
385000473,8,2,2.0,10,0.2
385012024,1,9,1.0,10,0.1
385012465,1,9,1.0,10,0.1
385103483,6,4,4.0,10,0.4
385124861,4,6,4.0,10,0.4
385127638,1,9,1.0,10,0.1
385128493,3,7,3.0,10,0.3
385128563,2,8,2.0,10,0.2
385129550,2,8,2.0,10,0.2
385133059,1,7,1.0,8,0.125
385134449,2,7,2.0,9,0.2222222222222222
385134952,3,5,3.0,8,0.375
385169927,5,4,4.0,9,0.4444444444444444
385177884,2,8,2.0,10,0.2
385178847,2,8,2.0,10,0.2
385182037,3,15,3.0,18,0.16666666666666666
385184247,2,8,2.0,10,0.2
385197032,2,8,2.0,10,0.2
385216874,8,19,8.0,27,0.2962962962962963
385217506,3,6,3.0,9,0.3333333333333333
385283761,1,8,1.0,9,0.1111111111111111
385292325,2,8,2.0,10,0.2
385305150,25,2,2.0,27,0.07407407407407407
385305669,3,7,3.0,10,0.3
385359130,1,18,1.0,19,0.05263157894736842
385360318,5,5,5.0,10,0.5
385399333,4,6,4.0,10,0.4
385433103,3,6,3.0,9,0.3333333333333333
385439315,6,3,3.0,9,0.3333333333333333
385440021,9,11,9.0,20,0.45
385440830,2,8,2.0,10,0.2
385441700,6,13,6.0,19,0.3157894736842105
385442812,1,8,1.0,9,0.1111111111111111
385447483,2,7,2.0,9,0.2222222222222222
385475351,3,6,3.0,9,0.3333333333333333
385494450,27,2,2.0,29,0.06896551724137931
385495210,7,1,1.0,8,0.125
385495358,8,2,2.0,10,0.2
385512340,3,7,3.0,10,0.3
385513972,2,17,2.0,19,0.10526315789473684
385577091,3,7,3.0,10,0.3
385582713,2,7,2.0,9,0.2222222222222222
385629382,27,1,1.0,28,0.03571428571428571
385629487,1,8,1.0,9,0.1111111111111111
385699328,1,19,1.0,20,0.05
385716819,1,9,1.0,10,0.1
385744263,2,18,2.0,20,0.1
385746654,3,6,3.0,9,0.3333333333333333
385786541,2,8,2.0,10,0.2
385795069,6,4,4.0,10,0.4
385795085,1,9,1.0,10,0.1
385795887,3,6,3.0,9,0.3333333333333333
385805986,3,6,3.0,9,0.3333333333333333
385817368,1,8,1.0,9,0.1111111111111111
385818219,1,19,1.0,20,0.05
385818864,1,9,1.0,10,0.1
385821718,1,7,1.0,8,0.125
385830699,3,7,3.0,10,0.3
385843376,21,7,7.0,28,0.25
385862629,7,1,1.0,8,0.125
385865044,5,4,4.0,9,0.4444444444444444
385934576,2,25,2.0,27,0.07407407407407407
385956330,2,8,2.0,10,0.2
385977532,1,19,1.0,20,0.05
385985728,6,14,6.0,20,0.3
385992594,1,8,1.0,9,0.1111111111111111
386052922,1,8,1.0,9,0.1111111111111111
386053270,8,2,2.0,10,0.2
386055201,3,14,3.0,17,0.17647058823529413
386057319,3,17,3.0,20,0.15
386159394,1,18,1.0,19,0.05263157894736842
386180083,1,9,1.0,10,0.1
386188883,6,20,6.0,26,0.23076923076923078
386202947,1,18,1.0,19,0.05263157894736842
386230624,8,2,2.0,10,0.2
386294670,1,18,1.0,19,0.05263157894736842
386347339,6,4,4.0,10,0.4
386463892,1,8,1.0,9,0.1111111111111111
386506271,1,9,1.0,10,0.1
386532404,2,8,2.0,10,0.2
386552009,4,5,4.0,9,0.4444444444444444
386552555,3,6,3.0,9,0.3333333333333333
386601562,1,9,1.0,10,0.1
386604100,1,28,1.0,29,0.034482758620689655
386614460,8,2,2.0,10,0.2
386634690,3,6,3.0,9,0.3333333333333333
386652864,9,1,1.0,10,0.1
386660032,2,14,2.0,16,0.125
386671043,3,7,3.0,10,0.3
386673210,3,7,3.0,10,0.3
386676118,2,8,2.0,10,0.2
386681637,9,1,1.0,10,0.1
386749389,8,1,1.0,9,0.1111111111111111
386761101,1,9,1.0,10,0.1
386765798,4,6,4.0,10,0.4
386766737,5,5,5.0,10,0.5
386767726,2,8,2.0,10,0.2
386768395,1,9,1.0,10,0.1
386769184,1,7,1.0,8,0.125
386778869,1,9,1.0,10,0.1
386847227,7,2,2.0,9,0.2222222222222222
386856870,1,9,1.0,10,0.1
386872429,4,6,4.0,10,0.4
386883632,27,3,3.0,30,0.1
386883994,5,5,5.0,10,0.5
386891548,4,4,4.0,8,0.5
386893375,8,1,1.0,9,0.1111111111111111
386897218,4,5,4.0,9,0.4444444444444444
386911320,1,17,1.0,18,0.05555555555555555
386964116,1,8,1.0,9,0.1111111111111111
386973424,3,6,3.0,9,0.3333333333333333
386993434,1,18,1.0,19,0.05263157894736842
387031451,1,9,1.0,10,0.1
387037639,1,9,1.0,10,0.1
387051300,2,8,2.0,10,0.2
387054443,1,9,1.0,10,0.1
387054823,4,6,4.0,10,0.4
387055213,2,8,2.0,10,0.2
387083836,1,9,1.0,10,0.1
387092313,5,4,4.0,9,0.4444444444444444
387112548,5,5,5.0,10,0.5
387117922,2,16,2.0,18,0.1111111111111111
387234282,3,7,3.0,10,0.3
387242369,2,8,2.0,10,0.2
387242890,2,7,2.0,9,0.2222222222222222
387263971,1,9,1.0,10,0.1
387276616,3,6,3.0,9,0.3333333333333333
387279225,2,7,2.0,9,0.2222222222222222
387280488,1,28,1.0,29,0.034482758620689655
387281878,7,20,7.0,27,0.25925925925925924
387298940,6,4,4.0,10,0.4
387316927,2,16,2.0,18,0.1111111111111111
387326631,2,7,2.0,9,0.2222222222222222
387327694,2,7,2.0,9,0.2222222222222222
387328740,1,9,1.0,10,0.1
387333165,2,8,2.0,10,0.2
387336123,2,8,2.0,10,0.2
387336987,1,9,1.0,10,0.1
387338095,5,5,5.0,10,0.5
387338805,1,9,1.0,10,0.1
387340944,1,9,1.0,10,0.1
387361626,4,23,4.0,27,0.14814814814814814
387364657,1,9,1.0,10,0.1
387366828,1,7,1.0,8,0.125
387370012,1,9,1.0,10,0.1
387379454,8,2,2.0,10,0.2
387384514,2,24,2.0,26,0.07692307692307693
387386677,1,9,1.0,10,0.1
387387695,1,9,1.0,10,0.1
387388371,1,9,1.0,10,0.1
387391229,2,7,2.0,9,0.2222222222222222
387392559,1,9,1.0,10,0.1
387394090,5,3,3.0,8,0.375
387405509,11,17,11.0,28,0.39285714285714285
387408487,4,4,4.0,8,0.5
387411311,2,8,2.0,10,0.2
387426655,2,7,2.0,9,0.2222222222222222
387434432,7,20,7.0,27,0.25925925925925924
387450328,3,7,3.0,10,0.3
387453273,1,9,1.0,10,0.1
387463741,2,7,2.0,9,0.2222222222222222
387467994,3,7,3.0,10,0.3
387470095,6,3,3.0,9,0.3333333333333333
387471238,9,1,1.0,10,0.1
387471457,1,8,1.0,9,0.1111111111111111
387471771,2,8,2.0,10,0.2
387473560,2,8,2.0,10,0.2
387474452,1,9,1.0,10,0.1
387479147,1,8,1.0,9,0.1111111111111111
387480863,4,6,4.0,10,0.4
387498726,2,17,2.0,19,0.10526315789473684
387511217,4,24,4.0,28,0.14285714285714285
387542076,3,17,3.0,20,0.15
387543964,8,2,2.0,10,0.2
387547707,1,8,1.0,9,0.1111111111111111
387552800,3,6,3.0,9,0.3333333333333333
387560340,3,6,3.0,9,0.3333333333333333
387588137,1,18,1.0,19,0.05263157894736842
387631183,2,7,2.0,9,0.2222222222222222
387638374,1,8,1.0,9,0.1111111111111111
387646296,8,2,2.0,10,0.2
387646945,2,27,2.0,29,0.06896551724137931
387653663,3,17,3.0,20,0.15
387659409,1,8,1.0,9,0.1111111111111111
387668565,1,7,1.0,8,0.125
387686001,7,3,3.0,10,0.3
387725494,1,17,1.0,18,0.05555555555555555
387753548,1,9,1.0,10,0.1
387762563,10,10,10.0,20,0.5
387768258,1,9,1.0,10,0.1
387818700,4,5,4.0,9,0.4444444444444444
387847123,1,8,1.0,9,0.1111111111111111
387858233,2,8,2.0,10,0.2
387872461,1,19,1.0,20,0.05
387873043,1,9,1.0,10,0.1
387875317,3,7,3.0,10,0.3
387876230,1,9,1.0,10,0.1
387898698,1,9,1.0,10,0.1
387900572,1,8,1.0,9,0.1111111111111111
387900845,1,9,1.0,10,0.1
387900999,1,8,1.0,9,0.1111111111111111
387948192,3,7,3.0,10,0.3
387949325,3,7,3.0,10,0.3
387953522,1,9,1.0,10,0.1
387954009,5,4,4.0,9,0.4444444444444444
387959219,1,19,1.0,20,0.05
387970303,1,9,1.0,10,0.1
387973028,1,8,1.0,9,0.1111111111111111
387987487,8,2,2.0,10,0.2
388020752,1,19,1.0,20,0.05
388022227,2,8,2.0,10,0.2
388037696,1,9,1.0,10,0.1
388039035,1,19,1.0,20,0.05
388039741,1,9,1.0,10,0.1
388046095,6,2,2.0,8,0.25
388062631,1,27,1.0,28,0.03571428571428571
388078252,3,5,3.0,8,0.375
388079892,2,8,2.0,10,0.2
388120925,1,18,1.0,19,0.05263157894736842
388134596,1,8,1.0,9,0.1111111111111111
388135222,1,19,1.0,20,0.05
388135670,6,4,4.0,10,0.4
388136503,7,20,7.0,27,0.25925925925925924
388148962,1,9,1.0,10,0.1
388149218,2,8,2.0,10,0.2
388150898,2,8,2.0,10,0.2
388151236,1,8,1.0,9,0.1111111111111111
388154206,3,7,3.0,10,0.3
388195292,3,7,3.0,10,0.3
388217371,8,1,1.0,9,0.1111111111111111
388217593,7,3,3.0,10,0.3
388217900,4,6,4.0,10,0.4
388237105,1,8,1.0,9,0.1111111111111111
388274663,6,3,3.0,9,0.3333333333333333
388291174,1,7,1.0,8,0.125
388302771,1,9,1.0,10,0.1
388302772,1,9,1.0,10,0.1
388307056,6,14,6.0,20,0.3
388384957,2,8,2.0,10,0.2
388385712,2,7,2.0,9,0.2222222222222222
388398768,1,9,1.0,10,0.1
388406958,10,10,10.0,20,0.5
388411787,1,9,1.0,10,0.1
388420389,5,21,5.0,26,0.19230769230769232
388442223,1,9,1.0,10,0.1
388483200,1,9,1.0,10,0.1
388493632,3,7,3.0,10,0.3
388494828,3,7,3.0,10,0.3
388496047,3,7,3.0,10,0.3
388502959,2,18,2.0,20,0.1
388504691,5,5,5.0,10,0.5
388505369,7,21,7.0,28,0.25
388508792,2,8,2.0,10,0.2
388514913,1,7,1.0,8,0.125
388518320,10,17,10.0,27,0.37037037037037035
388561980,1,7,1.0,8,0.125
388570246,3,6,3.0,9,0.3333333333333333
388574278,1,9,1.0,10,0.1
388577788,3,6,3.0,9,0.3333333333333333
388638740,1,9,1.0,10,0.1
388705557,3,17,3.0,20,0.15
388736428,15,11,11.0,26,0.4230769230769231
388737188,1,9,1.0,10,0.1
388737740,4,6,4.0,10,0.4
388753839,1,9,1.0,10,0.1
388759712,1,9,1.0,10,0.1
388761739,1,9,1.0,10,0.1
388763208,3,5,3.0,8,0.375
388763504,2,7,2.0,9,0.2222222222222222
388764340,3,7,3.0,10,0.3
388770071,9,1,1.0,10,0.1
388770503,2,8,2.0,10,0.2
388772640,2,7,2.0,9,0.2222222222222222
388775253,2,8,2.0,10,0.2
388779888,2,18,2.0,20,0.1
388780600,2,8,2.0,10,0.2
388785544,1,8,1.0,9,0.1111111111111111
388787290,8,1,1.0,9,0.1111111111111111
388823167,1,8,1.0,9,0.1111111111111111
388832017,17,11,11.0,28,0.39285714285714285
388837176,4,15,4.0,19,0.21052631578947367
388837817,2,8,2.0,10,0.2
388838081,8,2,2.0,10,0.2
388846787,2,8,2.0,10,0.2
388847187,1,9,1.0,10,0.1
388847737,2,7,2.0,9,0.2222222222222222
388848818,1,7,1.0,8,0.125
388867262,1,9,1.0,10,0.1
388904830,1,7,1.0,8,0.125
388946042,1,18,1.0,19,0.05263157894736842
388949684,8,11,8.0,19,0.42105263157894735
388953245,3,7,3.0,10,0.3
388954690,1,9,1.0,10,0.1
388955801,6,4,4.0,10,0.4
388959025,5,5,5.0,10,0.5
388961368,3,7,3.0,10,0.3
388961706,1,8,1.0,9,0.1111111111111111
388997524,8,2,2.0,10,0.2
389003259,1,9,1.0,10,0.1
389009257,8,2,2.0,10,0.2
389023892,1,8,1.0,9,0.1111111111111111
389026566,28,2,2.0,30,0.06666666666666667
389071342,4,5,4.0,9,0.4444444444444444
389092459,2,8,2.0,10,0.2
389116550,1,7,1.0,8,0.125
389141212,1,9,1.0,10,0.1
389143736,1,7,1.0,8,0.125
389190499,1,9,1.0,10,0.1
389196607,5,5,5.0,10,0.5
389199127,1,8,1.0,9,0.1111111111111111
389251549,8,1,1.0,9,0.1111111111111111
389288999,1,7,1.0,8,0.125
389370083,1,7,1.0,8,0.125
389431965,1,9,1.0,10,0.1
389434117,3,6,3.0,9,0.3333333333333333
389446873,12,8,8.0,20,0.4
389450294,1,19,1.0,20,0.05
389461965,4,6,4.0,10,0.4
389468988,1,9,1.0,10,0.1
389472292,1,7,1.0,8,0.125
389474945,8,2,2.0,10,0.2
389521735,5,5,5.0,10,0.5
389522384,7,3,3.0,10,0.3
389529515,2,8,2.0,10,0.2
389549515,1,19,1.0,20,0.05
389562835,1,18,1.0,19,0.05263157894736842
389577147,1,23,1.0,24,0.041666666666666664
389581072,2,8,2.0,10,0.2
389603338,1,9,1.0,10,0.1
389608698,1,9,1.0,10,0.1
389612075,1,7,1.0,8,0.125
389612407,3,23,3.0,26,0.11538461538461539
389612747,5,5,5.0,10,0.5
389652752,7,1,1.0,8,0.125
389653463,4,5,4.0,9,0.4444444444444444
389670056,6,13,6.0,19,0.3157894736842105
389699259,4,6,4.0,10,0.4
389700354,1,9,1.0,10,0.1
389735078,1,9,1.0,10,0.1
389788295,1,8,1.0,9,0.1111111111111111
389789105,1,9,1.0,10,0.1
389809150,4,4,4.0,8,0.5
389818355,25,1,1.0,26,0.038461538461538464
389853255,18,10,10.0,28,0.35714285714285715
389853417,6,4,4.0,10,0.4
389861801,2,7,2.0,9,0.2222222222222222
389878491,1,9,1.0,10,0.1
389881599,4,13,4.0,17,0.23529411764705882
389888214,1,8,1.0,9,0.1111111111111111
389909618,1,9,1.0,10,0.1
389921495,1,19,1.0,20,0.05
389972189,3,17,3.0,20,0.15
389983298,1,16,1.0,17,0.058823529411764705
389997214,1,18,1.0,19,0.05263157894736842
390022526,1,8,1.0,9,0.1111111111111111
390051273,1,9,1.0,10,0.1
390119005,2,6,2.0,8,0.25
390168982,1,9,1.0,10,0.1
390210659,1,19,1.0,20,0.05
390211645,4,6,4.0,10,0.4
390231472,2,8,2.0,10,0.2
390232465,4,6,4.0,10,0.4
390244184,1,7,1.0,8,0.125
390291287,1,9,1.0,10,0.1
390318802,1,8,1.0,9,0.1111111111111111
390323487,8,2,2.0,10,0.2
390323590,1,8,1.0,9,0.1111111111111111
390326950,5,4,4.0,9,0.4444444444444444
390327434,1,9,1.0,10,0.1
390337048,2,6,2.0,8,0.25
390338923,7,20,7.0,27,0.25925925925925924
390340674,6,3,3.0,9,0.3333333333333333
390374881,7,12,7.0,19,0.3684210526315789
390391239,1,8,1.0,9,0.1111111111111111
390419582,1,9,1.0,10,0.1
390437788,6,4,4.0,10,0.4
390438805,2,7,2.0,9,0.2222222222222222
390439121,2,6,2.0,8,0.25
390439812,1,8,1.0,9,0.1111111111111111
390441909,6,20,6.0,26,0.23076923076923078
390486018,1,19,1.0,20,0.05
390506825,5,5,5.0,10,0.5
390507810,9,1,1.0,10,0.1
390508105,3,7,3.0,10,0.3
390509450,1,17,1.0,18,0.05555555555555555
390596105,1,9,1.0,10,0.1
390597426,1,7,1.0,8,0.125
390597726,2,8,2.0,10,0.2
390598280,1,8,1.0,9,0.1111111111111111
390598784,6,3,3.0,9,0.3333333333333333
390607912,2,7,2.0,9,0.2222222222222222
390607992,16,3,3.0,19,0.15789473684210525
390608184,1,9,1.0,10,0.1
390618084,1,9,1.0,10,0.1
390657685,6,2,2.0,8,0.25
390670948,1,9,1.0,10,0.1
390674835,3,16,3.0,19,0.15789473684210525
390680169,1,28,1.0,29,0.034482758620689655
390686588,1,9,1.0,10,0.1
390688980,1,8,1.0,9,0.1111111111111111
390695328,5,3,3.0,8,0.375
390696361,2,6,2.0,8,0.25
390697530,8,1,1.0,9,0.1111111111111111
390698081,6,22,6.0,28,0.21428571428571427
390698298,1,9,1.0,10,0.1
390698692,2,8,2.0,10,0.2
390723723,2,18,2.0,20,0.1
390742721,3,25,3.0,28,0.10714285714285714
390761844,1,19,1.0,20,0.05
390774939,1,8,1.0,9,0.1111111111111111
390781828,8,1,1.0,9,0.1111111111111111
390783720,3,7,3.0,10,0.3
390788656,4,6,4.0,10,0.4
390801507,3,5,3.0,8,0.375
390806682,7,3,3.0,10,0.3
390827931,4,16,4.0,20,0.2
390859441,1,8,1.0,9,0.1111111111111111
390898355,3,7,3.0,10,0.3
390901939,7,3,3.0,10,0.3
390911563,3,6,3.0,9,0.3333333333333333
390913347,3,6,3.0,9,0.3333333333333333
390916881,1,8,1.0,9,0.1111111111111111
390918967,5,5,5.0,10,0.5
390979290,2,8,2.0,10,0.2
390991262,12,7,7.0,19,0.3684210526315789
391037758,2,8,2.0,10,0.2
391095338,1,9,1.0,10,0.1
391122259,3,7,3.0,10,0.3
391124436,3,7,3.0,10,0.3
391141109,5,5,5.0,10,0.5
391142121,3,6,3.0,9,0.3333333333333333
391173882,2,8,2.0,10,0.2
391183023,2,8,2.0,10,0.2
391186610,2,8,2.0,10,0.2
391195364,1,7,1.0,8,0.125
391221509,4,6,4.0,10,0.4
391225306,1,8,1.0,9,0.1111111111111111
391247545,2,7,2.0,9,0.2222222222222222
391280492,7,13,7.0,20,0.35
391284626,3,7,3.0,10,0.3
391286280,8,12,8.0,20,0.4
391299927,2,8,2.0,10,0.2
391303493,2,7,2.0,9,0.2222222222222222
391304873,9,18,9.0,27,0.3333333333333333
391305515,2,8,2.0,10,0.2
391323161,8,2,2.0,10,0.2
391343559,1,9,1.0,10,0.1
391354195,1,9,1.0,10,0.1
391374432,2,7,2.0,9,0.2222222222222222
391374553,2,7,2.0,9,0.2222222222222222
391375372,2,8,2.0,10,0.2
391394213,1,17,1.0,18,0.05555555555555555
391458584,2,7,2.0,9,0.2222222222222222
391472036,1,18,1.0,19,0.05263157894736842
391472251,2,7,2.0,9,0.2222222222222222
391516723,3,5,3.0,8,0.375
391554261,1,9,1.0,10,0.1
391572038,1,17,1.0,18,0.05555555555555555
391579054,13,7,7.0,20,0.35
391620761,2,8,2.0,10,0.2
391635689,3,6,3.0,9,0.3333333333333333
391654301,1,8,1.0,9,0.1111111111111111
391682050,1,9,1.0,10,0.1
391684827,1,7,1.0,8,0.125
391684937,3,6,3.0,9,0.3333333333333333
391700769,3,7,3.0,10,0.3
391781038,1,8,1.0,9,0.1111111111111111
391782880,1,19,1.0,20,0.05
391793162,1,9,1.0,10,0.1
391831745,5,5,5.0,10,0.5
391835678,2,8,2.0,10,0.2
391877143,5,15,5.0,20,0.25
391901167,2,16,2.0,18,0.1111111111111111
391924778,1,18,1.0,19,0.05263157894736842
391945320,7,3,3.0,10,0.3
391958319,7,13,7.0,20,0.35
391960518,1,9,1.0,10,0.1
391989571,2,15,2.0,17,0.11764705882352941
392052096,1,7,1.0,8,0.125
392094688,2,8,2.0,10,0.2
392116636,1,9,1.0,10,0.1
392230632,10,20,10.0,30,0.3333333333333333
392299966,9,1,1.0,10,0.1
392300979,3,7,3.0,10,0.3
392301287,9,1,1.0,10,0.1
392309995,21,9,9.0,30,0.3
392314026,1,9,1.0,10,0.1
392317722,1,8,1.0,9,0.1111111111111111
392405655,2,8,2.0,10,0.2
392412568,2,8,2.0,10,0.2
392432345,1,9,1.0,10,0.1
392520101,4,6,4.0,10,0.4
392529739,8,2,2.0,10,0.2
392530705,9,1,1.0,10,0.1
392531402,5,4,4.0,9,0.4444444444444444
392532051,6,3,3.0,9,0.3333333333333333
392551253,9,1,1.0,10,0.1
392551353,6,3,3.0,9,0.3333333333333333
392578870,3,6,3.0,9,0.3333333333333333
392589059,9,1,1.0,10,0.1
392697548,1,9,1.0,10,0.1
392726280,8,1,1.0,9,0.1111111111111111
392752217,4,15,4.0,19,0.21052631578947367
392832535,1,19,1.0,20,0.05
392864690,1,7,1.0,8,0.125
392866932,1,9,1.0,10,0.1
392875564,1,15,1.0,16,0.0625
392878318,1,9,1.0,10,0.1
392923467,8,2,2.0,10,0.2
392928524,1,17,1.0,18,0.05555555555555555
392975609,8,2,2.0,10,0.2
392995481,1,7,1.0,8,0.125
392998644,3,7,3.0,10,0.3
393021863,2,7,2.0,9,0.2222222222222222
393037881,1,9,1.0,10,0.1
393046397,2,18,2.0,20,0.1
393047804,1,8,1.0,9,0.1111111111111111
393048655,2,7,2.0,9,0.2222222222222222
393051511,4,6,4.0,10,0.4
393059223,4,6,4.0,10,0.4
393079902,1,8,1.0,9,0.1111111111111111
393082209,4,5,4.0,9,0.4444444444444444
393085891,9,1,1.0,10,0.1
393105411,2,8,2.0,10,0.2
393105903,3,5,3.0,8,0.375
393107775,17,12,12.0,29,0.41379310344827586
393114292,6,3,3.0,9,0.3333333333333333
393127199,1,18,1.0,19,0.05263157894736842
393189268,2,8,2.0,10,0.2
393229745,1,19,1.0,20,0.05
393230262,1,8,1.0,9,0.1111111111111111
393232649,1,9,1.0,10,0.1
393241471,1,9,1.0,10,0.1
393271338,1,9,1.0,10,0.1
393291821,4,6,4.0,10,0.4
393298214,1,8,1.0,9,0.1111111111111111
393301404,1,8,1.0,9,0.1111111111111111
393310026,1,17,1.0,18,0.05555555555555555
393327987,1,9,1.0,10,0.1
393365076,2,8,2.0,10,0.2
393375899,2,7,2.0,9,0.2222222222222222
393376447,2,8,2.0,10,0.2
393377269,1,9,1.0,10,0.1
393384668,1,9,1.0,10,0.1
393384840,1,9,1.0,10,0.1
393385157,2,8,2.0,10,0.2
393388026,1,7,1.0,8,0.125
393405239,1,9,1.0,10,0.1
393406591,6,12,6.0,18,0.3333333333333333
393411892,8,2,2.0,10,0.2
393417700,2,7,2.0,9,0.2222222222222222
393434074,4,6,4.0,10,0.4
393437708,6,4,4.0,10,0.4
393445807,6,4,4.0,10,0.4
393454371,4,6,4.0,10,0.4
393469276,2,7,2.0,9,0.2222222222222222
393501261,4,6,4.0,10,0.4
393516559,3,7,3.0,10,0.3
393519310,1,7,1.0,8,0.125
393573545,1,8,1.0,9,0.1111111111111111
393580244,3,7,3.0,10,0.3
393594621,6,3,3.0,9,0.3333333333333333
393594718,7,2,2.0,9,0.2222222222222222
393594790,1,19,1.0,20,0.05
393608879,1,9,1.0,10,0.1
393609212,1,28,1.0,29,0.034482758620689655
393626832,5,23,5.0,28,0.17857142857142858
393654934,9,1,1.0,10,0.1
393670119,1,9,1.0,10,0.1
393721487,3,6,3.0,9,0.3333333333333333
393740011,27,1,1.0,28,0.03571428571428571
393760348,1,8,1.0,9,0.1111111111111111
393782834,3,6,3.0,9,0.3333333333333333
393783752,7,2,2.0,9,0.2222222222222222
393799733,1,9,1.0,10,0.1
393842504,3,7,3.0,10,0.3
393852172,4,6,4.0,10,0.4
393865586,2,7,2.0,9,0.2222222222222222
393888989,8,2,2.0,10,0.2
393893825,25,5,5.0,30,0.16666666666666666
393980150,1,19,1.0,20,0.05
393992676,1,8,1.0,9,0.1111111111111111
393995748,3,7,3.0,10,0.3
394019403,7,2,2.0,9,0.2222222222222222
394020820,6,3,3.0,9,0.3333333333333333
394021623,1,9,1.0,10,0.1
394110740,1,9,1.0,10,0.1
394180336,5,15,5.0,20,0.25
394189103,3,17,3.0,20,0.15
394206319,1,9,1.0,10,0.1
394217397,8,2,2.0,10,0.2
394219265,8,2,2.0,10,0.2
394219456,8,2,2.0,10,0.2
394219681,5,5,5.0,10,0.5
394220253,1,9,1.0,10,0.1
394221128,3,24,3.0,27,0.1111111111111111
394221541,5,4,4.0,9,0.4444444444444444
394222675,6,4,4.0,10,0.4
394233643,8,11,8.0,19,0.42105263157894735
394234225,2,8,2.0,10,0.2
394259249,1,9,1.0,10,0.1
394287492,3,7,3.0,10,0.3
394324402,4,6,4.0,10,0.4
394326366,8,2,2.0,10,0.2
394334831,2,7,2.0,9,0.2222222222222222
394334898,1,9,1.0,10,0.1
394334986,4,6,4.0,10,0.4
394335076,3,6,3.0,9,0.3333333333333333
394354952,2,8,2.0,10,0.2
394361432,1,7,1.0,8,0.125
394362846,5,4,4.0,9,0.4444444444444444
394382550,2,7,2.0,9,0.2222222222222222
394397334,1,18,1.0,19,0.05263157894736842
394423462,1,17,1.0,18,0.05555555555555555
394427435,1,9,1.0,10,0.1
394476582,7,3,3.0,10,0.3
394481038,8,1,1.0,9,0.1111111111111111
394484795,5,4,4.0,9,0.4444444444444444
394487670,2,8,2.0,10,0.2
394519771,1,9,1.0,10,0.1
394555841,7,2,2.0,9,0.2222222222222222
394566989,1,9,1.0,10,0.1
394567159,1,19,1.0,20,0.05
394567788,1,8,1.0,9,0.1111111111111111
394569304,2,7,2.0,9,0.2222222222222222
394569984,1,9,1.0,10,0.1
394572968,1,8,1.0,9,0.1111111111111111
394577217,3,7,3.0,10,0.3
394618023,2,8,2.0,10,0.2
394636050,2,26,2.0,28,0.07142857142857142
394643077,2,7,2.0,9,0.2222222222222222
394648248,1,9,1.0,10,0.1
394648648,8,1,1.0,9,0.1111111111111111
394653391,3,22,3.0,25,0.12
394656467,7,2,2.0,9,0.2222222222222222
394657483,3,7,3.0,10,0.3
394660541,4,6,4.0,10,0.4
394660760,15,12,12.0,27,0.4444444444444444
394661015,5,4,4.0,9,0.4444444444444444
394661201,8,2,2.0,10,0.2
394661460,5,5,5.0,10,0.5
394663566,1,9,1.0,10,0.1
394664305,1,18,1.0,19,0.05263157894736842
394664792,2,8,2.0,10,0.2
394673197,9,1,1.0,10,0.1
394678089,3,7,3.0,10,0.3
394680558,1,18,1.0,19,0.05263157894736842
394680620,2,8,2.0,10,0.2
394726729,1,8,1.0,9,0.1111111111111111
394738745,27,2,2.0,29,0.06896551724137931
394758566,2,7,2.0,9,0.2222222222222222
394806891,2,7,2.0,9,0.2222222222222222
394848949,1,8,1.0,9,0.1111111111111111
394849386,5,4,4.0,9,0.4444444444444444
394858282,5,5,5.0,10,0.5
394858920,4,6,4.0,10,0.4
394864465,1,9,1.0,10,0.1
394866403,2,8,2.0,10,0.2
394866775,2,8,2.0,10,0.2
394881643,1,9,1.0,10,0.1
394900220,2,26,2.0,28,0.07142857142857142
394902815,1,9,1.0,10,0.1
394904101,4,6,4.0,10,0.4
394923091,3,5,3.0,8,0.375
394934765,7,2,2.0,9,0.2222222222222222
394936291,1,9,1.0,10,0.1
394937062,2,8,2.0,10,0.2
394945246,1,8,1.0,9,0.1111111111111111
394993702,1,9,1.0,10,0.1
394997168,1,8,1.0,9,0.1111111111111111
394998354,2,7,2.0,9,0.2222222222222222
395004574,5,14,5.0,19,0.2631578947368421
395015535,9,1,1.0,10,0.1
395025987,1,7,1.0,8,0.125
395029030,1,7,1.0,8,0.125
395062139,7,3,3.0,10,0.3
395064873,2,7,2.0,9,0.2222222222222222
395066037,5,4,4.0,9,0.4444444444444444
395066257,7,3,3.0,10,0.3
395074098,4,6,4.0,10,0.4
395074503,7,3,3.0,10,0.3
395079626,8,2,2.0,10,0.2
395079645,9,1,1.0,10,0.1
395095460,2,7,2.0,9,0.2222222222222222
395098684,1,17,1.0,18,0.05555555555555555
395179806,16,2,2.0,18,0.1111111111111111
395194328,1,19,1.0,20,0.05
395196414,6,4,4.0,10,0.4
395227876,1,9,1.0,10,0.1
395239647,3,7,3.0,10,0.3
395252778,6,3,3.0,9,0.3333333333333333
395253321,6,4,4.0,10,0.4
395253979,9,1,1.0,10,0.1
395257406,3,7,3.0,10,0.3
395259211,1,9,1.0,10,0.1
395259372,3,7,3.0,10,0.3
395259943,3,7,3.0,10,0.3
395260685,3,6,3.0,9,0.3333333333333333
395261445,1,9,1.0,10,0.1
395271926,2,7,2.0,9,0.2222222222222222
395319168,1,9,1.0,10,0.1
395320157,1,9,1.0,10,0.1
395371481,10,18,10.0,28,0.35714285714285715
395374878,1,19,1.0,20,0.05
395392687,1,8,1.0,9,0.1111111111111111
395422592,3,7,3.0,10,0.3
395424772,1,9,1.0,10,0.1
395425866,1,9,1.0,10,0.1
395432763,7,3,3.0,10,0.3
395433559,8,2,2.0,10,0.2
395434682,1,9,1.0,10,0.1
395453861,2,7,2.0,9,0.2222222222222222
395454987,1,8,1.0,9,0.1111111111111111
395458891,4,6,4.0,10,0.4
395481040,3,7,3.0,10,0.3
395481397,1,28,1.0,29,0.034482758620689655
395492584,2,7,2.0,9,0.2222222222222222
395567050,1,9,1.0,10,0.1
395585930,2,8,2.0,10,0.2
395618616,13,14,13.0,27,0.48148148148148145
395628157,5,5,5.0,10,0.5
395657042,4,5,4.0,9,0.4444444444444444
395676083,1,8,1.0,9,0.1111111111111111
395677270,1,9,1.0,10,0.1
395680587,5,25,5.0,30,0.16666666666666666
395683828,3,7,3.0,10,0.3
395684141,2,8,2.0,10,0.2
395743004,29,1,1.0,30,0.03333333333333333
395746618,1,9,1.0,10,0.1
395753623,3,7,3.0,10,0.3
395758098,1,9,1.0,10,0.1
395760482,5,5,5.0,10,0.5
395763142,2,8,2.0,10,0.2
395765620,8,21,8.0,29,0.27586206896551724
395765864,8,2,2.0,10,0.2
395790778,1,8,1.0,9,0.1111111111111111
395793712,1,9,1.0,10,0.1
395850174,8,2,2.0,10,0.2
395885803,1,9,1.0,10,0.1
395935262,5,15,5.0,20,0.25
395963419,1,9,1.0,10,0.1
395966814,1,19,1.0,20,0.05
395967240,1,8,1.0,9,0.1111111111111111
396041471,2,8,2.0,10,0.2
396042195,1,8,1.0,9,0.1111111111111111
396042959,1,9,1.0,10,0.1
396092012,4,5,4.0,9,0.4444444444444444
396122738,1,9,1.0,10,0.1
396135461,3,7,3.0,10,0.3
396145023,1,8,1.0,9,0.1111111111111111
396145272,2,8,2.0,10,0.2
396154256,1,7,1.0,8,0.125
396156530,1,9,1.0,10,0.1
396157729,1,7,1.0,8,0.125
396176186,1,8,1.0,9,0.1111111111111111
396180699,9,1,1.0,10,0.1
396183106,5,4,4.0,9,0.4444444444444444
396183505,1,7,1.0,8,0.125
396199875,2,27,2.0,29,0.06896551724137931
396204280,2,16,2.0,18,0.1111111111111111
396217464,2,8,2.0,10,0.2
396226145,4,5,4.0,9,0.4444444444444444
396227115,4,5,4.0,9,0.4444444444444444
396227579,3,6,3.0,9,0.3333333333333333
396233713,2,8,2.0,10,0.2
396235107,1,7,1.0,8,0.125
396235686,1,9,1.0,10,0.1
396240724,6,4,4.0,10,0.4
396245117,4,6,4.0,10,0.4
396247829,5,5,5.0,10,0.5
396260510,5,14,5.0,19,0.2631578947368421
396299317,2,8,2.0,10,0.2
396317795,3,5,3.0,8,0.375
396367269,1,9,1.0,10,0.1
396382289,1,8,1.0,9,0.1111111111111111
396408839,7,11,7.0,18,0.3888888888888889
396507513,2,8,2.0,10,0.2
396521135,1,9,1.0,10,0.1
396559033,1,8,1.0,9,0.1111111111111111
396590671,1,9,1.0,10,0.1
396600757,6,4,4.0,10,0.4
396603158,5,5,5.0,10,0.5
396603726,1,9,1.0,10,0.1
396620539,2,8,2.0,10,0.2
396626700,2,8,2.0,10,0.2
396630335,2,8,2.0,10,0.2
396632765,1,9,1.0,10,0.1
396640492,1,19,1.0,20,0.05
396664119,3,7,3.0,10,0.3
396678505,2,8,2.0,10,0.2
396679913,8,1,1.0,9,0.1111111111111111
396682507,7,3,3.0,10,0.3
396702143,1,9,1.0,10,0.1
396710484,2,8,2.0,10,0.2
396740830,1,9,1.0,10,0.1
396744291,1,7,1.0,8,0.125
396784266,2,17,2.0,19,0.10526315789473684
396787016,2,8,2.0,10,0.2
396793560,7,3,3.0,10,0.3
396794124,7,2,2.0,9,0.2222222222222222
396795467,8,2,2.0,10,0.2
396804359,1,16,1.0,17,0.058823529411764705
396807349,1,8,1.0,9,0.1111111111111111
396822564,3,6,3.0,9,0.3333333333333333
396834030,1,8,1.0,9,0.1111111111111111
396835546,6,3,3.0,9,0.3333333333333333
396871727,1,17,1.0,18,0.05555555555555555
396887269,5,5,5.0,10,0.5
396934923,1,8,1.0,9,0.1111111111111111
396947017,1,9,1.0,10,0.1
396951416,1,9,1.0,10,0.1
396954019,2,8,2.0,10,0.2
396976355,7,3,3.0,10,0.3
397011346,2,18,2.0,20,0.1
397012310,1,9,1.0,10,0.1
397013269,1,18,1.0,19,0.05263157894736842
397019244,1,8,1.0,9,0.1111111111111111
397020083,1,9,1.0,10,0.1
397047433,8,2,2.0,10,0.2
397117319,1,9,1.0,10,0.1
397137562,1,18,1.0,19,0.05263157894736842
397150474,9,1,1.0,10,0.1
397152230,8,2,2.0,10,0.2
397171366,9,1,1.0,10,0.1
397171547,1,8,1.0,9,0.1111111111111111
397171683,4,5,4.0,9,0.4444444444444444
397217043,2,8,2.0,10,0.2
397219227,1,9,1.0,10,0.1
397222217,3,16,3.0,19,0.15789473684210525
397222696,1,8,1.0,9,0.1111111111111111
397232877,1,9,1.0,10,0.1
397259663,2,7,2.0,9,0.2222222222222222
397357988,3,7,3.0,10,0.3
397386049,1,17,1.0,18,0.05555555555555555
397400047,1,18,1.0,19,0.05263157894736842
397409856,2,7,2.0,9,0.2222222222222222
397414196,1,9,1.0,10,0.1
397461278,1,9,1.0,10,0.1
397472611,1,18,1.0,19,0.05263157894736842
397510814,7,2,2.0,9,0.2222222222222222
397525306,1,9,1.0,10,0.1
397527395,3,7,3.0,10,0.3
397547282,5,22,5.0,27,0.18518518518518517
397547524,1,9,1.0,10,0.1
397549554,3,6,3.0,9,0.3333333333333333
397549748,1,9,1.0,10,0.1
397552798,2,6,2.0,8,0.25
397559427,2,6,2.0,8,0.25
397559952,2,8,2.0,10,0.2
397560791,11,16,11.0,27,0.4074074074074074
397571079,2,26,2.0,28,0.07142857142857142
397608440,6,4,4.0,10,0.4
397608769,4,5,4.0,9,0.4444444444444444
397639486,1,9,1.0,10,0.1
397656983,4,6,4.0,10,0.4
397671582,1,19,1.0,20,0.05
397699329,1,8,1.0,9,0.1111111111111111
397717754,1,8,1.0,9,0.1111111111111111
397718104,3,6,3.0,9,0.3333333333333333
397718906,2,7,2.0,9,0.2222222222222222
397722346,4,5,4.0,9,0.4444444444444444
397726284,2,8,2.0,10,0.2
397735315,1,29,1.0,30,0.03333333333333333
397751946,8,2,2.0,10,0.2
397793464,1,9,1.0,10,0.1
397805344,3,16,3.0,19,0.15789473684210525
397813096,1,19,1.0,20,0.05
397813320,1,8,1.0,9,0.1111111111111111
397829291,1,8,1.0,9,0.1111111111111111
397829781,6,3,3.0,9,0.3333333333333333
397830581,3,7,3.0,10,0.3
397870800,5,5,5.0,10,0.5
397874736,27,3,3.0,30,0.1
397875849,9,1,1.0,10,0.1
397876386,2,26,2.0,28,0.07142857142857142
397880461,1,9,1.0,10,0.1
397881463,2,8,2.0,10,0.2
397887438,2,7,2.0,9,0.2222222222222222
397920565,1,18,1.0,19,0.05263157894736842
397927827,1,26,1.0,27,0.037037037037037035
397932760,1,19,1.0,20,0.05
397933677,4,6,4.0,10,0.4
397934505,2,8,2.0,10,0.2
397948829,2,16,2.0,18,0.1111111111111111
397950397,1,18,1.0,19,0.05263157894736842
397970843,3,6,3.0,9,0.3333333333333333
397971441,3,6,3.0,9,0.3333333333333333
397994318,1,8,1.0,9,0.1111111111111111
397995041,1,19,1.0,20,0.05
397995535,8,2,2.0,10,0.2
397995828,7,3,3.0,10,0.3
397996508,1,9,1.0,10,0.1
398007696,3,5,3.0,8,0.375
398008517,4,6,4.0,10,0.4
398028933,1,7,1.0,8,0.125
398041571,2,8,2.0,10,0.2
398055723,9,1,1.0,10,0.1
398059195,2,8,2.0,10,0.2
398077342,1,9,1.0,10,0.1
398081265,4,6,4.0,10,0.4
398086031,1,9,1.0,10,0.1
398087050,1,9,1.0,10,0.1
398094957,2,8,2.0,10,0.2
398125710,1,9,1.0,10,0.1
398126657,1,9,1.0,10,0.1
398142503,1,7,1.0,8,0.125
398206107,9,1,1.0,10,0.1
398219926,2,8,2.0,10,0.2
398220507,26,1,1.0,27,0.037037037037037035
398273363,1,9,1.0,10,0.1
398291045,23,5,5.0,28,0.17857142857142858
398308174,5,4,4.0,9,0.4444444444444444
398312076,7,21,7.0,28,0.25
398312206,26,1,1.0,27,0.037037037037037035
398320603,1,9,1.0,10,0.1
398324498,1,8,1.0,9,0.1111111111111111
398326122,1,9,1.0,10,0.1
398360605,3,6,3.0,9,0.3333333333333333
398369714,1,9,1.0,10,0.1
398374293,2,8,2.0,10,0.2
398375039,5,4,4.0,9,0.4444444444444444
398382390,7,3,3.0,10,0.3
398385623,1,8,1.0,9,0.1111111111111111
398391238,4,6,4.0,10,0.4
398399926,4,16,4.0,20,0.2
398419210,5,5,5.0,10,0.5
398444564,2,7,2.0,9,0.2222222222222222
398456869,2,8,2.0,10,0.2
398460417,1,9,1.0,10,0.1
398461858,3,7,3.0,10,0.3
398465225,3,5,3.0,8,0.375
398478181,1,8,1.0,9,0.1111111111111111
398494557,5,14,5.0,19,0.2631578947368421
398495371,1,19,1.0,20,0.05
398500714,1,9,1.0,10,0.1
398508982,1,9,1.0,10,0.1
398566430,1,19,1.0,20,0.05
398566687,1,8,1.0,9,0.1111111111111111
398587793,3,7,3.0,10,0.3
398601475,2,7,2.0,9,0.2222222222222222
398631835,1,9,1.0,10,0.1
398639758,9,1,1.0,10,0.1
398658268,2,18,2.0,20,0.1
398679078,1,9,1.0,10,0.1
398685692,3,7,3.0,10,0.3
398687242,2,7,2.0,9,0.2222222222222222
398690250,1,8,1.0,9,0.1111111111111111
398698099,6,3,3.0,9,0.3333333333333333
398710980,6,4,4.0,10,0.4
398711308,4,6,4.0,10,0.4
398728150,1,17,1.0,18,0.05555555555555555
398772354,5,5,5.0,10,0.5
398810921,1,7,1.0,8,0.125
398812914,1,8,1.0,9,0.1111111111111111
398855242,1,8,1.0,9,0.1111111111111111
398860463,1,19,1.0,20,0.05
398865770,7,3,3.0,10,0.3
398875974,6,3,3.0,9,0.3333333333333333
398876099,2,8,2.0,10,0.2
398876872,3,6,3.0,9,0.3333333333333333
398877046,16,12,12.0,28,0.42857142857142855
398879739,5,5,5.0,10,0.5
398884046,7,3,3.0,10,0.3
398890671,1,9,1.0,10,0.1
398922680,4,5,4.0,9,0.4444444444444444
398938140,1,8,1.0,9,0.1111111111111111
398949915,1,8,1.0,9,0.1111111111111111
398969653,3,7,3.0,10,0.3
398978935,1,9,1.0,10,0.1
398987566,3,6,3.0,9,0.3333333333333333
398988754,1,9,1.0,10,0.1
398989694,6,22,6.0,28,0.21428571428571427
398991692,1,7,1.0,8,0.125
399005418,2,7,2.0,9,0.2222222222222222
399007253,1,8,1.0,9,0.1111111111111111
399012875,2,7,2.0,9,0.2222222222222222
399033679,1,9,1.0,10,0.1
399048247,1,17,1.0,18,0.05555555555555555
399057047,2,8,2.0,10,0.2
399058049,18,10,10.0,28,0.35714285714285715
399073013,7,3,3.0,10,0.3
399078585,4,16,4.0,20,0.2
399079363,1,8,1.0,9,0.1111111111111111
399081103,2,8,2.0,10,0.2
399090165,3,6,3.0,9,0.3333333333333333
399111267,7,3,3.0,10,0.3
399111751,1,9,1.0,10,0.1
399112602,2,8,2.0,10,0.2
399127374,2,8,2.0,10,0.2
399151306,3,7,3.0,10,0.3
399186554,2,8,2.0,10,0.2
399206066,3,7,3.0,10,0.3
399236473,5,22,5.0,27,0.18518518518518517
399237538,2,8,2.0,10,0.2
399238922,8,1,1.0,9,0.1111111111111111
399241936,9,1,1.0,10,0.1
399243816,1,18,1.0,19,0.05263157894736842
399294086,1,9,1.0,10,0.1
399310676,1,9,1.0,10,0.1
399323752,6,3,3.0,9,0.3333333333333333
399325142,9,1,1.0,10,0.1
399378606,5,5,5.0,10,0.5
399381785,1,9,1.0,10,0.1
399406259,1,7,1.0,8,0.125
399438463,3,7,3.0,10,0.3
399480113,1,9,1.0,10,0.1
399487447,9,1,1.0,10,0.1
399508491,1,9,1.0,10,0.1
399526259,1,9,1.0,10,0.1
399592249,13,7,7.0,20,0.35
399593625,1,8,1.0,9,0.1111111111111111
399634850,3,17,3.0,20,0.15
399636319,3,17,3.0,20,0.15
399636552,2,18,2.0,20,0.1
399645086,1,8,1.0,9,0.1111111111111111
399647531,1,9,1.0,10,0.1
399660982,3,6,3.0,9,0.3333333333333333
399662753,6,4,4.0,10,0.4
399666897,3,7,3.0,10,0.3
399667377,1,8,1.0,9,0.1111111111111111
399670423,1,8,1.0,9,0.1111111111111111
399681881,5,4,4.0,9,0.4444444444444444
399683731,1,9,1.0,10,0.1
399684286,3,16,3.0,19,0.15789473684210525
399706013,3,6,3.0,9,0.3333333333333333
399729043,1,9,1.0,10,0.1
399732687,5,4,4.0,9,0.4444444444444444
399733298,1,8,1.0,9,0.1111111111111111
399734003,4,6,4.0,10,0.4
399734596,3,6,3.0,9,0.3333333333333333
399735681,27,1,1.0,28,0.03571428571428571
399741078,3,6,3.0,9,0.3333333333333333
399755330,1,8,1.0,9,0.1111111111111111
399755952,2,8,2.0,10,0.2
399758439,8,2,2.0,10,0.2
399812641,1,8,1.0,9,0.1111111111111111
399828069,9,1,1.0,10,0.1
399843244,3,7,3.0,10,0.3
399848855,6,22,6.0,28,0.21428571428571427
399851302,1,19,1.0,20,0.05
399865156,2,16,2.0,18,0.1111111111111111
399868511,2,8,2.0,10,0.2
399876417,7,3,3.0,10,0.3
399909462,7,3,3.0,10,0.3
399915782,2,8,2.0,10,0.2
399955680,1,9,1.0,10,0.1
400008237,2,7,2.0,9,0.2222222222222222
400008434,1,9,1.0,10,0.1
400041499,1,9,1.0,10,0.1
400044096,2,8,2.0,10,0.2
400051572,3,16,3.0,19,0.15789473684210525
400057987,2,8,2.0,10,0.2
400093613,2,8,2.0,10,0.2
400098794,6,4,4.0,10,0.4
400115604,13,16,13.0,29,0.4482758620689655
400117587,13,15,13.0,28,0.4642857142857143
400146760,2,8,2.0,10,0.2
400168029,3,7,3.0,10,0.3
400182585,2,8,2.0,10,0.2
400183695,1,9,1.0,10,0.1
400194236,1,9,1.0,10,0.1
400202520,1,9,1.0,10,0.1
400218870,2,8,2.0,10,0.2
400219792,4,6,4.0,10,0.4
400250542,1,17,1.0,18,0.05555555555555555
400274673,1,9,1.0,10,0.1
400319858,3,6,3.0,9,0.3333333333333333
400334613,5,3,3.0,8,0.375
400339153,4,5,4.0,9,0.4444444444444444
400359061,1,9,1.0,10,0.1
400363376,2,24,2.0,26,0.07692307692307693
400369387,1,16,1.0,17,0.058823529411764705
400409769,2,8,2.0,10,0.2
400432433,1,9,1.0,10,0.1
400480147,1,9,1.0,10,0.1
400495006,1,8,1.0,9,0.1111111111111111
400512747,3,6,3.0,9,0.3333333333333333
400514339,10,9,9.0,19,0.47368421052631576
400514684,5,4,4.0,9,0.4444444444444444
400514976,8,2,2.0,10,0.2
400525493,7,3,3.0,10,0.3
400525612,8,2,2.0,10,0.2
400526160,8,2,2.0,10,0.2
400526332,14,14,14.0,28,0.5
400543714,1,9,1.0,10,0.1
400544374,1,8,1.0,9,0.1111111111111111
400545155,2,7,2.0,9,0.2222222222222222
400545192,1,7,1.0,8,0.125
400547306,1,9,1.0,10,0.1
400548190,3,5,3.0,8,0.375
400553256,8,1,1.0,9,0.1111111111111111
400553530,4,6,4.0,10,0.4
400556329,1,8,1.0,9,0.1111111111111111
400594113,1,9,1.0,10,0.1
400603590,1,9,1.0,10,0.1
400605991,2,8,2.0,10,0.2
400622795,1,16,1.0,17,0.058823529411764705
400633166,2,8,2.0,10,0.2
400641201,3,26,3.0,29,0.10344827586206896
400642572,1,9,1.0,10,0.1
400645954,5,5,5.0,10,0.5
400646165,8,19,8.0,27,0.2962962962962963
400646269,6,3,3.0,9,0.3333333333333333
400647258,1,9,1.0,10,0.1
400647898,6,22,6.0,28,0.21428571428571427
400647977,1,9,1.0,10,0.1
400648808,2,8,2.0,10,0.2
400650009,4,6,4.0,10,0.4
400671571,1,8,1.0,9,0.1111111111111111
400706758,1,8,1.0,9,0.1111111111111111
400708625,1,17,1.0,18,0.05555555555555555
400719508,1,7,1.0,8,0.125
400726765,1,8,1.0,9,0.1111111111111111
400772754,1,9,1.0,10,0.1
400778528,27,1,1.0,28,0.03571428571428571
400795701,1,9,1.0,10,0.1
400800089,6,2,2.0,8,0.25
400802199,8,1,1.0,9,0.1111111111111111
400814391,1,9,1.0,10,0.1
400818020,1,8,1.0,9,0.1111111111111111
400840773,8,11,8.0,19,0.42105263157894735
400842698,1,9,1.0,10,0.1
400843685,1,8,1.0,9,0.1111111111111111
400872667,3,7,3.0,10,0.3
400876893,8,2,2.0,10,0.2
400914461,2,16,2.0,18,0.1111111111111111
400930157,2,8,2.0,10,0.2
400930572,1,8,1.0,9,0.1111111111111111
400952783,2,8,2.0,10,0.2
400958302,1,9,1.0,10,0.1
400958507,4,5,4.0,9,0.4444444444444444
400958590,1,9,1.0,10,0.1
400962009,4,6,4.0,10,0.4
400963976,2,8,2.0,10,0.2
400966145,9,1,1.0,10,0.1
400966226,6,3,3.0,9,0.3333333333333333
400969282,5,4,4.0,9,0.4444444444444444
400969575,8,1,1.0,9,0.1111111111111111
400972154,5,5,5.0,10,0.5
400973543,4,4,4.0,8,0.5
400983978,5,25,5.0,30,0.16666666666666666
400997742,2,8,2.0,10,0.2
401000119,24,4,4.0,28,0.14285714285714285
401000251,7,2,2.0,9,0.2222222222222222
401000391,3,7,3.0,10,0.3
401000432,2,8,2.0,10,0.2
401009367,1,9,1.0,10,0.1
401010869,2,8,2.0,10,0.2
401011520,3,16,3.0,19,0.15789473684210525
401045824,1,9,1.0,10,0.1
401056304,1,9,1.0,10,0.1
401064107,1,8,1.0,9,0.1111111111111111
401093758,4,6,4.0,10,0.4
401111357,3,7,3.0,10,0.3
401133292,1,18,1.0,19,0.05263157894736842
401156642,3,6,3.0,9,0.3333333333333333
401186277,4,5,4.0,9,0.4444444444444444
401193698,2,27,2.0,29,0.06896551724137931
401206342,8,1,1.0,9,0.1111111111111111
401214806,2,8,2.0,10,0.2
401218200,2,7,2.0,9,0.2222222222222222
401225692,2,6,2.0,8,0.25
401246965,3,7,3.0,10,0.3
401248219,2,8,2.0,10,0.2
401264922,1,7,1.0,8,0.125
401274757,1,9,1.0,10,0.1
401278279,3,6,3.0,9,0.3333333333333333
401278693,3,6,3.0,9,0.3333333333333333
401280168,5,5,5.0,10,0.5
401288084,4,6,4.0,10,0.4
401292362,6,4,4.0,10,0.4
401308856,3,7,3.0,10,0.3
401328585,1,8,1.0,9,0.1111111111111111
401328937,3,16,3.0,19,0.15789473684210525
401333141,4,6,4.0,10,0.4
401348746,2,18,2.0,20,0.1
401396062,1,8,1.0,9,0.1111111111111111
401449471,4,5,4.0,9,0.4444444444444444
401492232,1,8,1.0,9,0.1111111111111111
401512389,1,9,1.0,10,0.1
401513801,1,9,1.0,10,0.1
401540079,3,6,3.0,9,0.3333333333333333
401545067,1,9,1.0,10,0.1
401580550,1,8,1.0,9,0.1111111111111111
401585921,2,7,2.0,9,0.2222222222222222
401587790,3,7,3.0,10,0.3
401589428,5,5,5.0,10,0.5
401590066,2,7,2.0,9,0.2222222222222222
401591180,1,9,1.0,10,0.1
401592804,4,6,4.0,10,0.4
401620933,2,7,2.0,9,0.2222222222222222
401672587,5,5,5.0,10,0.5
401675354,1,18,1.0,19,0.05263157894736842
401678665,3,16,3.0,19,0.15789473684210525
401688342,1,9,1.0,10,0.1
401689555,1,19,1.0,20,0.05
401709077,8,2,2.0,10,0.2
401743914,1,8,1.0,9,0.1111111111111111
401759475,3,7,3.0,10,0.3
401767857,2,17,2.0,19,0.10526315789473684
401778711,21,7,7.0,28,0.25
401779944,6,3,3.0,9,0.3333333333333333
401780225,7,3,3.0,10,0.3
401829786,1,9,1.0,10,0.1
401871797,1,9,1.0,10,0.1
401882450,3,6,3.0,9,0.3333333333333333
401914173,1,9,1.0,10,0.1
401937740,1,17,1.0,18,0.05555555555555555
402022345,3,7,3.0,10,0.3
402045769,8,2,2.0,10,0.2
402170701,1,9,1.0,10,0.1
402177787,1,9,1.0,10,0.1
402180417,1,9,1.0,10,0.1
402182469,1,19,1.0,20,0.05
402267455,7,3,3.0,10,0.3
402288025,1,9,1.0,10,0.1
402290735,2,8,2.0,10,0.2
402315674,1,19,1.0,20,0.05
402336041,1,9,1.0,10,0.1
402360941,4,6,4.0,10,0.4
402363183,9,1,1.0,10,0.1
402417835,2,7,2.0,9,0.2222222222222222
402435349,5,5,5.0,10,0.5
402435453,1,8,1.0,9,0.1111111111111111
402441637,2,17,2.0,19,0.10526315789473684
402472818,1,8,1.0,9,0.1111111111111111
402504986,1,8,1.0,9,0.1111111111111111
402530957,1,9,1.0,10,0.1
402531033,8,2,2.0,10,0.2
402531801,5,15,5.0,20,0.25
402531811,4,5,4.0,9,0.4444444444444444
402542710,5,5,5.0,10,0.5
402562473,1,9,1.0,10,0.1
402574304,1,28,1.0,29,0.034482758620689655
402576851,3,6,3.0,9,0.3333333333333333
402628174,1,9,1.0,10,0.1
402634134,1,8,1.0,9,0.1111111111111111
402638531,1,8,1.0,9,0.1111111111111111
402640228,1,8,1.0,9,0.1111111111111111
402641814,3,6,3.0,9,0.3333333333333333
402647698,2,8,2.0,10,0.2
402671115,9,10,9.0,19,0.47368421052631576
402698775,1,9,1.0,10,0.1
402701041,9,19,9.0,28,0.32142857142857145
402759382,1,8,1.0,9,0.1111111111111111
402768849,1,9,1.0,10,0.1
402782013,4,6,4.0,10,0.4
402784840,3,7,3.0,10,0.3
402802864,2,18,2.0,20,0.1
402811685,1,19,1.0,20,0.05
402846275,1,9,1.0,10,0.1
402863248,3,5,3.0,8,0.375
402884251,6,4,4.0,10,0.4
402884696,3,7,3.0,10,0.3
402887186,2,8,2.0,10,0.2
402887939,6,2,2.0,8,0.25
402963692,3,6,3.0,9,0.3333333333333333
402984565,2,7,2.0,9,0.2222222222222222
402984724,5,5,5.0,10,0.5
403031243,2,8,2.0,10,0.2
403048256,1,9,1.0,10,0.1
403048473,1,8,1.0,9,0.1111111111111111
403068434,2,7,2.0,9,0.2222222222222222
403069080,2,7,2.0,9,0.2222222222222222
403075764,2,8,2.0,10,0.2
403078814,1,18,1.0,19,0.05263157894736842
403078954,4,6,4.0,10,0.4
403186298,1,8,1.0,9,0.1111111111111111
403198613,6,4,4.0,10,0.4
403215016,1,19,1.0,20,0.05
403215776,2,7,2.0,9,0.2222222222222222
403232129,7,3,3.0,10,0.3
403237718,2,8,2.0,10,0.2
403246066,3,7,3.0,10,0.3
403268652,1,9,1.0,10,0.1
403295683,1,9,1.0,10,0.1
403298137,1,8,1.0,9,0.1111111111111111
403316234,1,8,1.0,9,0.1111111111111111
403323621,1,9,1.0,10,0.1
403345346,1,9,1.0,10,0.1
403369505,2,8,2.0,10,0.2
403374511,8,2,2.0,10,0.2
403375138,1,9,1.0,10,0.1
403382505,1,9,1.0,10,0.1
403405800,1,9,1.0,10,0.1
403421638,7,3,3.0,10,0.3
403423138,1,9,1.0,10,0.1
403443615,1,8,1.0,9,0.1111111111111111
403454957,2,8,2.0,10,0.2
403473655,1,9,1.0,10,0.1
403474427,1,8,1.0,9,0.1111111111111111
403478756,5,5,5.0,10,0.5
403494071,2,25,2.0,27,0.07407407407407407
403514481,1,9,1.0,10,0.1
403558949,1,17,1.0,18,0.05555555555555555
403585714,1,8,1.0,9,0.1111111111111111
403627115,2,8,2.0,10,0.2
403650824,1,8,1.0,9,0.1111111111111111
403672105,4,24,4.0,28,0.14285714285714285
403677167,4,6,4.0,10,0.4
403691113,1,18,1.0,19,0.05263157894736842
403695663,2,18,2.0,20,0.1
403708372,1,9,1.0,10,0.1
403708693,4,6,4.0,10,0.4
403709003,5,4,4.0,9,0.4444444444444444
403719806,1,18,1.0,19,0.05263157894736842
403734508,1,17,1.0,18,0.05555555555555555
403789293,4,5,4.0,9,0.4444444444444444
403799548,1,9,1.0,10,0.1
403807684,9,10,9.0,19,0.47368421052631576
403827352,1,8,1.0,9,0.1111111111111111
403833552,1,9,1.0,10,0.1
403888592,1,8,1.0,9,0.1111111111111111
403902093,3,6,3.0,9,0.3333333333333333
403902437,7,3,3.0,10,0.3
403909897,2,8,2.0,10,0.2
403911976,2,7,2.0,9,0.2222222222222222
403912276,4,6,4.0,10,0.4
403914418,2,7,2.0,9,0.2222222222222222
403922269,2,8,2.0,10,0.2
403948364,6,23,6.0,29,0.20689655172413793
403948738,1,9,1.0,10,0.1
403949045,1,9,1.0,10,0.1
403959068,7,2,2.0,9,0.2222222222222222
403992248,5,3,3.0,8,0.375
403992465,6,4,4.0,10,0.4
403994986,17,12,12.0,29,0.41379310344827586
404004249,2,7,2.0,9,0.2222222222222222
404009989,1,9,1.0,10,0.1
404029944,8,1,1.0,9,0.1111111111111111
404030100,3,7,3.0,10,0.3
404049500,1,9,1.0,10,0.1
404089683,1,9,1.0,10,0.1
404096761,8,2,2.0,10,0.2
404098199,1,8,1.0,9,0.1111111111111111
404098241,1,8,1.0,9,0.1111111111111111
404099140,2,8,2.0,10,0.2
404100205,7,2,2.0,9,0.2222222222222222
404101963,8,1,1.0,9,0.1111111111111111
404125172,2,8,2.0,10,0.2
404145750,6,4,4.0,10,0.4
404177567,1,19,1.0,20,0.05
404275149,2,7,2.0,9,0.2222222222222222
404281714,4,6,4.0,10,0.4
404283692,6,4,4.0,10,0.4
404288916,5,14,5.0,19,0.2631578947368421
404294944,1,8,1.0,9,0.1111111111111111
404296459,2,7,2.0,9,0.2222222222222222
404301891,1,8,1.0,9,0.1111111111111111
404308942,3,6,3.0,9,0.3333333333333333
404326428,1,19,1.0,20,0.05
404329048,3,6,3.0,9,0.3333333333333333
404371408,7,2,2.0,9,0.2222222222222222
404390043,1,8,1.0,9,0.1111111111111111
404393831,8,21,8.0,29,0.27586206896551724
404394345,7,2,2.0,9,0.2222222222222222
404394954,2,8,2.0,10,0.2
404409686,2,8,2.0,10,0.2
404469549,6,2,2.0,8,0.25
404475876,4,5,4.0,9,0.4444444444444444
404489043,3,7,3.0,10,0.3
404499503,1,9,1.0,10,0.1
404502744,1,9,1.0,10,0.1
404513216,2,6,2.0,8,0.25
404524993,1,29,1.0,30,0.03333333333333333
404536076,1,35,1.0,36,0.027777777777777776
404545956,1,18,1.0,19,0.05263157894736842
404565341,17,12,12.0,29,0.41379310344827586
404566151,6,3,3.0,9,0.3333333333333333
404616259,1,18,1.0,19,0.05263157894736842
404637019,1,9,1.0,10,0.1
404640184,1,9,1.0,10,0.1
404643708,1,9,1.0,10,0.1
404646400,1,9,1.0,10,0.1
404672652,1,7,1.0,8,0.125
404683542,1,19,1.0,20,0.05
404691949,1,18,1.0,19,0.05263157894736842
404711659,1,9,1.0,10,0.1
404778399,1,8,1.0,9,0.1111111111111111
404778920,2,7,2.0,9,0.2222222222222222
404781262,27,1,1.0,28,0.03571428571428571
404781573,8,2,2.0,10,0.2
404797586,1,29,1.0,30,0.03333333333333333
404798355,4,5,4.0,9,0.4444444444444444
404798760,7,3,3.0,10,0.3
404803313,2,8,2.0,10,0.2
404807822,2,8,2.0,10,0.2
404818689,2,7,2.0,9,0.2222222222222222
404873582,2,17,2.0,19,0.10526315789473684
404889070,5,5,5.0,10,0.5
404906993,1,9,1.0,10,0.1
404923483,8,2,2.0,10,0.2
404952086,1,9,1.0,10,0.1
405016702,2,8,2.0,10,0.2
405053959,1,7,1.0,8,0.125
405055795,1,9,1.0,10,0.1
405116486,3,7,3.0,10,0.3
405117117,1,8,1.0,9,0.1111111111111111
405138079,1,8,1.0,9,0.1111111111111111
405147401,2,7,2.0,9,0.2222222222222222
405150660,1,7,1.0,8,0.125
405178645,1,17,1.0,18,0.05555555555555555
405179467,1,7,1.0,8,0.125
405185767,1,9,1.0,10,0.1
405187506,2,8,2.0,10,0.2
405197899,5,15,5.0,20,0.25
405198190,2,8,2.0,10,0.2
405199095,1,8,1.0,9,0.1111111111111111
405236155,1,8,1.0,9,0.1111111111111111
405250909,2,7,2.0,9,0.2222222222222222
405257035,2,8,2.0,10,0.2
405259773,3,7,3.0,10,0.3
405356978,2,8,2.0,10,0.2
405381346,1,18,1.0,19,0.05263157894736842
405387479,2,18,2.0,20,0.1
405450337,4,6,4.0,10,0.4
405521213,3,7,3.0,10,0.3
405585015,4,6,4.0,10,0.4
405585561,2,7,2.0,9,0.2222222222222222
405587068,8,1,1.0,9,0.1111111111111111
405587210,1,9,1.0,10,0.1
405588470,1,9,1.0,10,0.1
405598262,2,7,2.0,9,0.2222222222222222
405598565,1,9,1.0,10,0.1
405599241,8,2,2.0,10,0.2
405601228,12,15,12.0,27,0.4444444444444444
405601464,4,6,4.0,10,0.4
405615971,1,9,1.0,10,0.1
405634458,1,17,1.0,18,0.05555555555555555
405708965,1,19,1.0,20,0.05
405727519,1,9,1.0,10,0.1
405734330,7,3,3.0,10,0.3
405751260,1,9,1.0,10,0.1
405782945,2,7,2.0,9,0.2222222222222222
405788872,1,19,1.0,20,0.05
405839158,5,14,5.0,19,0.2631578947368421
405841530,2,17,2.0,19,0.10526315789473684
405930695,3,7,3.0,10,0.3
405962437,1,9,1.0,10,0.1
405989409,3,7,3.0,10,0.3
405997393,6,4,4.0,10,0.4
406010004,3,7,3.0,10,0.3
406020992,4,6,4.0,10,0.4
406039531,6,4,4.0,10,0.4
406084496,1,8,1.0,9,0.1111111111111111
406194898,3,7,3.0,10,0.3
406214915,1,7,1.0,8,0.125
406223126,1,17,1.0,18,0.05555555555555555
406224588,14,13,13.0,27,0.48148148148148145
406232560,4,5,4.0,9,0.4444444444444444
406232675,4,6,4.0,10,0.4
406232746,9,1,1.0,10,0.1
406234338,2,7,2.0,9,0.2222222222222222
406266441,4,6,4.0,10,0.4
406279555,7,3,3.0,10,0.3
406357241,1,19,1.0,20,0.05
406378050,9,1,1.0,10,0.1
406378824,2,8,2.0,10,0.2
406389288,3,7,3.0,10,0.3
406392635,2,7,2.0,9,0.2222222222222222
406395996,1,9,1.0,10,0.1
406467560,5,5,5.0,10,0.5
406545763,2,7,2.0,9,0.2222222222222222
406580474,4,4,4.0,8,0.5
406584560,2,7,2.0,9,0.2222222222222222
406588665,8,1,1.0,9,0.1111111111111111
406606710,1,9,1.0,10,0.1
406619953,3,7,3.0,10,0.3
406620267,7,3,3.0,10,0.3
406640872,8,2,2.0,10,0.2
406708158,2,8,2.0,10,0.2
406738597,1,8,1.0,9,0.1111111111111111
406813174,1,18,1.0,19,0.05263157894736842
406827291,1,8,1.0,9,0.1111111111111111
406927774,2,7,2.0,9,0.2222222222222222
406976979,2,7,2.0,9,0.2222222222222222
407001680,1,9,1.0,10,0.1
407008197,2,8,2.0,10,0.2
407008729,7,1,1.0,8,0.125
407015997,1,25,1.0,26,0.038461538461538464
407024514,5,14,5.0,19,0.2631578947368421
407089345,1,19,1.0,20,0.05
407117127,1,8,1.0,9,0.1111111111111111
407127063,7,13,7.0,20,0.35
407132338,1,7,1.0,8,0.125
407145351,1,8,1.0,9,0.1111111111111111
407162190,1,9,1.0,10,0.1
407170679,1,8,1.0,9,0.1111111111111111
407198071,9,1,1.0,10,0.1
407198408,8,1,1.0,9,0.1111111111111111
407199669,9,1,1.0,10,0.1
407219190,2,8,2.0,10,0.2
407224471,1,9,1.0,10,0.1
407248570,1,9,1.0,10,0.1
407270198,2,7,2.0,9,0.2222222222222222
407275743,1,9,1.0,10,0.1
407286164,1,9,1.0,10,0.1
407293794,1,9,1.0,10,0.1
407306231,1,18,1.0,19,0.05263157894736842
407312036,1,8,1.0,9,0.1111111111111111
407316819,2,7,2.0,9,0.2222222222222222
407385488,1,8,1.0,9,0.1111111111111111
407386513,3,6,3.0,9,0.3333333333333333
407386568,1,8,1.0,9,0.1111111111111111
407397960,1,17,1.0,18,0.05555555555555555
407429548,4,4,4.0,8,0.5
407476137,1,9,1.0,10,0.1
407491108,1,18,1.0,19,0.05263157894736842
407543095,8,21,8.0,29,0.27586206896551724
407568611,1,8,1.0,9,0.1111111111111111
407570630,4,6,4.0,10,0.4
407573708,2,8,2.0,10,0.2
407580388,1,8,1.0,9,0.1111111111111111
407583087,1,8,1.0,9,0.1111111111111111
407614284,2,17,2.0,19,0.10526315789473684
407624930,5,5,5.0,10,0.5
407657379,4,5,4.0,9,0.4444444444444444
407668153,2,18,2.0,20,0.1
407670818,2,7,2.0,9,0.2222222222222222
407695368,1,8,1.0,9,0.1111111111111111
407709435,1,8,1.0,9,0.1111111111111111
407709575,2,8,2.0,10,0.2
407710585,1,9,1.0,10,0.1
407711520,1,9,1.0,10,0.1
407712119,2,8,2.0,10,0.2
407713775,1,9,1.0,10,0.1
407716714,2,8,2.0,10,0.2
407731460,5,4,4.0,9,0.4444444444444444
407731579,9,1,1.0,10,0.1
407731671,3,6,3.0,9,0.3333333333333333
407731793,6,4,4.0,10,0.4
407734852,4,22,4.0,26,0.15384615384615385
407742527,3,7,3.0,10,0.3
407757518,1,9,1.0,10,0.1
407765389,1,9,1.0,10,0.1
407775411,1,29,1.0,30,0.03333333333333333
407784912,2,6,2.0,8,0.25
407790983,1,18,1.0,19,0.05263157894736842
407910802,9,1,1.0,10,0.1
407928376,1,7,1.0,8,0.125
407930557,1,9,1.0,10,0.1
407936608,16,14,14.0,30,0.4666666666666667
407939853,1,8,1.0,9,0.1111111111111111
407940228,2,7,2.0,9,0.2222222222222222
407943427,5,23,5.0,28,0.17857142857142858
407951949,1,9,1.0,10,0.1
407970135,3,16,3.0,19,0.15789473684210525
408001409,6,4,4.0,10,0.4
408001756,4,5,4.0,9,0.4444444444444444
408002212,3,7,3.0,10,0.3
408007170,2,8,2.0,10,0.2
408020107,1,9,1.0,10,0.1
408047510,1,8,1.0,9,0.1111111111111111
408054512,1,18,1.0,19,0.05263157894736842
408067895,1,9,1.0,10,0.1
408106312,1,9,1.0,10,0.1
408120793,3,6,3.0,9,0.3333333333333333
408126117,3,7,3.0,10,0.3
408132671,2,8,2.0,10,0.2
408132757,1,8,1.0,9,0.1111111111111111
408136108,1,8,1.0,9,0.1111111111111111
408142872,6,4,4.0,10,0.4
408146000,8,2,2.0,10,0.2
408215872,1,19,1.0,20,0.05
408266412,1,9,1.0,10,0.1
408321590,7,2,2.0,9,0.2222222222222222
408325555,1,9,1.0,10,0.1
408339336,7,3,3.0,10,0.3
408418939,1,18,1.0,19,0.05263157894736842
408420822,1,8,1.0,9,0.1111111111111111
408426896,4,6,4.0,10,0.4
408427208,1,18,1.0,19,0.05263157894736842
408427822,2,8,2.0,10,0.2
408436435,1,18,1.0,19,0.05263157894736842
408450109,3,6,3.0,9,0.3333333333333333
408453001,4,5,4.0,9,0.4444444444444444
408458024,1,9,1.0,10,0.1
408485019,1,9,1.0,10,0.1
408539712,1,8,1.0,9,0.1111111111111111
408543475,4,4,4.0,8,0.5
408547863,3,16,3.0,19,0.15789473684210525
408548120,10,19,10.0,29,0.3448275862068966
408552205,1,9,1.0,10,0.1
408605553,1,18,1.0,19,0.05263157894736842
408606248,4,4,4.0,8,0.5
408606479,3,6,3.0,9,0.3333333333333333
408611291,27,3,3.0,30,0.1
408634045,4,6,4.0,10,0.4
408668661,9,1,1.0,10,0.1
408668861,19,8,8.0,27,0.2962962962962963
408705166,1,9,1.0,10,0.1
408718290,3,7,3.0,10,0.3
408719405,8,15,8.0,23,0.34782608695652173
408751802,9,1,1.0,10,0.1
408781221,1,8,1.0,9,0.1111111111111111
408788803,4,25,4.0,29,0.13793103448275862
408791301,1,9,1.0,10,0.1
408798277,3,6,3.0,9,0.3333333333333333
408816327,1,9,1.0,10,0.1
408822585,3,16,3.0,19,0.15789473684210525
408837811,2,25,2.0,27,0.07407407407407407
408840720,1,8,1.0,9,0.1111111111111111
408844610,1,9,1.0,10,0.1
408900358,3,6,3.0,9,0.3333333333333333
408904418,1,18,1.0,19,0.05263157894736842
408911136,6,2,2.0,8,0.25
408951253,7,3,3.0,10,0.3
408997447,2,6,2.0,8,0.25
408999550,1,7,1.0,8,0.125
409048245,4,5,4.0,9,0.4444444444444444
409048848,2,7,2.0,9,0.2222222222222222
409049327,4,6,4.0,10,0.4
409049694,7,2,2.0,9,0.2222222222222222
409075013,3,6,3.0,9,0.3333333333333333
409075841,4,4,4.0,8,0.5
409075902,7,3,3.0,10,0.3
409114077,1,8,1.0,9,0.1111111111111111
409127488,22,5,5.0,27,0.18518518518518517
409134531,9,1,1.0,10,0.1
409147363,8,2,2.0,10,0.2
409148568,7,1,1.0,8,0.125
409187022,1,9,1.0,10,0.1
409216146,3,7,3.0,10,0.3
409238584,12,15,12.0,27,0.4444444444444444
409238932,1,9,1.0,10,0.1
409239836,2,6,2.0,8,0.25
409244835,2,7,2.0,9,0.2222222222222222
409275484,3,6,3.0,9,0.3333333333333333
409311386,5,3,3.0,8,0.375
409311764,7,2,2.0,9,0.2222222222222222
409343173,1,9,1.0,10,0.1
409343871,2,8,2.0,10,0.2
409354441,9,1,1.0,10,0.1
409382423,2,8,2.0,10,0.2
409386551,4,5,4.0,9,0.4444444444444444
409406867,1,9,1.0,10,0.1
409417903,3,7,3.0,10,0.3
409418203,3,7,3.0,10,0.3
409478125,4,5,4.0,9,0.4444444444444444
409491872,3,16,3.0,19,0.15789473684210525
409492086,8,1,1.0,9,0.1111111111111111
409545228,1,18,1.0,19,0.05263157894736842
409561008,5,4,4.0,9,0.4444444444444444
409564833,9,1,1.0,10,0.1
409579174,1,8,1.0,9,0.1111111111111111
409613709,24,6,6.0,30,0.2
409635645,1,9,1.0,10,0.1
409689302,7,3,3.0,10,0.3
409689688,9,1,1.0,10,0.1
409689846,4,4,4.0,8,0.5
409689986,7,2,2.0,9,0.2222222222222222
409690111,7,1,1.0,8,0.125
409690233,8,1,1.0,9,0.1111111111111111
409700689,5,5,5.0,10,0.5
409701392,2,8,2.0,10,0.2
409739586,1,19,1.0,20,0.05
409740473,3,7,3.0,10,0.3
409788139,3,5,3.0,8,0.375
409808582,1,18,1.0,19,0.05263157894736842
409817763,1,9,1.0,10,0.1
409827747,3,7,3.0,10,0.3
409852196,1,9,1.0,10,0.1
409857948,1,9,1.0,10,0.1
409859934,1,9,1.0,10,0.1
409921660,1,9,1.0,10,0.1
409922103,3,7,3.0,10,0.3
409922777,2,8,2.0,10,0.2
409928242,3,7,3.0,10,0.3
409931359,1,8,1.0,9,0.1111111111111111
409937538,1,9,1.0,10,0.1
409939926,3,6,3.0,9,0.3333333333333333
409952457,1,19,1.0,20,0.05
409978701,1,9,1.0,10,0.1
409986442,9,1,1.0,10,0.1
409996527,1,8,1.0,9,0.1111111111111111
410026835,6,4,4.0,10,0.4
410085119,2,17,2.0,19,0.10526315789473684
410088844,1,19,1.0,20,0.05
410103403,4,6,4.0,10,0.4
410152159,2,8,2.0,10,0.2
410155301,1,9,1.0,10,0.1
410160828,2,8,2.0,10,0.2
410162970,2,8,2.0,10,0.2
410163265,2,8,2.0,10,0.2
410163730,2,8,2.0,10,0.2
410164358,2,8,2.0,10,0.2
410166502,4,5,4.0,9,0.4444444444444444
410166564,2,8,2.0,10,0.2
410166895,6,4,4.0,10,0.4
410172645,1,9,1.0,10,0.1
410173357,1,9,1.0,10,0.1
410174479,1,8,1.0,9,0.1111111111111111
410183693,3,6,3.0,9,0.3333333333333333
410206234,2,7,2.0,9,0.2222222222222222
410206656,1,9,1.0,10,0.1
410207026,1,7,1.0,8,0.125
410207438,4,6,4.0,10,0.4
410222483,1,9,1.0,10,0.1
410250159,5,4,4.0,9,0.4444444444444444
410279595,1,17,1.0,18,0.05555555555555555
410279767,4,5,4.0,9,0.4444444444444444
410288360,1,9,1.0,10,0.1
410291106,1,9,1.0,10,0.1
410302250,4,6,4.0,10,0.4
410363635,1,9,1.0,10,0.1
410392072,1,9,1.0,10,0.1
410403832,3,7,3.0,10,0.3
410417874,3,16,3.0,19,0.15789473684210525
410431331,1,9,1.0,10,0.1
410432053,3,6,3.0,9,0.3333333333333333
410436814,2,17,2.0,19,0.10526315789473684
410442945,1,17,1.0,18,0.05555555555555555
410445567,1,8,1.0,9,0.1111111111111111
410498983,2,8,2.0,10,0.2
410518622,2,8,2.0,10,0.2
410552284,1,18,1.0,19,0.05263157894736842
410609966,6,4,4.0,10,0.4
410663245,1,18,1.0,19,0.05263157894736842
410677439,1,9,1.0,10,0.1
410678248,2,15,2.0,17,0.11764705882352941
410678476,2,7,2.0,9,0.2222222222222222
410688086,1,9,1.0,10,0.1
410701161,3,6,3.0,9,0.3333333333333333
410701313,12,17,12.0,29,0.41379310344827586
410704606,1,8,1.0,9,0.1111111111111111
410753641,1,19,1.0,20,0.05
410785481,17,12,12.0,29,0.41379310344827586
410785960,5,5,5.0,10,0.5
410800956,2,7,2.0,9,0.2222222222222222
410801147,1,7,1.0,8,0.125
410802868,2,7,2.0,9,0.2222222222222222
410812763,2,15,2.0,17,0.11764705882352941
410823258,6,4,4.0,10,0.4
410825740,14,14,14.0,28,0.5
410840804,1,9,1.0,10,0.1
410841378,9,1,1.0,10,0.1
410868900,1,8,1.0,9,0.1111111111111111
410869581,4,5,4.0,9,0.4444444444444444
410870006,1,8,1.0,9,0.1111111111111111
410874242,6,3,3.0,9,0.3333333333333333
410875062,2,8,2.0,10,0.2
410876823,2,8,2.0,10,0.2
410877932,5,5,5.0,10,0.5
410879176,5,5,5.0,10,0.5
410896381,1,8,1.0,9,0.1111111111111111
410898022,5,5,5.0,10,0.5
410902735,1,9,1.0,10,0.1
410908715,5,5,5.0,10,0.5
410936971,3,7,3.0,10,0.3
410938665,1,8,1.0,9,0.1111111111111111
410948241,2,28,2.0,30,0.06666666666666667
410967103,9,20,9.0,29,0.3103448275862069
411035921,2,7,2.0,9,0.2222222222222222
411040111,7,1,1.0,8,0.125
411082090,1,8,1.0,9,0.1111111111111111
411106578,8,2,2.0,10,0.2
411117559,7,22,7.0,29,0.2413793103448276
411126923,4,6,4.0,10,0.4
411169429,1,8,1.0,9,0.1111111111111111
411215799,3,16,3.0,19,0.15789473684210525
411226444,1,9,1.0,10,0.1
411262361,1,9,1.0,10,0.1
411264775,1,9,1.0,10,0.1
411300319,2,8,2.0,10,0.2
411306341,1,9,1.0,10,0.1
411311628,1,9,1.0,10,0.1
411318001,1,9,1.0,10,0.1
411351362,3,23,3.0,26,0.11538461538461539
411352810,2,7,2.0,9,0.2222222222222222
411360902,1,8,1.0,9,0.1111111111111111
411364833,5,4,4.0,9,0.4444444444444444
411436385,1,9,1.0,10,0.1
411440827,5,5,5.0,10,0.5
411453294,2,8,2.0,10,0.2
411474221,4,6,4.0,10,0.4
411507940,4,6,4.0,10,0.4
411507987,8,2,2.0,10,0.2
411512731,4,6,4.0,10,0.4
411589529,2,8,2.0,10,0.2
411615903,1,8,1.0,9,0.1111111111111111
411620634,8,1,1.0,9,0.1111111111111111
411622353,26,3,3.0,29,0.10344827586206896
411659282,2,8,2.0,10,0.2
411688496,7,2,2.0,9,0.2222222222222222
411715930,1,9,1.0,10,0.1
411740406,2,8,2.0,10,0.2
411742313,2,8,2.0,10,0.2
411769821,2,8,2.0,10,0.2
411838783,1,8,1.0,9,0.1111111111111111
411843495,8,1,1.0,9,0.1111111111111111
411844755,5,5,5.0,10,0.5
411846002,16,11,11.0,27,0.4074074074074074
411846181,3,7,3.0,10,0.3
411863298,1,9,1.0,10,0.1
411866917,1,9,1.0,10,0.1
411879247,2,8,2.0,10,0.2
411884288,3,7,3.0,10,0.3
411896324,1,8,1.0,9,0.1111111111111111
411922512,1,15,1.0,16,0.0625
411981597,2,15,2.0,17,0.11764705882352941
411987688,22,4,4.0,26,0.15384615384615385
411991723,2,26,2.0,28,0.07142857142857142
412011737,2,8,2.0,10,0.2
412034470,1,16,1.0,17,0.058823529411764705
412053308,1,8,1.0,9,0.1111111111111111
412059880,3,5,3.0,8,0.375
412065242,1,8,1.0,9,0.1111111111111111
412070967,1,19,1.0,20,0.05
412086514,2,8,2.0,10,0.2
412087351,3,17,3.0,20,0.15
412088014,3,7,3.0,10,0.3
412088349,1,8,1.0,9,0.1111111111111111
412111957,5,5,5.0,10,0.5
412115041,22,7,7.0,29,0.2413793103448276
412115146,6,4,4.0,10,0.4
412150946,1,18,1.0,19,0.05263157894736842
412152442,19,6,6.0,25,0.24
412212327,8,2,2.0,10,0.2
412219761,1,9,1.0,10,0.1
412237670,4,5,4.0,9,0.4444444444444444
412264777,8,2,2.0,10,0.2
412294415,2,6,2.0,8,0.25
412316725,1,9,1.0,10,0.1
412326675,11,18,11.0,29,0.3793103448275862
412329275,2,8,2.0,10,0.2
412330323,4,6,4.0,10,0.4
412334345,1,7,1.0,8,0.125
412335774,3,7,3.0,10,0.3
412336292,1,8,1.0,9,0.1111111111111111
412350931,2,8,2.0,10,0.2
412351198,1,9,1.0,10,0.1
412355508,3,7,3.0,10,0.3
412356938,1,9,1.0,10,0.1
412368073,2,18,2.0,20,0.1
412378110,3,7,3.0,10,0.3
412382811,3,16,3.0,19,0.15789473684210525
412398467,2,8,2.0,10,0.2
412406432,1,9,1.0,10,0.1
412439666,1,9,1.0,10,0.1
412452666,1,25,1.0,26,0.038461538461538464
412456800,3,7,3.0,10,0.3
412461843,2,7,2.0,9,0.2222222222222222
412462489,12,8,8.0,20,0.4
412499749,2,8,2.0,10,0.2
412594947,6,3,3.0,9,0.3333333333333333
412596576,2,8,2.0,10,0.2
412599851,1,18,1.0,19,0.05263157894736842
412601516,2,8,2.0,10,0.2
412618823,1,9,1.0,10,0.1
412623361,2,18,2.0,20,0.1
412626998,9,1,1.0,10,0.1
412644681,4,6,4.0,10,0.4
412716866,1,7,1.0,8,0.125
412725308,1,9,1.0,10,0.1
412731241,1,28,1.0,29,0.034482758620689655
412747377,1,8,1.0,9,0.1111111111111111
412750080,4,6,4.0,10,0.4
412771640,6,4,4.0,10,0.4
412785752,2,6,2.0,8,0.25
412813453,2,17,2.0,19,0.10526315789473684
412820530,3,7,3.0,10,0.3
412834597,1,9,1.0,10,0.1
412840985,1,9,1.0,10,0.1
412866613,2,8,2.0,10,0.2
412898129,5,21,5.0,26,0.19230769230769232
412903124,2,7,2.0,9,0.2222222222222222
412909499,1,8,1.0,9,0.1111111111111111
412915651,2,7,2.0,9,0.2222222222222222
412939716,1,9,1.0,10,0.1
412955330,1,19,1.0,20,0.05
412962814,2,8,2.0,10,0.2
412963403,21,9,9.0,30,0.3
412966751,5,3,3.0,8,0.375
412967243,1,9,1.0,10,0.1
412967711,4,6,4.0,10,0.4
412987799,2,8,2.0,10,0.2
412988151,3,7,3.0,10,0.3
412989243,14,13,13.0,27,0.48148148148148145
412994261,1,7,1.0,8,0.125
412995758,2,8,2.0,10,0.2
412996604,3,16,3.0,19,0.15789473684210525
412997954,1,19,1.0,20,0.05
413018492,4,23,4.0,27,0.14814814814814814
413042293,1,9,1.0,10,0.1
413042614,9,11,9.0,20,0.45
413048596,3,7,3.0,10,0.3
413049140,1,9,1.0,10,0.1
413050845,8,2,2.0,10,0.2
413063024,7,23,7.0,30,0.23333333333333334
413135250,1,9,1.0,10,0.1
413144610,1,8,1.0,9,0.1111111111111111
413144654,1,9,1.0,10,0.1
413178143,2,6,2.0,8,0.25
413210410,1,9,1.0,10,0.1
413214492,1,8,1.0,9,0.1111111111111111
413227480,2,7,2.0,9,0.2222222222222222
413227647,2,8,2.0,10,0.2
413242237,2,27,2.0,29,0.06896551724137931
413308266,1,7,1.0,8,0.125
413328996,8,12,8.0,20,0.4
413363994,5,5,5.0,10,0.5
413376345,2,6,2.0,8,0.25
413377748,6,2,2.0,8,0.25
413378004,4,5,4.0,9,0.4444444444444444
413385404,5,5,5.0,10,0.5
413391569,1,9,1.0,10,0.1
413395867,7,2,2.0,9,0.2222222222222222
413400357,1,9,1.0,10,0.1
413477463,2,6,2.0,8,0.25
413479974,2,7,2.0,9,0.2222222222222222
413513559,3,7,3.0,10,0.3
413546217,1,9,1.0,10,0.1
413552179,2,6,2.0,8,0.25
413555095,2,6,2.0,8,0.25
413588635,2,7,2.0,9,0.2222222222222222
413630972,1,9,1.0,10,0.1
413674231,1,7,1.0,8,0.125
413682459,1,9,1.0,10,0.1
413697446,2,8,2.0,10,0.2
413708526,1,8,1.0,9,0.1111111111111111
413708723,1,9,1.0,10,0.1
413722875,2,8,2.0,10,0.2
413736054,4,5,4.0,9,0.4444444444444444
413737949,5,4,4.0,9,0.4444444444444444
413738724,5,5,5.0,10,0.5
413744508,4,5,4.0,9,0.4444444444444444
413745452,1,26,1.0,27,0.037037037037037035
413754285,6,4,4.0,10,0.4
413755098,7,3,3.0,10,0.3
413775473,7,1,1.0,8,0.125
413791991,2,8,2.0,10,0.2
413843817,7,2,2.0,9,0.2222222222222222
413852731,3,17,3.0,20,0.15
413864612,1,9,1.0,10,0.1
413868247,3,5,3.0,8,0.375
413868700,7,16,7.0,23,0.30434782608695654
413868836,1,9,1.0,10,0.1
413870337,2,7,2.0,9,0.2222222222222222
413873366,1,9,1.0,10,0.1
413873650,1,9,1.0,10,0.1
413876616,1,9,1.0,10,0.1
413877302,1,9,1.0,10,0.1
413884675,1,18,1.0,19,0.05263157894736842
413892823,2,7,2.0,9,0.2222222222222222
413911778,2,7,2.0,9,0.2222222222222222
413917403,1,18,1.0,19,0.05263157894736842
413964593,2,8,2.0,10,0.2
413967237,2,17,2.0,19,0.10526315789473684
413986137,24,6,6.0,30,0.2
413994656,7,13,7.0,20,0.35
414015157,3,6,3.0,9,0.3333333333333333
414055463,1,9,1.0,10,0.1
414112575,2,7,2.0,9,0.2222222222222222
414117125,1,7,1.0,8,0.125
414144382,3,17,3.0,20,0.15
414145653,7,1,1.0,8,0.125
414153005,5,22,5.0,27,0.18518518518518517
414154236,5,14,5.0,19,0.2631578947368421
414160978,2,7,2.0,9,0.2222222222222222
414162305,6,3,3.0,9,0.3333333333333333
414174548,2,8,2.0,10,0.2
414190584,1,9,1.0,10,0.1
414191076,7,3,3.0,10,0.3
414210855,3,5,3.0,8,0.375
414238504,1,9,1.0,10,0.1
414260453,2,28,2.0,30,0.06666666666666667
414267122,8,2,2.0,10,0.2
414269835,6,3,3.0,9,0.3333333333333333
414271587,3,7,3.0,10,0.3
414286591,1,9,1.0,10,0.1
414288832,4,6,4.0,10,0.4
414307056,1,9,1.0,10,0.1
414309663,5,3,3.0,8,0.375
414317484,8,2,2.0,10,0.2
414332467,3,7,3.0,10,0.3
414383114,4,6,4.0,10,0.4
414389619,1,8,1.0,9,0.1111111111111111
414390052,13,7,7.0,20,0.35
414436552,1,8,1.0,9,0.1111111111111111
414436773,2,7,2.0,9,0.2222222222222222
414491237,4,23,4.0,27,0.14814814814814814
414491309,1,9,1.0,10,0.1
414529415,1,9,1.0,10,0.1
414531211,12,16,12.0,28,0.42857142857142855
414583931,5,4,4.0,9,0.4444444444444444
414635571,8,12,8.0,20,0.4
414661471,5,3,3.0,8,0.375
414682679,1,8,1.0,9,0.1111111111111111
414682969,1,9,1.0,10,0.1
414683143,1,7,1.0,8,0.125
414684067,8,1,1.0,9,0.1111111111111111
414685321,2,7,2.0,9,0.2222222222222222
414687374,1,8,1.0,9,0.1111111111111111
414689448,1,8,1.0,9,0.1111111111111111
414713119,8,1,1.0,9,0.1111111111111111
414731654,5,5,5.0,10,0.5
414737723,1,9,1.0,10,0.1
414800874,6,4,4.0,10,0.4
414811127,1,9,1.0,10,0.1
414817436,2,6,2.0,8,0.25
414865489,3,6,3.0,9,0.3333333333333333
414877748,4,6,4.0,10,0.4
414882047,8,1,1.0,9,0.1111111111111111
414891777,1,9,1.0,10,0.1
414892064,7,3,3.0,10,0.3
414901348,1,8,1.0,9,0.1111111111111111
414903411,8,2,2.0,10,0.2
414931116,1,19,1.0,20,0.05
414956268,1,9,1.0,10,0.1
414973379,2,6,2.0,8,0.25
415007282,1,9,1.0,10,0.1
415021764,1,9,1.0,10,0.1
415027559,2,8,2.0,10,0.2
415037734,1,9,1.0,10,0.1
415075964,1,8,1.0,9,0.1111111111111111
415081121,1,8,1.0,9,0.1111111111111111
415088371,8,10,8.0,18,0.4444444444444444
415091285,3,24,3.0,27,0.1111111111111111
415098229,8,2,2.0,10,0.2
415107236,23,6,6.0,29,0.20689655172413793
415120275,2,17,2.0,19,0.10526315789473684
415152626,2,8,2.0,10,0.2
415171782,2,8,2.0,10,0.2
415188128,2,8,2.0,10,0.2
415190051,7,3,3.0,10,0.3
415200550,3,6,3.0,9,0.3333333333333333
415215158,6,3,3.0,9,0.3333333333333333
415215451,25,3,3.0,28,0.10714285714285714
415235171,1,8,1.0,9,0.1111111111111111
415243051,1,8,1.0,9,0.1111111111111111
415252281,5,5,5.0,10,0.5
415253612,4,5,4.0,9,0.4444444444444444
415254102,1,9,1.0,10,0.1
415272704,3,6,3.0,9,0.3333333333333333
415280835,5,5,5.0,10,0.5
415285520,1,9,1.0,10,0.1
415286494,2,7,2.0,9,0.2222222222222222
415321951,3,6,3.0,9,0.3333333333333333
415322409,3,6,3.0,9,0.3333333333333333
415323047,1,9,1.0,10,0.1
415323399,1,8,1.0,9,0.1111111111111111
415325794,3,5,3.0,8,0.375
415389990,5,15,5.0,20,0.25
415408742,5,5,5.0,10,0.5
415410727,1,8,1.0,9,0.1111111111111111
415452264,5,5,5.0,10,0.5
415487722,9,1,1.0,10,0.1
415506660,5,5,5.0,10,0.5
415510587,5,5,5.0,10,0.5
415551149,2,17,2.0,19,0.10526315789473684
415552048,8,2,2.0,10,0.2
415567838,6,4,4.0,10,0.4
415575958,6,3,3.0,9,0.3333333333333333
415611659,2,8,2.0,10,0.2
415617747,3,7,3.0,10,0.3
415618044,2,8,2.0,10,0.2
415667720,5,5,5.0,10,0.5
415684685,7,3,3.0,10,0.3
415692171,3,7,3.0,10,0.3
415693847,1,7,1.0,8,0.125
415755863,1,8,1.0,9,0.1111111111111111
415766972,3,5,3.0,8,0.375
415775797,1,8,1.0,9,0.1111111111111111
415786085,1,17,1.0,18,0.05555555555555555
415806004,2,7,2.0,9,0.2222222222222222
415813550,2,18,2.0,20,0.1
415818949,1,8,1.0,9,0.1111111111111111
415822522,11,18,11.0,29,0.3793103448275862
415887789,4,4,4.0,8,0.5
415888499,7,2,2.0,9,0.2222222222222222
415894628,1,8,1.0,9,0.1111111111111111
415906058,6,13,6.0,19,0.3157894736842105
415911026,5,5,5.0,10,0.5
415911644,2,16,2.0,18,0.1111111111111111
415912741,3,6,3.0,9,0.3333333333333333
415913367,4,6,4.0,10,0.4
415913681,2,7,2.0,9,0.2222222222222222
415924728,1,8,1.0,9,0.1111111111111111
415948195,6,14,6.0,20,0.3
415960090,1,18,1.0,19,0.05263157894736842
416014494,2,8,2.0,10,0.2
416088373,1,7,1.0,8,0.125
416098757,1,8,1.0,9,0.1111111111111111
416108095,3,26,3.0,29,0.10344827586206896
416161704,6,4,4.0,10,0.4
416170166,1,7,1.0,8,0.125
416173359,9,1,1.0,10,0.1
416201937,1,9,1.0,10,0.1
416243378,4,6,4.0,10,0.4
416280298,1,8,1.0,9,0.1111111111111111
416304369,1,7,1.0,8,0.125
416308072,4,6,4.0,10,0.4
416308285,9,1,1.0,10,0.1
416309002,7,3,3.0,10,0.3
416310154,1,7,1.0,8,0.125
416310489,9,1,1.0,10,0.1
416315021,7,2,2.0,9,0.2222222222222222
416341391,24,5,5.0,29,0.1724137931034483
416365395,7,1,1.0,8,0.125
416376482,1,8,1.0,9,0.1111111111111111
416383815,2,7,2.0,9,0.2222222222222222
416451759,1,9,1.0,10,0.1
416454950,9,1,1.0,10,0.1
416455122,8,2,2.0,10,0.2
416455262,5,5,5.0,10,0.5
416455892,1,8,1.0,9,0.1111111111111111
416457780,1,19,1.0,20,0.05
416463712,2,7,2.0,9,0.2222222222222222
416488489,3,16,3.0,19,0.15789473684210525
416498803,2,6,2.0,8,0.25
416503660,1,9,1.0,10,0.1
416510284,2,8,2.0,10,0.2
416520056,5,4,4.0,9,0.4444444444444444
416587743,2,7,2.0,9,0.2222222222222222
416610672,2,18,2.0,20,0.1
416612789,2,8,2.0,10,0.2
416629289,3,7,3.0,10,0.3
416662615,1,9,1.0,10,0.1
416664074,1,9,1.0,10,0.1
416666147,2,8,2.0,10,0.2
416761661,1,9,1.0,10,0.1
416762222,1,19,1.0,20,0.05
416766914,4,6,4.0,10,0.4
416767124,6,3,3.0,9,0.3333333333333333
416767603,3,5,3.0,8,0.375
416848356,1,19,1.0,20,0.05
416853209,9,21,9.0,30,0.3
416861336,2,8,2.0,10,0.2
416880101,2,7,2.0,9,0.2222222222222222
416894643,1,18,1.0,19,0.05263157894736842
416905701,7,3,3.0,10,0.3
416906019,4,6,4.0,10,0.4
416914486,1,9,1.0,10,0.1
416939457,1,9,1.0,10,0.1
416965463,1,9,1.0,10,0.1
416965830,16,13,13.0,29,0.4482758620689655
416979306,3,7,3.0,10,0.3
416986395,9,1,1.0,10,0.1
416987481,8,1,1.0,9,0.1111111111111111
416987608,1,9,1.0,10,0.1
416988533,8,2,2.0,10,0.2
416994048,2,8,2.0,10,0.2
417000497,6,4,4.0,10,0.4
417001262,2,7,2.0,9,0.2222222222222222
417001785,1,7,1.0,8,0.125
417047612,12,15,12.0,27,0.4444444444444444
417079854,1,9,1.0,10,0.1
417082219,3,7,3.0,10,0.3
417083689,1,8,1.0,9,0.1111111111111111
417084630,1,9,1.0,10,0.1
417084895,19,9,9.0,28,0.32142857142857145
417085335,6,2,2.0,8,0.25
417118159,1,8,1.0,9,0.1111111111111111
417119995,6,4,4.0,10,0.4
417121311,4,6,4.0,10,0.4
417136956,2,8,2.0,10,0.2
417138717,2,8,2.0,10,0.2
417139083,2,8,2.0,10,0.2
417186812,2,7,2.0,9,0.2222222222222222
417204192,2,15,2.0,17,0.11764705882352941
417227954,3,17,3.0,20,0.15
417234562,18,10,10.0,28,0.35714285714285715
417289359,6,4,4.0,10,0.4
417289904,7,3,3.0,10,0.3
417298597,1,8,1.0,9,0.1111111111111111
417304978,1,9,1.0,10,0.1
417341772,5,14,5.0,19,0.2631578947368421
417367972,4,5,4.0,9,0.4444444444444444
417477320,5,14,5.0,19,0.2631578947368421
417480356,1,9,1.0,10,0.1
417486418,4,6,4.0,10,0.4
417488949,1,9,1.0,10,0.1
417495536,1,9,1.0,10,0.1
417517310,3,7,3.0,10,0.3
417517979,9,1,1.0,10,0.1
417518368,8,1,1.0,9,0.1111111111111111
417605046,1,7,1.0,8,0.125
417620908,1,7,1.0,8,0.125
417627544,3,7,3.0,10,0.3
417627822,3,6,3.0,9,0.3333333333333333
417639149,1,9,1.0,10,0.1
417656898,3,17,3.0,20,0.15
417713346,2,17,2.0,19,0.10526315789473684
417718126,1,9,1.0,10,0.1
417723075,5,4,4.0,9,0.4444444444444444
417727957,3,17,3.0,20,0.15
417827139,2,8,2.0,10,0.2
417830326,6,4,4.0,10,0.4
417863555,1,8,1.0,9,0.1111111111111111
417865148,1,19,1.0,20,0.05
417902202,1,8,1.0,9,0.1111111111111111
417912548,27,1,1.0,28,0.03571428571428571
417912716,9,1,1.0,10,0.1
417915480,1,18,1.0,19,0.05263157894736842
418002510,2,7,2.0,9,0.2222222222222222
418006486,8,1,1.0,9,0.1111111111111111
418008260,7,2,2.0,9,0.2222222222222222
418025704,22,5,5.0,27,0.18518518518518517
418042243,1,18,1.0,19,0.05263157894736842
418042587,4,6,4.0,10,0.4
418047553,1,8,1.0,9,0.1111111111111111
418081263,1,19,1.0,20,0.05
418106743,3,6,3.0,9,0.3333333333333333
418160889,1,9,1.0,10,0.1
418176192,1,9,1.0,10,0.1
418197906,1,9,1.0,10,0.1
418206777,2,8,2.0,10,0.2
418208376,1,8,1.0,9,0.1111111111111111
418208467,13,6,6.0,19,0.3157894736842105
418208598,4,4,4.0,8,0.5
418208670,8,2,2.0,10,0.2
418209957,3,7,3.0,10,0.3
418210099,5,4,4.0,9,0.4444444444444444
418211278,5,5,5.0,10,0.5
418223709,3,7,3.0,10,0.3
418225735,2,8,2.0,10,0.2
418228867,6,4,4.0,10,0.4
418230967,1,9,1.0,10,0.1
418231948,7,2,2.0,9,0.2222222222222222
418237434,8,21,8.0,29,0.27586206896551724
418259581,3,6,3.0,9,0.3333333333333333
418260969,7,3,3.0,10,0.3
418285820,1,8,1.0,9,0.1111111111111111
418287023,1,18,1.0,19,0.05263157894736842
418293983,3,15,3.0,18,0.16666666666666666
418295378,9,1,1.0,10,0.1
418349032,3,6,3.0,9,0.3333333333333333
418356702,1,8,1.0,9,0.1111111111111111
418374244,1,8,1.0,9,0.1111111111111111
418379056,5,5,5.0,10,0.5
418380917,1,9,1.0,10,0.1
418387855,11,15,11.0,26,0.4230769230769231
418409188,16,11,11.0,27,0.4074074074074074
418461583,1,9,1.0,10,0.1
418463192,6,4,4.0,10,0.4
418488490,1,9,1.0,10,0.1
418489034,5,3,3.0,8,0.375
418489349,2,7,2.0,9,0.2222222222222222
418492330,3,6,3.0,9,0.3333333333333333
418535938,1,8,1.0,9,0.1111111111111111
418538349,2,7,2.0,9,0.2222222222222222
418557672,1,9,1.0,10,0.1
418566482,1,9,1.0,10,0.1
418576615,3,6,3.0,9,0.3333333333333333
418578782,2,6,2.0,8,0.25
418586587,2,8,2.0,10,0.2
418594555,3,17,3.0,20,0.15
418597593,2,17,2.0,19,0.10526315789473684
418600425,2,8,2.0,10,0.2
418601588,1,9,1.0,10,0.1
418601823,8,2,2.0,10,0.2
418614590,7,23,7.0,30,0.23333333333333334
418633601,1,8,1.0,9,0.1111111111111111
418638558,1,8,1.0,9,0.1111111111111111
418641165,1,9,1.0,10,0.1
418642219,2,8,2.0,10,0.2
418650827,9,1,1.0,10,0.1
418683428,23,5,5.0,28,0.17857142857142858
418696020,3,6,3.0,9,0.3333333333333333
418707393,4,6,4.0,10,0.4
418715545,7,3,3.0,10,0.3
418715804,4,5,4.0,9,0.4444444444444444
418735700,5,5,5.0,10,0.5
418779482,9,20,9.0,29,0.3103448275862069
418785090,1,8,1.0,9,0.1111111111111111
418802555,2,18,2.0,20,0.1
418814743,3,6,3.0,9,0.3333333333333333
418830072,2,7,2.0,9,0.2222222222222222
418836569,8,2,2.0,10,0.2
418839141,1,9,1.0,10,0.1
418913960,5,3,3.0,8,0.375
418948312,1,9,1.0,10,0.1
419018211,1,9,1.0,10,0.1
419020971,1,9,1.0,10,0.1
419035355,7,3,3.0,10,0.3
419038465,4,25,4.0,29,0.13793103448275862
419060055,1,9,1.0,10,0.1
419070847,1,17,1.0,18,0.05555555555555555
419096496,1,7,1.0,8,0.125
419103376,1,9,1.0,10,0.1
419140558,2,8,2.0,10,0.2
419168890,4,5,4.0,9,0.4444444444444444
419172123,4,6,4.0,10,0.4
419176687,7,3,3.0,10,0.3
419177491,3,6,3.0,9,0.3333333333333333
419188751,3,5,3.0,8,0.375
419189128,1,8,1.0,9,0.1111111111111111
419203427,1,9,1.0,10,0.1
419204565,2,7,2.0,9,0.2222222222222222
419204983,1,9,1.0,10,0.1
419219155,2,8,2.0,10,0.2
419252105,1,7,1.0,8,0.125
419259148,1,9,1.0,10,0.1
419318804,2,18,2.0,20,0.1
419357415,3,14,3.0,17,0.17647058823529413
419369565,1,8,1.0,9,0.1111111111111111
419374449,1,9,1.0,10,0.1
419400538,1,16,1.0,17,0.058823529411764705
419432094,9,1,1.0,10,0.1
419443220,1,18,1.0,19,0.05263157894736842
419445241,1,8,1.0,9,0.1111111111111111
419457508,1,8,1.0,9,0.1111111111111111
419458526,1,9,1.0,10,0.1
419468334,1,17,1.0,18,0.05555555555555555
419473925,8,2,2.0,10,0.2
419474153,9,17,9.0,26,0.34615384615384615
419474908,8,2,2.0,10,0.2
419477170,1,8,1.0,9,0.1111111111111111
419491707,1,8,1.0,9,0.1111111111111111
419493003,2,8,2.0,10,0.2
419514186,1,8,1.0,9,0.1111111111111111
419522790,1,9,1.0,10,0.1
419599332,1,17,1.0,18,0.05555555555555555
419614701,3,7,3.0,10,0.3
419618472,1,9,1.0,10,0.1
419618763,7,2,2.0,9,0.2222222222222222
419627731,2,8,2.0,10,0.2
419629686,8,2,2.0,10,0.2
419646533,1,9,1.0,10,0.1
419665000,1,8,1.0,9,0.1111111111111111
419672227,2,8,2.0,10,0.2
419675357,1,9,1.0,10,0.1
419684022,3,6,3.0,9,0.3333333333333333
419692521,1,18,1.0,19,0.05263157894736842
419717486,3,6,3.0,9,0.3333333333333333
419719749,3,7,3.0,10,0.3
419735392,2,8,2.0,10,0.2
419741495,1,9,1.0,10,0.1
419745985,4,6,4.0,10,0.4
419746783,20,9,9.0,29,0.3103448275862069
419746843,5,5,5.0,10,0.5
419749118,2,8,2.0,10,0.2
419749644,5,24,5.0,29,0.1724137931034483
419753844,1,8,1.0,9,0.1111111111111111
419804534,2,8,2.0,10,0.2
419807951,2,8,2.0,10,0.2
419835603,2,7,2.0,9,0.2222222222222222
419838758,1,19,1.0,20,0.05
419843357,6,4,4.0,10,0.4
419862379,1,19,1.0,20,0.05
419862704,1,8,1.0,9,0.1111111111111111
419879683,3,7,3.0,10,0.3
419891998,1,8,1.0,9,0.1111111111111111
419897895,26,1,1.0,27,0.037037037037037035
419951365,1,9,1.0,10,0.1
419994323,1,9,1.0,10,0.1
419994405,1,8,1.0,9,0.1111111111111111
420043881,7,3,3.0,10,0.3
420098757,8,2,2.0,10,0.2
420099531,4,6,4.0,10,0.4
420099994,3,5,3.0,8,0.375
420108956,2,8,2.0,10,0.2
420123516,4,4,4.0,8,0.5
420124938,2,8,2.0,10,0.2
420129009,1,9,1.0,10,0.1
420132432,2,8,2.0,10,0.2
420154046,1,9,1.0,10,0.1
420171817,2,8,2.0,10,0.2
420204068,3,7,3.0,10,0.3
420208723,3,7,3.0,10,0.3
420209791,8,2,2.0,10,0.2
420210581,1,9,1.0,10,0.1
420231208,2,7,2.0,9,0.2222222222222222
420233288,3,16,3.0,19,0.15789473684210525
420246597,2,8,2.0,10,0.2
420249341,3,7,3.0,10,0.3
420267331,1,9,1.0,10,0.1
420282999,1,18,1.0,19,0.05263157894736842
420302561,10,18,10.0,28,0.35714285714285715
420408952,7,2,2.0,9,0.2222222222222222
420409618,3,7,3.0,10,0.3
420439706,3,7,3.0,10,0.3
420502679,5,5,5.0,10,0.5
420504356,6,4,4.0,10,0.4
420517171,7,2,2.0,9,0.2222222222222222
420582978,3,6,3.0,9,0.3333333333333333
420597126,1,9,1.0,10,0.1
420597497,2,8,2.0,10,0.2
420600656,4,6,4.0,10,0.4
420601085,2,7,2.0,9,0.2222222222222222
420601191,7,21,7.0,28,0.25
420602293,1,18,1.0,19,0.05263157894736842
420603233,9,1,1.0,10,0.1
420610597,4,6,4.0,10,0.4
420611646,5,5,5.0,10,0.5
420612066,2,8,2.0,10,0.2
420645501,5,4,4.0,9,0.4444444444444444
420658615,1,9,1.0,10,0.1
420661950,7,12,7.0,19,0.3684210526315789
420689715,6,4,4.0,10,0.4
420710320,1,9,1.0,10,0.1
420715830,3,7,3.0,10,0.3
420720842,2,7,2.0,9,0.2222222222222222
420728134,5,4,4.0,9,0.4444444444444444
420731608,3,6,3.0,9,0.3333333333333333
420731738,3,7,3.0,10,0.3
420736267,6,4,4.0,10,0.4
420737039,28,1,1.0,29,0.034482758620689655
420759636,5,5,5.0,10,0.5
420763273,6,3,3.0,9,0.3333333333333333
420765433,5,3,3.0,8,0.375
420775818,1,8,1.0,9,0.1111111111111111
420777369,1,27,1.0,28,0.03571428571428571
420804991,2,8,2.0,10,0.2
420818154,6,3,3.0,9,0.3333333333333333
420830184,2,8,2.0,10,0.2
420838349,3,6,3.0,9,0.3333333333333333
420840002,5,5,5.0,10,0.5
420893149,9,1,1.0,10,0.1
420894667,6,4,4.0,10,0.4
420896388,5,5,5.0,10,0.5
420900758,6,4,4.0,10,0.4
420901299,4,6,4.0,10,0.4
420911022,2,16,2.0,18,0.1111111111111111
420912814,20,9,9.0,29,0.3103448275862069
420914085,9,1,1.0,10,0.1
420918629,2,8,2.0,10,0.2
420921959,1,17,1.0,18,0.05555555555555555
420923796,8,20,8.0,28,0.2857142857142857
420924819,7,2,2.0,9,0.2222222222222222
420925587,9,1,1.0,10,0.1
420926344,7,3,3.0,10,0.3
420928435,2,26,2.0,28,0.07142857142857142
421028058,1,9,1.0,10,0.1
421043321,6,20,6.0,26,0.23076923076923078
421078387,4,5,4.0,9,0.4444444444444444
421079527,1,8,1.0,9,0.1111111111111111
421122145,3,6,3.0,9,0.3333333333333333
421143966,14,14,14.0,28,0.5
421234030,11,16,11.0,27,0.4074074074074074
421234437,4,6,4.0,10,0.4
421236588,1,9,1.0,10,0.1
421247005,1,8,1.0,9,0.1111111111111111
421259911,6,3,3.0,9,0.3333333333333333
421286593,5,14,5.0,19,0.2631578947368421
421305058,1,9,1.0,10,0.1
421305413,3,6,3.0,9,0.3333333333333333
421311921,1,17,1.0,18,0.05555555555555555
421332193,1,18,1.0,19,0.05263157894736842
421343057,1,9,1.0,10,0.1
421354169,5,5,5.0,10,0.5
421357329,1,18,1.0,19,0.05263157894736842
421358910,7,11,7.0,18,0.3888888888888889
421359553,7,23,7.0,30,0.23333333333333334
421388021,1,9,1.0,10,0.1
421389231,7,2,2.0,9,0.2222222222222222
421389505,6,4,4.0,10,0.4
421389769,8,2,2.0,10,0.2
421390097,4,6,4.0,10,0.4
421442493,5,5,5.0,10,0.5
421442940,5,5,5.0,10,0.5
421443709,6,24,6.0,30,0.2
421459366,4,6,4.0,10,0.4
421466438,1,8,1.0,9,0.1111111111111111
421468679,1,16,1.0,17,0.058823529411764705
421477716,2,18,2.0,20,0.1
421516117,12,6,6.0,18,0.3333333333333333
421534833,1,9,1.0,10,0.1
421540018,1,8,1.0,9,0.1111111111111111
421540503,2,7,2.0,9,0.2222222222222222
421547234,1,9,1.0,10,0.1
421554321,5,5,5.0,10,0.5
421583608,1,8,1.0,9,0.1111111111111111
421584402,4,5,4.0,9,0.4444444444444444
421585117,4,6,4.0,10,0.4
421585608,7,3,3.0,10,0.3
421586556,5,5,5.0,10,0.5
421587291,7,3,3.0,10,0.3
421637046,1,9,1.0,10,0.1
421646132,3,7,3.0,10,0.3
421658106,9,1,1.0,10,0.1
421677926,5,22,5.0,27,0.18518518518518517
421723596,2,16,2.0,18,0.1111111111111111
421728540,1,9,1.0,10,0.1
421750653,1,8,1.0,9,0.1111111111111111
421799924,8,2,2.0,10,0.2
421814599,1,9,1.0,10,0.1
421827808,2,17,2.0,19,0.10526315789473684
421847651,3,7,3.0,10,0.3
421928436,3,6,3.0,9,0.3333333333333333
421937282,3,7,3.0,10,0.3
421940481,5,4,4.0,9,0.4444444444444444
421954395,5,5,5.0,10,0.5
421958497,1,8,1.0,9,0.1111111111111111
421979183,2,17,2.0,19,0.10526315789473684
421990298,1,8,1.0,9,0.1111111111111111
421990655,8,1,1.0,9,0.1111111111111111
421991392,6,4,4.0,10,0.4
421991588,9,1,1.0,10,0.1
421999310,1,18,1.0,19,0.05263157894736842
422003437,1,7,1.0,8,0.125
422005203,1,8,1.0,9,0.1111111111111111
422018276,3,15,3.0,18,0.16666666666666666
422075031,5,4,4.0,9,0.4444444444444444
422078704,2,6,2.0,8,0.25
422091229,1,9,1.0,10,0.1
422094515,16,12,12.0,28,0.42857142857142855
422152189,2,8,2.0,10,0.2
422157962,2,8,2.0,10,0.2
422158833,11,18,11.0,29,0.3793103448275862
422187600,1,9,1.0,10,0.1
422195925,1,8,1.0,9,0.1111111111111111
422213608,2,8,2.0,10,0.2
422218315,1,8,1.0,9,0.1111111111111111
422222175,8,2,2.0,10,0.2
422226442,1,8,1.0,9,0.1111111111111111
422226664,2,8,2.0,10,0.2
422227009,4,5,4.0,9,0.4444444444444444
422230753,2,8,2.0,10,0.2
422240057,3,6,3.0,9,0.3333333333333333
422240232,2,7,2.0,9,0.2222222222222222
422240506,23,4,4.0,27,0.14814814814814814
422240936,2,8,2.0,10,0.2
422241037,9,1,1.0,10,0.1
422241259,1,9,1.0,10,0.1
422254695,3,25,3.0,28,0.10714285714285714
422256086,2,8,2.0,10,0.2
422258457,9,1,1.0,10,0.1
422258716,8,2,2.0,10,0.2
422259405,12,16,12.0,28,0.42857142857142855
422268562,6,4,4.0,10,0.4
422271082,3,6,3.0,9,0.3333333333333333
422337852,2,7,2.0,9,0.2222222222222222
422340659,3,7,3.0,10,0.3
422341164,3,6,3.0,9,0.3333333333333333
422341420,1,28,1.0,29,0.034482758620689655
422362897,7,2,2.0,9,0.2222222222222222
422378077,1,9,1.0,10,0.1
422385117,2,8,2.0,10,0.2
422391017,2,8,2.0,10,0.2
422405192,1,9,1.0,10,0.1
422407866,1,9,1.0,10,0.1
422409848,8,2,2.0,10,0.2
422425658,2,18,2.0,20,0.1
422442366,1,9,1.0,10,0.1
422442667,1,8,1.0,9,0.1111111111111111
422454949,11,7,7.0,18,0.3888888888888889
422461113,1,9,1.0,10,0.1
422507997,7,12,7.0,19,0.3684210526315789
422532145,4,6,4.0,10,0.4
422532535,5,4,4.0,9,0.4444444444444444
422534930,1,9,1.0,10,0.1
422542241,3,17,3.0,20,0.15
422552935,9,1,1.0,10,0.1
422566819,1,8,1.0,9,0.1111111111111111
422575163,1,17,1.0,18,0.05555555555555555
422621555,1,9,1.0,10,0.1
422642762,5,4,4.0,9,0.4444444444444444
422643659,6,4,4.0,10,0.4
422643966,1,9,1.0,10,0.1
422647312,2,8,2.0,10,0.2
422648998,8,1,1.0,9,0.1111111111111111
422671639,1,9,1.0,10,0.1
422677626,1,9,1.0,10,0.1
422679197,1,9,1.0,10,0.1
422679998,1,19,1.0,20,0.05
422707169,1,18,1.0,19,0.05263157894736842
422711141,1,19,1.0,20,0.05
422723917,3,7,3.0,10,0.3
422736078,5,14,5.0,19,0.2631578947368421
422748727,3,15,3.0,18,0.16666666666666666
422749163,4,14,4.0,18,0.2222222222222222
422755004,5,5,5.0,10,0.5
422765190,8,1,1.0,9,0.1111111111111111
422766558,8,2,2.0,10,0.2
422768579,2,8,2.0,10,0.2
422805844,7,2,2.0,9,0.2222222222222222
422822673,1,7,1.0,8,0.125
422836903,2,7,2.0,9,0.2222222222222222
422841032,1,9,1.0,10,0.1
422845959,1,8,1.0,9,0.1111111111111111
422857447,1,9,1.0,10,0.1
422886195,19,11,11.0,30,0.36666666666666664
422901210,2,7,2.0,9,0.2222222222222222
422951366,4,6,4.0,10,0.4
422971691,3,7,3.0,10,0.3
422972846,2,7,2.0,9,0.2222222222222222
422978644,1,9,1.0,10,0.1
422979195,1,9,1.0,10,0.1
422992346,3,17,3.0,20,0.15
422992946,4,5,4.0,9,0.4444444444444444
422994698,3,6,3.0,9,0.3333333333333333
422994990,2,8,2.0,10,0.2
422995407,1,9,1.0,10,0.1
423006506,3,5,3.0,8,0.375
423030431,1,7,1.0,8,0.125
423045634,1,9,1.0,10,0.1
423066819,1,7,1.0,8,0.125
423068195,1,8,1.0,9,0.1111111111111111
423072973,2,16,2.0,18,0.1111111111111111
423085820,1,8,1.0,9,0.1111111111111111
423097489,6,4,4.0,10,0.4
423101394,1,9,1.0,10,0.1
423101508,2,8,2.0,10,0.2
423102658,1,9,1.0,10,0.1
423104314,4,5,4.0,9,0.4444444444444444
423106210,3,6,3.0,9,0.3333333333333333
423112450,2,8,2.0,10,0.2
423117667,7,3,3.0,10,0.3
423118133,1,7,1.0,8,0.125
423118790,5,4,4.0,9,0.4444444444444444
423134410,2,8,2.0,10,0.2
423164534,2,17,2.0,19,0.10526315789473684
423189702,3,7,3.0,10,0.3
423194729,4,5,4.0,9,0.4444444444444444
423197778,4,6,4.0,10,0.4
423261969,2,8,2.0,10,0.2
423279980,1,8,1.0,9,0.1111111111111111
423283544,1,19,1.0,20,0.05
423284212,4,5,4.0,9,0.4444444444444444
423285867,2,8,2.0,10,0.2
423299822,2,8,2.0,10,0.2
423360636,8,2,2.0,10,0.2
423360856,9,1,1.0,10,0.1
423361897,9,1,1.0,10,0.1
423361938,27,3,3.0,30,0.1
423383779,1,9,1.0,10,0.1
423385007,1,9,1.0,10,0.1
423398606,1,9,1.0,10,0.1
423405242,5,21,5.0,26,0.19230769230769232
423408962,2,17,2.0,19,0.10526315789473684
423416273,10,18,10.0,28,0.35714285714285715
423426835,1,7,1.0,8,0.125
423451803,1,7,1.0,8,0.125
423473263,7,19,7.0,26,0.2692307692307692
423475331,3,6,3.0,9,0.3333333333333333
423477395,3,7,3.0,10,0.3
423500310,1,9,1.0,10,0.1
423516228,1,17,1.0,18,0.05555555555555555
423547056,3,7,3.0,10,0.3
423557425,1,7,1.0,8,0.125
423628157,3,7,3.0,10,0.3
423630683,3,7,3.0,10,0.3
423633833,1,15,1.0,16,0.0625
423643880,2,8,2.0,10,0.2
423644691,1,7,1.0,8,0.125
423646747,3,7,3.0,10,0.3
423648327,1,9,1.0,10,0.1
423654981,2,8,2.0,10,0.2
423661737,4,14,4.0,18,0.2222222222222222
423666935,2,26,2.0,28,0.07142857142857142
423731947,3,7,3.0,10,0.3
423732731,24,3,3.0,27,0.1111111111111111
423734286,1,9,1.0,10,0.1
423734652,5,5,5.0,10,0.5
423760315,1,18,1.0,19,0.05263157894736842
423761164,3,7,3.0,10,0.3
423763065,2,15,2.0,17,0.11764705882352941
423768104,9,1,1.0,10,0.1
423783385,23,5,5.0,28,0.17857142857142858
423797651,4,15,4.0,19,0.21052631578947367
423801142,2,7,2.0,9,0.2222222222222222
423804053,4,6,4.0,10,0.4
423818448,1,17,1.0,18,0.05555555555555555
423823340,1,9,1.0,10,0.1
423824335,6,3,3.0,9,0.3333333333333333
423824475,27,3,3.0,30,0.1
423825355,1,9,1.0,10,0.1
423825623,1,9,1.0,10,0.1
423899618,6,2,2.0,8,0.25
423927768,1,8,1.0,9,0.1111111111111111
423929113,2,8,2.0,10,0.2
423933061,8,2,2.0,10,0.2
423942976,26,2,2.0,28,0.07142857142857142
423943220,7,3,3.0,10,0.3
423949153,1,9,1.0,10,0.1
423952174,6,12,6.0,18,0.3333333333333333
423974128,1,19,1.0,20,0.05
423982270,1,9,1.0,10,0.1
423995596,4,5,4.0,9,0.4444444444444444
423997955,1,8,1.0,9,0.1111111111111111
424013460,1,8,1.0,9,0.1111111111111111
424015221,2,16,2.0,18,0.1111111111111111
424018205,2,7,2.0,9,0.2222222222222222
424026624,4,5,4.0,9,0.4444444444444444
424026717,6,4,4.0,10,0.4
424026935,3,7,3.0,10,0.3
424027001,2,7,2.0,9,0.2222222222222222
424027969,1,8,1.0,9,0.1111111111111111
424035938,1,9,1.0,10,0.1
424046996,8,2,2.0,10,0.2
424091087,1,18,1.0,19,0.05263157894736842
424134954,16,11,11.0,27,0.4074074074074074
424152650,1,8,1.0,9,0.1111111111111111
424233123,1,8,1.0,9,0.1111111111111111
424268386,1,19,1.0,20,0.05
424276004,1,9,1.0,10,0.1
424295789,1,19,1.0,20,0.05
424311065,13,15,13.0,28,0.4642857142857143
424312281,1,18,1.0,19,0.05263157894736842
424422424,4,4,4.0,8,0.5
424462530,1,9,1.0,10,0.1
424464647,1,9,1.0,10,0.1
424493618,2,6,2.0,8,0.25
424539382,2,8,2.0,10,0.2
424540968,8,2,2.0,10,0.2
424588666,5,5,5.0,10,0.5
424607740,9,1,1.0,10,0.1
424616177,2,8,2.0,10,0.2
424655195,4,15,4.0,19,0.21052631578947367
424657956,1,8,1.0,9,0.1111111111111111
424666117,3,7,3.0,10,0.3
424668935,10,19,10.0,29,0.3448275862068966
424689471,4,6,4.0,10,0.4
424693124,2,8,2.0,10,0.2
424702212,2,8,2.0,10,0.2
424703133,1,9,1.0,10,0.1
424719721,1,8,1.0,9,0.1111111111111111
424766379,1,9,1.0,10,0.1
424781231,4,6,4.0,10,0.4
424782699,9,20,9.0,29,0.3103448275862069
424782783,21,7,7.0,28,0.25
424783315,5,5,5.0,10,0.5
424796709,8,2,2.0,10,0.2
424830856,3,7,3.0,10,0.3
424831674,3,16,3.0,19,0.15789473684210525
424833133,5,4,4.0,9,0.4444444444444444
424895704,1,9,1.0,10,0.1
424898001,1,9,1.0,10,0.1
424898961,3,6,3.0,9,0.3333333333333333
424903156,3,7,3.0,10,0.3
424904873,7,2,2.0,9,0.2222222222222222
424905366,1,8,1.0,9,0.1111111111111111
424907425,1,9,1.0,10,0.1
424963495,1,9,1.0,10,0.1
425000898,4,6,4.0,10,0.4
425018660,2,8,2.0,10,0.2
425018913,1,8,1.0,9,0.1111111111111111
425036833,7,2,2.0,9,0.2222222222222222
425037525,8,1,1.0,9,0.1111111111111111
425055439,3,6,3.0,9,0.3333333333333333
425080723,2,8,2.0,10,0.2
425095530,1,28,1.0,29,0.034482758620689655
425098218,1,9,1.0,10,0.1
425100955,1,9,1.0,10,0.1
425116482,2,8,2.0,10,0.2
425122594,1,17,1.0,18,0.05555555555555555
425180665,1,8,1.0,9,0.1111111111111111
425213885,1,9,1.0,10,0.1
425239708,1,9,1.0,10,0.1
425243859,1,9,1.0,10,0.1
425274279,1,9,1.0,10,0.1
425383177,3,7,3.0,10,0.3
425389338,1,9,1.0,10,0.1
425421217,1,8,1.0,9,0.1111111111111111
425426770,3,6,3.0,9,0.3333333333333333
425427226,6,3,3.0,9,0.3333333333333333
425473133,2,18,2.0,20,0.1
425473788,1,9,1.0,10,0.1
425480542,5,3,3.0,8,0.375
425484373,6,4,4.0,10,0.4
425494975,1,19,1.0,20,0.05
425605288,2,17,2.0,19,0.10526315789473684
425666635,1,9,1.0,10,0.1
425671502,23,7,7.0,30,0.23333333333333334
425671965,7,2,2.0,9,0.2222222222222222
425672004,24,2,2.0,26,0.07692307692307693
425694567,2,7,2.0,9,0.2222222222222222
425699281,1,9,1.0,10,0.1
425699851,1,8,1.0,9,0.1111111111111111
425726192,4,33,4.0,37,0.10810810810810811
425726477,1,8,1.0,9,0.1111111111111111
425728155,1,9,1.0,10,0.1
425740253,8,12,8.0,20,0.4
425752711,1,9,1.0,10,0.1
425753760,1,9,1.0,10,0.1
425754807,9,17,9.0,26,0.34615384615384615
425755203,4,24,4.0,28,0.14285714285714285
425755465,6,4,4.0,10,0.4
425757964,1,18,1.0,19,0.05263157894736842
425766556,7,2,2.0,9,0.2222222222222222
425766813,27,1,1.0,28,0.03571428571428571
425801588,7,3,3.0,10,0.3
425842532,1,9,1.0,10,0.1
425891285,9,1,1.0,10,0.1
425900780,7,3,3.0,10,0.3
425913983,1,9,1.0,10,0.1
425917078,2,8,2.0,10,0.2
425920634,1,7,1.0,8,0.125
425922850,1,9,1.0,10,0.1
425923183,4,5,4.0,9,0.4444444444444444
425930592,3,6,3.0,9,0.3333333333333333
425931906,6,3,3.0,9,0.3333333333333333
425938011,1,8,1.0,9,0.1111111111111111
425939634,1,19,1.0,20,0.05
425948183,1,9,1.0,10,0.1
425959546,2,7,2.0,9,0.2222222222222222
425971438,7,2,2.0,9,0.2222222222222222
425997809,1,7,1.0,8,0.125
426058326,5,3,3.0,8,0.375
426109102,3,7,3.0,10,0.3
426124458,5,5,5.0,10,0.5
426125036,2,8,2.0,10,0.2
426127540,1,8,1.0,9,0.1111111111111111
426128206,2,7,2.0,9,0.2222222222222222
426128415,4,5,4.0,9,0.4444444444444444
426128694,2,6,2.0,8,0.25
426128825,5,5,5.0,10,0.5
426133571,3,7,3.0,10,0.3
426145602,2,8,2.0,10,0.2
426147778,1,9,1.0,10,0.1
426153008,4,5,4.0,9,0.4444444444444444
426154591,5,4,4.0,9,0.4444444444444444
426162558,2,7,2.0,9,0.2222222222222222
426163924,2,8,2.0,10,0.2
426170865,4,5,4.0,9,0.4444444444444444
426174480,1,18,1.0,19,0.05263157894736842
426186360,7,2,2.0,9,0.2222222222222222
426206337,5,5,5.0,10,0.5
426207841,1,9,1.0,10,0.1
426251348,1,8,1.0,9,0.1111111111111111
426255143,6,4,4.0,10,0.4
426255484,4,24,4.0,28,0.14285714285714285
426260593,3,5,3.0,8,0.375
426268017,24,3,3.0,27,0.1111111111111111
426268094,7,2,2.0,9,0.2222222222222222
426268232,5,3,3.0,8,0.375
426268634,8,2,2.0,10,0.2
426268887,4,6,4.0,10,0.4
426269272,8,1,1.0,9,0.1111111111111111
426295629,5,4,4.0,9,0.4444444444444444
426296682,2,8,2.0,10,0.2
426302414,2,8,2.0,10,0.2
426305715,1,8,1.0,9,0.1111111111111111
426306311,4,6,4.0,10,0.4
426306479,4,6,4.0,10,0.4
426307077,10,18,10.0,28,0.35714285714285715
426317282,2,8,2.0,10,0.2
426320416,3,7,3.0,10,0.3
426328591,1,9,1.0,10,0.1
426334123,6,4,4.0,10,0.4
426335597,2,7,2.0,9,0.2222222222222222
426336796,2,8,2.0,10,0.2
426387631,3,7,3.0,10,0.3
426392075,3,7,3.0,10,0.3
426420385,1,16,1.0,17,0.058823529411764705
426443009,2,8,2.0,10,0.2
426457360,2,8,2.0,10,0.2
426485242,2,7,2.0,9,0.2222222222222222
426502830,11,8,8.0,19,0.42105263157894735
426515246,3,6,3.0,9,0.3333333333333333
426520490,3,14,3.0,17,0.17647058823529413
426530776,2,6,2.0,8,0.25
426537026,3,7,3.0,10,0.3
426551076,3,7,3.0,10,0.3
426583403,2,7,2.0,9,0.2222222222222222
426587398,4,6,4.0,10,0.4
426588556,9,1,1.0,10,0.1
426589124,1,9,1.0,10,0.1
426591807,3,6,3.0,9,0.3333333333333333
426594149,3,7,3.0,10,0.3
426594372,7,1,1.0,8,0.125
426595566,2,8,2.0,10,0.2
426597433,8,2,2.0,10,0.2
426662408,1,9,1.0,10,0.1
426672559,3,7,3.0,10,0.3
426673406,2,8,2.0,10,0.2
426680022,7,3,3.0,10,0.3
426688653,1,9,1.0,10,0.1
426694568,9,1,1.0,10,0.1
426697179,1,8,1.0,9,0.1111111111111111
426697834,2,8,2.0,10,0.2
426698207,6,3,3.0,9,0.3333333333333333
426724723,2,8,2.0,10,0.2
426758307,1,19,1.0,20,0.05
426768956,5,5,5.0,10,0.5
426772875,2,8,2.0,10,0.2
426777496,1,9,1.0,10,0.1
426808074,1,9,1.0,10,0.1
426849701,1,7,1.0,8,0.125
426853024,1,8,1.0,9,0.1111111111111111
426901778,2,8,2.0,10,0.2
426926022,3,7,3.0,10,0.3
426949095,3,7,3.0,10,0.3
426955264,1,9,1.0,10,0.1
426969962,1,9,1.0,10,0.1
426971239,2,6,2.0,8,0.25
427010679,2,8,2.0,10,0.2
427011118,2,8,2.0,10,0.2
427011726,4,6,4.0,10,0.4
427011939,1,9,1.0,10,0.1
427012191,1,9,1.0,10,0.1
427012309,2,7,2.0,9,0.2222222222222222
427016782,8,1,1.0,9,0.1111111111111111
427019994,1,9,1.0,10,0.1
427032016,1,19,1.0,20,0.05
427034197,2,8,2.0,10,0.2
427050437,4,6,4.0,10,0.4
427109185,4,5,4.0,9,0.4444444444444444
427139258,5,22,5.0,27,0.18518518518518517
427145914,11,18,11.0,29,0.3793103448275862
427191217,2,8,2.0,10,0.2
427196025,7,2,2.0,9,0.2222222222222222
427204508,1,7,1.0,8,0.125
427216952,7,1,1.0,8,0.125
427217598,6,4,4.0,10,0.4
427218244,9,1,1.0,10,0.1
427222785,1,9,1.0,10,0.1
427226603,1,18,1.0,19,0.05263157894736842
427229136,2,17,2.0,19,0.10526315789473684
427238631,3,7,3.0,10,0.3
427241760,1,9,1.0,10,0.1
427276089,7,2,2.0,9,0.2222222222222222
427298597,17,3,3.0,20,0.15
427307699,1,7,1.0,8,0.125
427317534,8,1,1.0,9,0.1111111111111111
427318398,1,9,1.0,10,0.1
427323144,2,7,2.0,9,0.2222222222222222
427337925,3,7,3.0,10,0.3
427342375,1,9,1.0,10,0.1
427345619,8,1,1.0,9,0.1111111111111111
427356069,18,1,1.0,19,0.05263157894736842
427405011,3,7,3.0,10,0.3
427409719,7,3,3.0,10,0.3
427410823,1,18,1.0,19,0.05263157894736842
427437428,3,5,3.0,8,0.375
427437496,9,1,1.0,10,0.1
427444559,2,17,2.0,19,0.10526315789473684
427465241,5,5,5.0,10,0.5
427465908,3,7,3.0,10,0.3
427472884,1,7,1.0,8,0.125
427473282,1,8,1.0,9,0.1111111111111111
427483115,4,6,4.0,10,0.4
427483173,5,5,5.0,10,0.5
427483924,1,8,1.0,9,0.1111111111111111
427490889,5,4,4.0,9,0.4444444444444444
427514908,8,1,1.0,9,0.1111111111111111
427524607,1,9,1.0,10,0.1
427526754,1,9,1.0,10,0.1
427527963,2,8,2.0,10,0.2
427528572,7,3,3.0,10,0.3
427550023,5,5,5.0,10,0.5
427553543,7,2,2.0,9,0.2222222222222222
427577493,1,18,1.0,19,0.05263157894736842
427600549,1,8,1.0,9,0.1111111111111111
427634232,1,7,1.0,8,0.125
427634434,1,9,1.0,10,0.1
427683317,4,6,4.0,10,0.4
427704016,2,17,2.0,19,0.10526315789473684
427721736,1,16,1.0,17,0.058823529411764705
427742112,4,6,4.0,10,0.4
427744648,2,7,2.0,9,0.2222222222222222
427752278,2,8,2.0,10,0.2
427786122,4,5,4.0,9,0.4444444444444444
427823826,2,8,2.0,10,0.2
427837966,4,23,4.0,27,0.14814814814814814
427958359,1,9,1.0,10,0.1
427998242,2,8,2.0,10,0.2
428002223,5,5,5.0,10,0.5
428002288,2,6,2.0,8,0.25
428006345,1,26,1.0,27,0.037037037037037035
428055759,1,9,1.0,10,0.1
428174848,3,7,3.0,10,0.3
428184459,2,8,2.0,10,0.2
428184832,3,7,3.0,10,0.3
428185938,4,5,4.0,9,0.4444444444444444
428232370,2,8,2.0,10,0.2
428243678,1,9,1.0,10,0.1
428319862,3,7,3.0,10,0.3
428331260,1,9,1.0,10,0.1
428355117,1,9,1.0,10,0.1
428388057,4,4,4.0,8,0.5
428388979,5,5,5.0,10,0.5
428389954,7,3,3.0,10,0.3
428421466,2,8,2.0,10,0.2
428422943,1,8,1.0,9,0.1111111111111111
428423576,1,9,1.0,10,0.1
428438527,4,6,4.0,10,0.4
428447367,2,17,2.0,19,0.10526315789473684
428450088,9,1,1.0,10,0.1
428523258,1,16,1.0,17,0.058823529411764705
428527288,1,9,1.0,10,0.1
428529153,1,9,1.0,10,0.1
428566798,9,1,1.0,10,0.1
428580584,26,3,3.0,29,0.10344827586206896
428589277,7,3,3.0,10,0.3
428617023,3,7,3.0,10,0.3
428673560,1,9,1.0,10,0.1
428680130,1,27,1.0,28,0.03571428571428571
428682879,1,8,1.0,9,0.1111111111111111
428684127,2,8,2.0,10,0.2
428698987,2,8,2.0,10,0.2
428759734,3,7,3.0,10,0.3
428812863,1,8,1.0,9,0.1111111111111111
428822105,1,25,1.0,26,0.038461538461538464
428822198,1,28,1.0,29,0.034482758620689655
428836834,2,8,2.0,10,0.2
428837177,3,7,3.0,10,0.3
428845659,2,8,2.0,10,0.2
428846003,2,8,2.0,10,0.2
428848228,5,5,5.0,10,0.5
428849547,3,7,3.0,10,0.3
428853734,2,8,2.0,10,0.2
428937215,7,2,2.0,9,0.2222222222222222
428988020,1,8,1.0,9,0.1111111111111111
429016741,3,7,3.0,10,0.3
429041786,1,17,1.0,18,0.05555555555555555
429049727,3,7,3.0,10,0.3
429075733,1,8,1.0,9,0.1111111111111111
429108283,1,9,1.0,10,0.1
429141630,1,9,1.0,10,0.1
429213799,1,9,1.0,10,0.1
429282055,3,7,3.0,10,0.3
429337594,8,10,8.0,18,0.4444444444444444
429350947,4,6,4.0,10,0.4
429362110,3,7,3.0,10,0.3
429368103,1,9,1.0,10,0.1
429484221,1,18,1.0,19,0.05263157894736842
429486351,5,24,5.0,29,0.1724137931034483
429493932,22,5,5.0,27,0.18518518518518517
429494226,7,2,2.0,9,0.2222222222222222
429591492,3,17,3.0,20,0.15
429618695,2,6,2.0,8,0.25
429632647,5,5,5.0,10,0.5
429652521,3,7,3.0,10,0.3
429655422,5,5,5.0,10,0.5
429679626,4,6,4.0,10,0.4
429684806,5,24,5.0,29,0.1724137931034483
429720736,1,8,1.0,9,0.1111111111111111
429723181,1,9,1.0,10,0.1
429740402,1,9,1.0,10,0.1
429782663,3,7,3.0,10,0.3
429797477,1,9,1.0,10,0.1
429828110,1,9,1.0,10,0.1
429829299,1,9,1.0,10,0.1
429829380,3,7,3.0,10,0.3
429848778,1,18,1.0,19,0.05263157894736842
429861541,1,8,1.0,9,0.1111111111111111
429880917,4,5,4.0,9,0.4444444444444444
429882255,11,15,11.0,26,0.4230769230769231
429885012,4,5,4.0,9,0.4444444444444444
429901624,9,1,1.0,10,0.1
429902043,2,8,2.0,10,0.2
429925462,1,9,1.0,10,0.1
429925615,4,6,4.0,10,0.4
429935908,1,18,1.0,19,0.05263157894736842
429942599,27,1,1.0,28,0.03571428571428571
429997446,1,19,1.0,20,0.05
430014468,2,18,2.0,20,0.1
430024784,2,8,2.0,10,0.2
430034232,1,18,1.0,19,0.05263157894736842
430062084,9,1,1.0,10,0.1
430063037,7,3,3.0,10,0.3
430076740,1,9,1.0,10,0.1
430079958,1,17,1.0,18,0.05555555555555555
430082908,6,4,4.0,10,0.4
430083066,5,5,5.0,10,0.5
430090540,2,8,2.0,10,0.2
430100469,15,13,13.0,28,0.4642857142857143
430113329,1,9,1.0,10,0.1
430113801,1,9,1.0,10,0.1
430115885,26,2,2.0,28,0.07142857142857142
430115926,2,26,2.0,28,0.07142857142857142
430116326,1,8,1.0,9,0.1111111111111111
430121331,8,2,2.0,10,0.2
430125898,3,7,3.0,10,0.3
430140263,3,7,3.0,10,0.3
430160474,5,4,4.0,9,0.4444444444444444
430181840,1,18,1.0,19,0.05263157894736842
430256462,4,6,4.0,10,0.4
430256924,8,2,2.0,10,0.2
430282627,1,8,1.0,9,0.1111111111111111
430282630,1,9,1.0,10,0.1
430297563,2,8,2.0,10,0.2
430300744,8,2,2.0,10,0.2
430321369,4,6,4.0,10,0.4
430329022,3,5,3.0,8,0.375
430330710,4,23,4.0,27,0.14814814814814814
430334569,2,7,2.0,9,0.2222222222222222
430334649,1,9,1.0,10,0.1
430338551,6,23,6.0,29,0.20689655172413793
430381366,1,8,1.0,9,0.1111111111111111
430430843,9,1,1.0,10,0.1
430432526,5,4,4.0,9,0.4444444444444444
430433044,1,9,1.0,10,0.1
430433262,3,7,3.0,10,0.3
430436027,1,7,1.0,8,0.125
430444168,1,9,1.0,10,0.1
430454586,1,8,1.0,9,0.1111111111111111
430455267,5,5,5.0,10,0.5
430457841,2,8,2.0,10,0.2
430476252,3,6,3.0,9,0.3333333333333333
430482373,4,16,4.0,20,0.2
430484932,1,9,1.0,10,0.1
430485286,3,17,3.0,20,0.15
430508600,5,4,4.0,9,0.4444444444444444
430517073,3,7,3.0,10,0.3
430528836,6,3,3.0,9,0.3333333333333333
430547401,4,6,4.0,10,0.4
430548255,1,27,1.0,28,0.03571428571428571
430552979,5,3,3.0,8,0.375
430558796,1,9,1.0,10,0.1
430567837,1,7,1.0,8,0.125
430597134,4,6,4.0,10,0.4
430621473,8,2,2.0,10,0.2
430621695,7,2,2.0,9,0.2222222222222222
430648006,1,9,1.0,10,0.1
430661239,3,7,3.0,10,0.3
430687252,1,9,1.0,10,0.1
430687475,1,9,1.0,10,0.1
430688432,4,23,4.0,27,0.14814814814814814
430695715,2,6,2.0,8,0.25
430696439,2,7,2.0,9,0.2222222222222222
430719665,1,9,1.0,10,0.1
430730262,3,6,3.0,9,0.3333333333333333
430731372,2,8,2.0,10,0.2
430733955,2,8,2.0,10,0.2
430734562,2,8,2.0,10,0.2
430755867,1,9,1.0,10,0.1
430790705,3,7,3.0,10,0.3
430791814,4,21,4.0,25,0.16
430792440,6,4,4.0,10,0.4
430793268,2,8,2.0,10,0.2
430798477,3,7,3.0,10,0.3
430798718,1,9,1.0,10,0.1
430799275,3,15,3.0,18,0.16666666666666666
430799730,1,9,1.0,10,0.1
430805641,2,18,2.0,20,0.1
430807174,2,8,2.0,10,0.2
430816118,1,9,1.0,10,0.1
430834648,13,7,7.0,20,0.35
430853674,1,9,1.0,10,0.1
430854047,11,18,11.0,29,0.3793103448275862
430868900,1,9,1.0,10,0.1
430869294,2,8,2.0,10,0.2
430874914,1,7,1.0,8,0.125
430885999,1,8,1.0,9,0.1111111111111111
430894643,3,5,3.0,8,0.375
430898629,2,7,2.0,9,0.2222222222222222
430902979,3,7,3.0,10,0.3
430912604,4,14,4.0,18,0.2222222222222222
430914474,9,9,9.0,18,0.5
430915779,8,2,2.0,10,0.2
430919736,8,1,1.0,9,0.1111111111111111
430921092,7,3,3.0,10,0.3
430957612,5,5,5.0,10,0.5
430960037,5,5,5.0,10,0.5
430962771,1,9,1.0,10,0.1
430963276,4,6,4.0,10,0.4
430963482,6,3,3.0,9,0.3333333333333333
430973302,2,26,2.0,28,0.07142857142857142
430977401,1,9,1.0,10,0.1
430979626,6,4,4.0,10,0.4
430991274,8,2,2.0,10,0.2
430994641,8,1,1.0,9,0.1111111111111111
430995260,4,6,4.0,10,0.4
430999925,1,9,1.0,10,0.1
431000337,8,2,2.0,10,0.2
431000485,3,6,3.0,9,0.3333333333333333
431001414,3,7,3.0,10,0.3
431006225,3,7,3.0,10,0.3
431021864,6,14,6.0,20,0.3
431024679,1,9,1.0,10,0.1
431029431,2,8,2.0,10,0.2
431035004,1,8,1.0,9,0.1111111111111111
431035072,3,24,3.0,27,0.1111111111111111
431067967,9,1,1.0,10,0.1
431074065,7,3,3.0,10,0.3
431086000,12,17,12.0,29,0.41379310344827586
431089180,5,5,5.0,10,0.5
431096640,2,7,2.0,9,0.2222222222222222
431138208,1,9,1.0,10,0.1
431157162,1,17,1.0,18,0.05555555555555555
431193341,7,2,2.0,9,0.2222222222222222
431193634,6,4,4.0,10,0.4
431194529,10,18,10.0,28,0.35714285714285715
431196191,1,9,1.0,10,0.1
431200000,8,2,2.0,10,0.2
431201122,2,8,2.0,10,0.2
431202689,6,2,2.0,8,0.25
431203665,18,12,12.0,30,0.4
431208145,1,8,1.0,9,0.1111111111111111
431211204,5,5,5.0,10,0.5
431222350,1,9,1.0,10,0.1
431222847,2,8,2.0,10,0.2
431232508,1,9,1.0,10,0.1
431252872,3,5,3.0,8,0.375
431255096,1,9,1.0,10,0.1
431288800,1,19,1.0,20,0.05
431304144,1,9,1.0,10,0.1
431308710,6,3,3.0,9,0.3333333333333333
431330345,8,2,2.0,10,0.2
431344294,1,17,1.0,18,0.05555555555555555
431348503,1,8,1.0,9,0.1111111111111111
431361797,1,7,1.0,8,0.125
431378812,3,6,3.0,9,0.3333333333333333
431446432,2,7,2.0,9,0.2222222222222222
431446564,6,3,3.0,9,0.3333333333333333
431449652,3,5,3.0,8,0.375
431468103,4,5,4.0,9,0.4444444444444444
431469027,5,4,4.0,9,0.4444444444444444
431470082,1,28,1.0,29,0.034482758620689655
431478225,1,19,1.0,20,0.05
431480335,1,7,1.0,8,0.125
431480573,2,7,2.0,9,0.2222222222222222
431480780,1,8,1.0,9,0.1111111111111111
431497381,1,8,1.0,9,0.1111111111111111
431499134,1,9,1.0,10,0.1
431509877,5,5,5.0,10,0.5
431510404,2,7,2.0,9,0.2222222222222222
431510545,1,8,1.0,9,0.1111111111111111
431511086,2,6,2.0,8,0.25
431511683,2,7,2.0,9,0.2222222222222222
431525935,5,4,4.0,9,0.4444444444444444
431588127,1,8,1.0,9,0.1111111111111111
431599952,2,8,2.0,10,0.2
431614188,28,2,2.0,30,0.06666666666666667
431638161,1,9,1.0,10,0.1
431645548,1,18,1.0,19,0.05263157894736842
431682125,2,7,2.0,9,0.2222222222222222
431697307,2,8,2.0,10,0.2
431721328,2,8,2.0,10,0.2
431725306,1,7,1.0,8,0.125
431731963,6,22,6.0,28,0.21428571428571427
431740628,1,17,1.0,18,0.05555555555555555
431756989,5,5,5.0,10,0.5
431764443,2,8,2.0,10,0.2
431765167,5,4,4.0,9,0.4444444444444444
431767737,8,21,8.0,29,0.27586206896551724
431769078,6,14,6.0,20,0.3
431776082,1,19,1.0,20,0.05
431821290,3,7,3.0,10,0.3
431835598,1,8,1.0,9,0.1111111111111111
431864939,8,1,1.0,9,0.1111111111111111
431865575,4,5,4.0,9,0.4444444444444444
431896115,2,8,2.0,10,0.2
431900548,1,8,1.0,9,0.1111111111111111
431900567,2,8,2.0,10,0.2
431912577,9,1,1.0,10,0.1
431935299,1,9,1.0,10,0.1
431941017,1,8,1.0,9,0.1111111111111111
431953100,5,4,4.0,9,0.4444444444444444
432003072,3,7,3.0,10,0.3
432061924,4,6,4.0,10,0.4
432063106,2,7,2.0,9,0.2222222222222222
432108063,1,19,1.0,20,0.05
432178664,1,9,1.0,10,0.1
432223342,1,9,1.0,10,0.1
432225049,1,9,1.0,10,0.1
432239397,3,26,3.0,29,0.10344827586206896
432246852,1,9,1.0,10,0.1
432249191,8,2,2.0,10,0.2
432249548,1,8,1.0,9,0.1111111111111111
432278212,8,1,1.0,9,0.1111111111111111
432283556,2,8,2.0,10,0.2
432288330,1,8,1.0,9,0.1111111111111111
432316883,1,16,1.0,17,0.058823529411764705
432345414,1,9,1.0,10,0.1
432347203,1,27,1.0,28,0.03571428571428571
432351636,3,7,3.0,10,0.3
432423872,1,19,1.0,20,0.05
432426315,3,6,3.0,9,0.3333333333333333
432430210,1,9,1.0,10,0.1
432434411,1,7,1.0,8,0.125
432457849,1,19,1.0,20,0.05
432463995,3,6,3.0,9,0.3333333333333333
432478497,4,14,4.0,18,0.2222222222222222
432507171,3,7,3.0,10,0.3
432521174,9,1,1.0,10,0.1
432574665,9,1,1.0,10,0.1
432575714,20,7,7.0,27,0.25925925925925924
432589686,1,8,1.0,9,0.1111111111111111
432640969,1,9,1.0,10,0.1
432660951,1,9,1.0,10,0.1
432662595,1,7,1.0,8,0.125
432673226,5,5,5.0,10,0.5
432680527,6,13,6.0,19,0.3157894736842105
432734106,6,3,3.0,9,0.3333333333333333
432777586,1,8,1.0,9,0.1111111111111111
432780020,2,8,2.0,10,0.2
432780621,2,8,2.0,10,0.2
432780932,1,9,1.0,10,0.1
432843725,7,3,3.0,10,0.3
432844870,1,9,1.0,10,0.1
432846709,1,9,1.0,10,0.1
432846989,4,6,4.0,10,0.4
432847015,2,8,2.0,10,0.2
432848580,9,1,1.0,10,0.1
432850663,13,6,6.0,19,0.3157894736842105
432856566,5,5,5.0,10,0.5
432860400,4,6,4.0,10,0.4
432866480,3,7,3.0,10,0.3
432867217,7,19,7.0,26,0.2692307692307692
432867428,9,20,9.0,29,0.3103448275862069
432868223,3,6,3.0,9,0.3333333333333333
432875742,2,7,2.0,9,0.2222222222222222
432876542,2,6,2.0,8,0.25
432876963,5,4,4.0,9,0.4444444444444444
432877817,7,3,3.0,10,0.3
432880156,2,8,2.0,10,0.2
432887222,3,5,3.0,8,0.375
432889635,3,17,3.0,20,0.15
432893097,1,8,1.0,9,0.1111111111111111
432895863,2,8,2.0,10,0.2
432928273,4,5,4.0,9,0.4444444444444444
432945796,3,7,3.0,10,0.3
432950084,2,8,2.0,10,0.2
432954607,5,5,5.0,10,0.5
432998808,1,9,1.0,10,0.1
433003353,4,6,4.0,10,0.4
433008760,3,6,3.0,9,0.3333333333333333
433020777,1,9,1.0,10,0.1
433044802,1,9,1.0,10,0.1
433052522,1,9,1.0,10,0.1
433053025,2,8,2.0,10,0.2
433058156,27,3,3.0,30,0.1
433063570,20,9,9.0,29,0.3103448275862069
433063760,5,4,4.0,9,0.4444444444444444
433065363,2,7,2.0,9,0.2222222222222222
433066705,9,1,1.0,10,0.1
433091679,1,9,1.0,10,0.1
433104292,1,9,1.0,10,0.1
433109982,8,2,2.0,10,0.2
433116190,4,6,4.0,10,0.4
433116964,4,5,4.0,9,0.4444444444444444
433127909,1,8,1.0,9,0.1111111111111111
433182872,1,9,1.0,10,0.1
433229202,1,8,1.0,9,0.1111111111111111
433252696,8,1,1.0,9,0.1111111111111111
433280509,1,8,1.0,9,0.1111111111111111
433295286,8,2,2.0,10,0.2
433327827,4,6,4.0,10,0.4
433329898,2,7,2.0,9,0.2222222222222222
433350780,1,9,1.0,10,0.1
433383900,2,7,2.0,9,0.2222222222222222
433425230,1,8,1.0,9,0.1111111111111111
433443693,5,4,4.0,9,0.4444444444444444
433456275,2,8,2.0,10,0.2
433476213,1,9,1.0,10,0.1
433500641,4,6,4.0,10,0.4
433540984,4,6,4.0,10,0.4
433556764,2,7,2.0,9,0.2222222222222222
433667838,1,19,1.0,20,0.05
433704601,1,17,1.0,18,0.05555555555555555
433721404,1,8,1.0,9,0.1111111111111111
433725155,1,9,1.0,10,0.1
433739884,9,1,1.0,10,0.1
433768036,4,5,4.0,9,0.4444444444444444
433769241,8,1,1.0,9,0.1111111111111111
433772164,1,8,1.0,9,0.1111111111111111
433786444,1,8,1.0,9,0.1111111111111111
433788599,3,17,3.0,20,0.15
433883631,2,8,2.0,10,0.2
433913646,2,7,2.0,9,0.2222222222222222
433931420,5,5,5.0,10,0.5
433981443,2,7,2.0,9,0.2222222222222222
433983899,2,8,2.0,10,0.2
433991138,5,3,3.0,8,0.375
434011380,1,8,1.0,9,0.1111111111111111
434030216,2,8,2.0,10,0.2
434030376,1,9,1.0,10,0.1
434035882,5,5,5.0,10,0.5
434037987,1,7,1.0,8,0.125
434043689,1,16,1.0,17,0.058823529411764705
434055914,2,8,2.0,10,0.2
434056957,2,8,2.0,10,0.2
434072829,5,10,5.0,15,0.3333333333333333
434080102,7,3,3.0,10,0.3
434109505,4,6,4.0,10,0.4
434131919,4,6,4.0,10,0.4
434134216,2,6,2.0,8,0.25
434145900,1,8,1.0,9,0.1111111111111111
434188932,2,26,2.0,28,0.07142857142857142
434206607,2,7,2.0,9,0.2222222222222222
434206696,2,7,2.0,9,0.2222222222222222
434208425,1,19,1.0,20,0.05
434226631,2,8,2.0,10,0.2
434256291,3,6,3.0,9,0.3333333333333333
434272035,1,9,1.0,10,0.1
434288143,1,9,1.0,10,0.1
434290566,1,9,1.0,10,0.1
434291117,2,8,2.0,10,0.2
434324184,5,5,5.0,10,0.5
434324804,1,9,1.0,10,0.1
434334807,22,5,5.0,27,0.18518518518518517
434335534,7,3,3.0,10,0.3
434346520,11,16,11.0,27,0.4074074074074074
434347237,6,4,4.0,10,0.4
434348394,5,3,3.0,8,0.375
434349328,7,3,3.0,10,0.3
434359942,2,7,2.0,9,0.2222222222222222
434364079,1,9,1.0,10,0.1
434368070,3,7,3.0,10,0.3
434371766,7,3,3.0,10,0.3
434372192,9,1,1.0,10,0.1
434372590,5,5,5.0,10,0.5
434373461,6,4,4.0,10,0.4
434374079,8,1,1.0,9,0.1111111111111111
434377865,1,8,1.0,9,0.1111111111111111
434381851,2,27,2.0,29,0.06896551724137931
434437422,1,9,1.0,10,0.1
434440492,2,8,2.0,10,0.2
434468149,3,7,3.0,10,0.3
434473623,1,9,1.0,10,0.1
434474632,8,1,1.0,9,0.1111111111111111
434474944,1,7,1.0,8,0.125
434475167,25,5,5.0,30,0.16666666666666666
434479337,7,3,3.0,10,0.3
434479716,3,7,3.0,10,0.3
434480856,4,4,4.0,8,0.5
434481868,3,23,3.0,26,0.11538461538461539
434487317,2,8,2.0,10,0.2
434531891,1,9,1.0,10,0.1
434549407,1,9,1.0,10,0.1
434560639,2,8,2.0,10,0.2
434570489,1,9,1.0,10,0.1
434572266,1,8,1.0,9,0.1111111111111111
434607232,4,6,4.0,10,0.4
434642584,1,8,1.0,9,0.1111111111111111
434677348,2,8,2.0,10,0.2
434737191,8,2,2.0,10,0.2
434744021,1,7,1.0,8,0.125
434795271,7,3,3.0,10,0.3
434801933,2,7,2.0,9,0.2222222222222222
434844448,7,2,2.0,9,0.2222222222222222
434857545,8,2,2.0,10,0.2
434858546,16,13,13.0,29,0.4482758620689655
434864120,1,8,1.0,9,0.1111111111111111
434866099,1,8,1.0,9,0.1111111111111111
434883432,1,9,1.0,10,0.1
434902514,1,8,1.0,9,0.1111111111111111
434910322,1,9,1.0,10,0.1
434926030,1,26,1.0,27,0.037037037037037035
434928243,2,8,2.0,10,0.2
434937649,1,9,1.0,10,0.1
434949294,1,9,1.0,10,0.1
434961301,1,9,1.0,10,0.1
434979838,8,1,1.0,9,0.1111111111111111
434995737,2,8,2.0,10,0.2
435009500,4,15,4.0,19,0.21052631578947367
435010146,4,6,4.0,10,0.4
435010482,25,3,3.0,28,0.10714285714285714
435034763,3,14,3.0,17,0.17647058823529413
435038584,3,7,3.0,10,0.3
435041743,1,18,1.0,19,0.05263157894736842
435077268,2,8,2.0,10,0.2
435077614,1,9,1.0,10,0.1
435078969,6,4,4.0,10,0.4
435088559,5,5,5.0,10,0.5
435141174,1,8,1.0,9,0.1111111111111111
435164310,2,8,2.0,10,0.2
435215123,1,9,1.0,10,0.1
435231802,7,3,3.0,10,0.3
435246317,1,9,1.0,10,0.1
435246720,3,7,3.0,10,0.3
435246766,5,5,5.0,10,0.5
435263250,1,8,1.0,9,0.1111111111111111
435266638,4,22,4.0,26,0.15384615384615385
435276210,4,6,4.0,10,0.4
435352968,3,7,3.0,10,0.3
435390017,1,8,1.0,9,0.1111111111111111
435391107,2,8,2.0,10,0.2
435397565,1,8,1.0,9,0.1111111111111111
435399074,2,7,2.0,9,0.2222222222222222
435406694,1,8,1.0,9,0.1111111111111111
435457502,6,4,4.0,10,0.4
435457927,1,7,1.0,8,0.125
435458242,2,7,2.0,9,0.2222222222222222
435458570,6,3,3.0,9,0.3333333333333333
435459039,1,9,1.0,10,0.1
435469756,1,8,1.0,9,0.1111111111111111
435500397,1,7,1.0,8,0.125
435512946,6,4,4.0,10,0.4
435514177,8,2,2.0,10,0.2
435528778,1,9,1.0,10,0.1
435574727,15,13,13.0,28,0.4642857142857143
435582397,2,14,2.0,16,0.125
435673008,1,9,1.0,10,0.1
435802025,1,9,1.0,10,0.1
435822182,4,5,4.0,9,0.4444444444444444
435831967,2,7,2.0,9,0.2222222222222222
435844175,2,8,2.0,10,0.2
435850942,1,8,1.0,9,0.1111111111111111
435877385,2,7,2.0,9,0.2222222222222222
435877811,7,23,7.0,30,0.23333333333333334
435917499,2,18,2.0,20,0.1
435927301,2,8,2.0,10,0.2
435932307,6,4,4.0,10,0.4
435932648,1,9,1.0,10,0.1
435936215,1,18,1.0,19,0.05263157894736842
435936533,2,8,2.0,10,0.2
435965438,7,3,3.0,10,0.3
435966125,27,1,1.0,28,0.03571428571428571
435966337,2,8,2.0,10,0.2
435977246,4,16,4.0,20,0.2
435994542,2,8,2.0,10,0.2
436001058,2,8,2.0,10,0.2
436005411,5,3,3.0,8,0.375
436016481,7,2,2.0,9,0.2222222222222222
436023164,1,8,1.0,9,0.1111111111111111
436024707,8,17,8.0,25,0.32
436054876,8,1,1.0,9,0.1111111111111111
436057974,8,1,1.0,9,0.1111111111111111
436068856,5,5,5.0,10,0.5
436070693,1,9,1.0,10,0.1
436071691,4,6,4.0,10,0.4
436084480,6,11,6.0,17,0.35294117647058826
436096960,1,9,1.0,10,0.1
436105446,2,8,2.0,10,0.2
436136458,7,1,1.0,8,0.125
436174177,8,2,2.0,10,0.2
436180604,1,18,1.0,19,0.05263157894736842
436246112,4,6,4.0,10,0.4
436246374,1,9,1.0,10,0.1
436246872,3,6,3.0,9,0.3333333333333333
436247490,1,8,1.0,9,0.1111111111111111
436247960,1,7,1.0,8,0.125
436263264,3,16,3.0,19,0.15789473684210525
436270593,1,9,1.0,10,0.1
436272455,2,7,2.0,9,0.2222222222222222
436274853,2,8,2.0,10,0.2
436275410,5,5,5.0,10,0.5
436288333,12,17,12.0,29,0.41379310344827586
436369290,1,8,1.0,9,0.1111111111111111
436384659,3,7,3.0,10,0.3
436418134,2,24,2.0,26,0.07692307692307693
436420596,1,9,1.0,10,0.1
436425537,2,8,2.0,10,0.2
436430867,1,8,1.0,9,0.1111111111111111
436454348,1,9,1.0,10,0.1
436463462,6,4,4.0,10,0.4
436466836,2,8,2.0,10,0.2
436467026,9,1,1.0,10,0.1
436467208,6,4,4.0,10,0.4
436471757,6,3,3.0,9,0.3333333333333333
436543214,4,6,4.0,10,0.4
436573699,8,1,1.0,9,0.1111111111111111
436582426,1,9,1.0,10,0.1
436582549,2,8,2.0,10,0.2
436585132,2,8,2.0,10,0.2
436587829,1,9,1.0,10,0.1
436601034,1,9,1.0,10,0.1
436601474,5,5,5.0,10,0.5
436618389,6,22,6.0,28,0.21428571428571427
436657547,1,9,1.0,10,0.1
436674818,1,8,1.0,9,0.1111111111111111
436675211,1,9,1.0,10,0.1
436675805,3,27,3.0,30,0.1
436683241,11,9,9.0,20,0.45
436683373,5,3,3.0,8,0.375
436688251,1,19,1.0,20,0.05
436741480,1,19,1.0,20,0.05
436742341,2,8,2.0,10,0.2
436762905,1,8,1.0,9,0.1111111111111111
436764111,4,6,4.0,10,0.4
436764924,9,1,1.0,10,0.1
436767536,4,6,4.0,10,0.4
436794538,6,3,3.0,9,0.3333333333333333
436799493,2,8,2.0,10,0.2
436801802,7,1,1.0,8,0.125
436802581,24,5,5.0,29,0.1724137931034483
436807363,1,9,1.0,10,0.1
436813157,1,9,1.0,10,0.1
436898928,2,7,2.0,9,0.2222222222222222
436910082,1,19,1.0,20,0.05
436911447,24,4,4.0,28,0.14285714285714285
436945173,6,3,3.0,9,0.3333333333333333
436945726,8,2,2.0,10,0.2
436952275,3,7,3.0,10,0.3
436953538,1,17,1.0,18,0.05555555555555555
436953601,1,9,1.0,10,0.1
436961797,1,9,1.0,10,0.1
436974561,1,8,1.0,9,0.1111111111111111
437076730,1,9,1.0,10,0.1
437084660,8,10,8.0,18,0.4444444444444444
437093288,1,7,1.0,8,0.125
437111380,1,8,1.0,9,0.1111111111111111
437113259,1,9,1.0,10,0.1
437114950,4,6,4.0,10,0.4
437115071,6,3,3.0,9,0.3333333333333333
437127820,3,6,3.0,9,0.3333333333333333
437129044,1,9,1.0,10,0.1
437144385,6,14,6.0,20,0.3
437291788,4,6,4.0,10,0.4
437311080,7,2,2.0,9,0.2222222222222222
437326634,6,3,3.0,9,0.3333333333333333
437359278,1,17,1.0,18,0.05555555555555555
437364060,1,9,1.0,10,0.1
437370400,1,9,1.0,10,0.1
437391377,1,17,1.0,18,0.05555555555555555
437407760,7,3,3.0,10,0.3
437409841,3,6,3.0,9,0.3333333333333333
437425705,6,3,3.0,9,0.3333333333333333
437425908,8,2,2.0,10,0.2
437426129,2,6,2.0,8,0.25
437426692,2,7,2.0,9,0.2222222222222222
437427119,7,2,2.0,9,0.2222222222222222
437445839,15,5,5.0,20,0.25
437446718,4,6,4.0,10,0.4
437454514,2,8,2.0,10,0.2
437473578,2,15,2.0,17,0.11764705882352941
437473885,3,7,3.0,10,0.3
437509203,1,16,1.0,17,0.058823529411764705
437526030,7,3,3.0,10,0.3
437527165,2,7,2.0,9,0.2222222222222222
437527717,1,9,1.0,10,0.1
437530749,4,6,4.0,10,0.4
437532848,2,7,2.0,9,0.2222222222222222
437534084,7,2,2.0,9,0.2222222222222222
437660937,8,11,8.0,19,0.42105263157894735
437662888,4,5,4.0,9,0.4444444444444444
437670332,5,5,5.0,10,0.5
437725406,2,8,2.0,10,0.2
437767295,1,19,1.0,20,0.05
437813854,1,8,1.0,9,0.1111111111111111
437836858,2,7,2.0,9,0.2222222222222222
437840159,7,3,3.0,10,0.3
437842427,7,2,2.0,9,0.2222222222222222
437851727,1,8,1.0,9,0.1111111111111111
437858831,11,9,9.0,20,0.45
437868553,2,17,2.0,19,0.10526315789473684
437896314,1,9,1.0,10,0.1
437948507,5,5,5.0,10,0.5
437952333,2,18,2.0,20,0.1
437953500,3,6,3.0,9,0.3333333333333333
437955320,3,6,3.0,9,0.3333333333333333
437955424,1,8,1.0,9,0.1111111111111111
437963243,1,17,1.0,18,0.05555555555555555
437978904,1,9,1.0,10,0.1
437985524,2,8,2.0,10,0.2
438036885,1,9,1.0,10,0.1
438040367,1,9,1.0,10,0.1
438043854,1,9,1.0,10,0.1
438080977,2,7,2.0,9,0.2222222222222222
438085001,6,4,4.0,10,0.4
438085401,2,16,2.0,18,0.1111111111111111
438094326,1,8,1.0,9,0.1111111111111111
438127468,1,9,1.0,10,0.1
438173395,27,1,1.0,28,0.03571428571428571
438184411,1,9,1.0,10,0.1
438193245,2,8,2.0,10,0.2
438213958,7,1,1.0,8,0.125
438235273,5,4,4.0,9,0.4444444444444444
438241529,6,4,4.0,10,0.4
438298622,1,9,1.0,10,0.1
438304561,1,19,1.0,20,0.05
438336001,7,2,2.0,9,0.2222222222222222
438336144,3,7,3.0,10,0.3
438336196,5,3,3.0,8,0.375
438336779,1,9,1.0,10,0.1
438338531,2,6,2.0,8,0.25
438353651,6,4,4.0,10,0.4
438375084,8,2,2.0,10,0.2
438388373,2,7,2.0,9,0.2222222222222222
438402277,7,2,2.0,9,0.2222222222222222
438402536,3,7,3.0,10,0.3
438403115,5,24,5.0,29,0.1724137931034483
438421420,9,10,9.0,19,0.47368421052631576
438422626,1,8,1.0,9,0.1111111111111111
438423546,1,7,1.0,8,0.125
438424164,1,8,1.0,9,0.1111111111111111
438425017,1,9,1.0,10,0.1
438442560,2,16,2.0,18,0.1111111111111111
438461623,1,8,1.0,9,0.1111111111111111
438491343,2,17,2.0,19,0.10526315789473684
438519655,1,8,1.0,9,0.1111111111111111
438520452,8,2,2.0,10,0.2
438521433,8,2,2.0,10,0.2
438521869,1,8,1.0,9,0.1111111111111111
438525276,8,1,1.0,9,0.1111111111111111
438526420,3,7,3.0,10,0.3
438527962,19,9,9.0,28,0.32142857142857145
438542736,8,1,1.0,9,0.1111111111111111
438569423,2,8,2.0,10,0.2
438571177,1,9,1.0,10,0.1
438572125,2,8,2.0,10,0.2
438583435,2,7,2.0,9,0.2222222222222222
438584646,4,6,4.0,10,0.4
438585218,4,5,4.0,9,0.4444444444444444
438586760,3,6,3.0,9,0.3333333333333333
438588590,2,7,2.0,9,0.2222222222222222
438588906,1,9,1.0,10,0.1
438595190,2,8,2.0,10,0.2
438617547,1,9,1.0,10,0.1
438618479,5,5,5.0,10,0.5
438619309,1,8,1.0,9,0.1111111111111111
438626611,1,17,1.0,18,0.05555555555555555
438636234,8,11,8.0,19,0.42105263157894735
438655890,5,22,5.0,27,0.18518518518518517
438664195,6,4,4.0,10,0.4
438683540,1,9,1.0,10,0.1
438683741,5,4,4.0,9,0.4444444444444444
438684370,9,1,1.0,10,0.1
438684528,9,1,1.0,10,0.1
438694277,7,1,1.0,8,0.125
438694346,1,9,1.0,10,0.1
438699915,3,17,3.0,20,0.15
438731584,4,14,4.0,18,0.2222222222222222
438742794,1,9,1.0,10,0.1
438808445,25,4,4.0,29,0.13793103448275862
438808952,3,6,3.0,9,0.3333333333333333
439023962,6,3,3.0,9,0.3333333333333333
439037411,1,9,1.0,10,0.1
439135082,8,1,1.0,9,0.1111111111111111
439144281,2,7,2.0,9,0.2222222222222222
439160800,8,2,2.0,10,0.2
439179658,1,9,1.0,10,0.1
439186320,1,9,1.0,10,0.1
439187368,8,2,2.0,10,0.2
439188902,7,1,1.0,8,0.125
439188993,8,2,2.0,10,0.2
439189059,5,4,4.0,9,0.4444444444444444
439189204,6,4,4.0,10,0.4
439189363,4,6,4.0,10,0.4
439205011,1,9,1.0,10,0.1
439214070,1,18,1.0,19,0.05263157894736842
439217735,2,15,2.0,17,0.11764705882352941
439257784,1,9,1.0,10,0.1
439263805,2,7,2.0,9,0.2222222222222222
439271523,1,9,1.0,10,0.1
439299461,4,5,4.0,9,0.4444444444444444
439332967,8,2,2.0,10,0.2
439337324,1,9,1.0,10,0.1
439372474,1,8,1.0,9,0.1111111111111111
439399335,1,9,1.0,10,0.1
439426149,3,7,3.0,10,0.3
439438024,7,2,2.0,9,0.2222222222222222
439453496,2,8,2.0,10,0.2
439458380,4,24,4.0,28,0.14285714285714285
439510346,1,9,1.0,10,0.1
439556229,1,9,1.0,10,0.1
439574415,6,2,2.0,8,0.25
439574800,2,8,2.0,10,0.2
439648833,1,9,1.0,10,0.1
439701472,1,7,1.0,8,0.125
439757385,1,27,1.0,28,0.03571428571428571
439787203,2,8,2.0,10,0.2
439790205,1,9,1.0,10,0.1
439792073,1,9,1.0,10,0.1
439826948,3,7,3.0,10,0.3
439833338,7,3,3.0,10,0.3
439846943,3,11,3.0,14,0.21428571428571427
439934924,1,9,1.0,10,0.1
439953905,1,17,1.0,18,0.05555555555555555
439984042,4,6,4.0,10,0.4
440001346,1,9,1.0,10,0.1
440029648,1,9,1.0,10,0.1
440042553,2,8,2.0,10,0.2
440103239,3,26,3.0,29,0.10344827586206896
440103576,3,24,3.0,27,0.1111111111111111
440115065,1,7,1.0,8,0.125
440120691,6,4,4.0,10,0.4
440129834,1,18,1.0,19,0.05263157894736842
440153706,1,9,1.0,10,0.1
440178797,3,7,3.0,10,0.3
440179771,4,5,4.0,9,0.4444444444444444
440180207,6,2,2.0,8,0.25
440207476,2,8,2.0,10,0.2
440209544,1,9,1.0,10,0.1
440240019,1,9,1.0,10,0.1
440275371,3,7,3.0,10,0.3
440285098,1,9,1.0,10,0.1
440291313,1,9,1.0,10,0.1
440342112,9,1,1.0,10,0.1
440397989,2,8,2.0,10,0.2
440400376,23,5,5.0,28,0.17857142857142858
440405746,1,7,1.0,8,0.125
440417726,1,9,1.0,10,0.1
440425071,1,7,1.0,8,0.125
440453905,1,9,1.0,10,0.1
440480157,6,3,3.0,9,0.3333333333333333
440484754,1,9,1.0,10,0.1
440484763,4,6,4.0,10,0.4
440497056,3,6,3.0,9,0.3333333333333333
440499228,8,20,8.0,28,0.2857142857142857
440537949,8,2,2.0,10,0.2
440538278,8,2,2.0,10,0.2
440555612,1,8,1.0,9,0.1111111111111111
440556895,2,8,2.0,10,0.2
440592011,9,1,1.0,10,0.1
440606438,1,8,1.0,9,0.1111111111111111
440608606,8,1,1.0,9,0.1111111111111111
440608723,1,8,1.0,9,0.1111111111111111
440609112,26,1,1.0,27,0.037037037037037035
440657582,2,7,2.0,9,0.2222222222222222
440689269,2,18,2.0,20,0.1
440694870,1,8,1.0,9,0.1111111111111111
440770499,1,8,1.0,9,0.1111111111111111
440773030,1,19,1.0,20,0.05
440812495,1,16,1.0,17,0.058823529411764705
440824739,8,2,2.0,10,0.2
440851458,5,3,3.0,8,0.375
440886624,6,3,3.0,9,0.3333333333333333
440889596,2,8,2.0,10,0.2
440890521,2,8,2.0,10,0.2
440892217,2,8,2.0,10,0.2
440907741,2,8,2.0,10,0.2
440908527,4,6,4.0,10,0.4
440909747,1,8,1.0,9,0.1111111111111111
440913665,4,6,4.0,10,0.4
440919845,3,7,3.0,10,0.3
440942146,1,7,1.0,8,0.125
440942949,1,17,1.0,18,0.05555555555555555
440969883,4,4,4.0,8,0.5
440991501,4,24,4.0,28,0.14285714285714285
440998076,1,18,1.0,19,0.05263157894736842
441031553,1,9,1.0,10,0.1
441036542,1,18,1.0,19,0.05263157894736842
441055968,1,17,1.0,18,0.05555555555555555
441063581,2,8,2.0,10,0.2
441065751,2,7,2.0,9,0.2222222222222222
441101298,1,8,1.0,9,0.1111111111111111
441110884,1,9,1.0,10,0.1
441113751,3,6,3.0,9,0.3333333333333333
441132363,2,8,2.0,10,0.2
441147592,1,8,1.0,9,0.1111111111111111
441149973,2,8,2.0,10,0.2
441188752,2,8,2.0,10,0.2
441212213,1,9,1.0,10,0.1
441215480,2,7,2.0,9,0.2222222222222222
441216268,1,9,1.0,10,0.1
441230798,2,8,2.0,10,0.2
441231320,1,18,1.0,19,0.05263157894736842
441234027,1,8,1.0,9,0.1111111111111111
441234529,5,4,4.0,9,0.4444444444444444
441239817,2,7,2.0,9,0.2222222222222222
441241578,1,9,1.0,10,0.1
441245689,2,7,2.0,9,0.2222222222222222
441281296,1,9,1.0,10,0.1
441281913,1,18,1.0,19,0.05263157894736842
441295849,1,8,1.0,9,0.1111111111111111
441302501,7,3,3.0,10,0.3
441302593,2,8,2.0,10,0.2
441306066,1,9,1.0,10,0.1
441306801,3,17,3.0,20,0.15
441308437,3,6,3.0,9,0.3333333333333333
441308882,2,8,2.0,10,0.2
441318675,4,5,4.0,9,0.4444444444444444
441325562,1,9,1.0,10,0.1
441326054,7,3,3.0,10,0.3
441327544,1,8,1.0,9,0.1111111111111111
441340974,2,8,2.0,10,0.2
441341512,2,27,2.0,29,0.06896551724137931
441347385,3,6,3.0,9,0.3333333333333333
441348403,1,9,1.0,10,0.1
441371250,3,16,3.0,19,0.15789473684210525
441413379,1,8,1.0,9,0.1111111111111111
441439302,13,16,13.0,29,0.4482758620689655
441450012,1,25,1.0,26,0.038461538461538464
441454904,1,9,1.0,10,0.1
441468877,8,22,8.0,30,0.26666666666666666
441483203,2,18,2.0,20,0.1
441521742,1,17,1.0,18,0.05555555555555555
441530230,4,4,4.0,8,0.5
441530933,1,9,1.0,10,0.1
441537836,2,8,2.0,10,0.2
441538612,1,9,1.0,10,0.1
441541217,2,8,2.0,10,0.2
441564325,2,8,2.0,10,0.2
441566331,5,4,4.0,9,0.4444444444444444
441586186,1,8,1.0,9,0.1111111111111111
441604016,1,9,1.0,10,0.1
441604879,1,18,1.0,19,0.05263157894736842
441621519,3,24,3.0,27,0.1111111111111111
441623460,1,26,1.0,27,0.037037037037037035
441650005,4,6,4.0,10,0.4
441650188,1,8,1.0,9,0.1111111111111111
441659456,3,7,3.0,10,0.3
441659726,4,5,4.0,9,0.4444444444444444
441663151,6,4,4.0,10,0.4
441663233,11,16,11.0,27,0.4074074074074074
441673044,1,9,1.0,10,0.1
441684210,1,9,1.0,10,0.1
441737063,1,9,1.0,10,0.1
441749536,1,8,1.0,9,0.1111111111111111
441750568,1,9,1.0,10,0.1
441755210,1,9,1.0,10,0.1
441758294,8,1,1.0,9,0.1111111111111111
441761043,1,19,1.0,20,0.05
441807336,1,19,1.0,20,0.05
441809969,1,27,1.0,28,0.03571428571428571
441813551,5,3,3.0,8,0.375
441820538,3,6,3.0,9,0.3333333333333333
441849139,7,1,1.0,8,0.125
441849635,7,1,1.0,8,0.125
441851554,2,7,2.0,9,0.2222222222222222
441856532,2,6,2.0,8,0.25
441862264,2,8,2.0,10,0.2
441878985,1,19,1.0,20,0.05
441893735,9,1,1.0,10,0.1
441897182,3,16,3.0,19,0.15789473684210525
441919130,1,8,1.0,9,0.1111111111111111
441928505,1,8,1.0,9,0.1111111111111111
441935567,5,5,5.0,10,0.5
441945861,1,9,1.0,10,0.1
441960226,4,4,4.0,8,0.5
441966074,1,9,1.0,10,0.1
441967338,2,8,2.0,10,0.2
441968082,6,21,6.0,27,0.2222222222222222
441970234,7,2,2.0,9,0.2222222222222222
441970402,7,3,3.0,10,0.3
441970959,2,8,2.0,10,0.2
441979851,1,8,1.0,9,0.1111111111111111
441995655,1,18,1.0,19,0.05263157894736842
442060338,1,19,1.0,20,0.05
442068321,8,1,1.0,9,0.1111111111111111
442108703,4,12,4.0,16,0.25
442129505,1,9,1.0,10,0.1
442148698,6,4,4.0,10,0.4
442168150,1,7,1.0,8,0.125
442169344,2,8,2.0,10,0.2
442210395,1,9,1.0,10,0.1
442267952,2,7,2.0,9,0.2222222222222222
442315740,8,1,1.0,9,0.1111111111111111
442369849,3,7,3.0,10,0.3
442378857,1,9,1.0,10,0.1
442406333,1,9,1.0,10,0.1
442408779,4,14,4.0,18,0.2222222222222222
442412892,1,7,1.0,8,0.125
442415658,1,18,1.0,19,0.05263157894736842
442439418,10,9,9.0,19,0.47368421052631576
442503591,2,8,2.0,10,0.2
442524348,1,8,1.0,9,0.1111111111111111
442524949,1,8,1.0,9,0.1111111111111111
442551636,1,18,1.0,19,0.05263157894736842
442599447,6,2,2.0,8,0.25
442607982,2,16,2.0,18,0.1111111111111111
442616584,4,5,4.0,9,0.4444444444444444
442627185,1,8,1.0,9,0.1111111111111111
442627322,17,12,12.0,29,0.41379310344827586
442634879,1,18,1.0,19,0.05263157894736842
442649053,7,2,2.0,9,0.2222222222222222
442649395,6,3,3.0,9,0.3333333333333333
442649730,5,5,5.0,10,0.5
442649962,3,6,3.0,9,0.3333333333333333
442673703,3,16,3.0,19,0.15789473684210525
442680122,1,9,1.0,10,0.1
442712871,2,8,2.0,10,0.2
442724909,24,4,4.0,28,0.14285714285714285
442725299,3,7,3.0,10,0.3
442764370,8,2,2.0,10,0.2
442772854,5,5,5.0,10,0.5
442801904,2,17,2.0,19,0.10526315789473684
442802110,4,4,4.0,8,0.5
442802811,4,5,4.0,9,0.4444444444444444
442858313,3,7,3.0,10,0.3
442870745,9,11,9.0,20,0.45
442894196,1,9,1.0,10,0.1
442905982,1,7,1.0,8,0.125
442928994,14,14,14.0,28,0.5
442929380,2,7,2.0,9,0.2222222222222222
442936542,3,7,3.0,10,0.3
442955721,15,13,13.0,28,0.4642857142857143
443072547,2,8,2.0,10,0.2
443093203,8,1,1.0,9,0.1111111111111111
443132200,7,1,1.0,8,0.125
443135669,1,9,1.0,10,0.1
443135967,1,7,1.0,8,0.125
443138712,2,7,2.0,9,0.2222222222222222
443222808,5,3,3.0,8,0.375
443231999,22,6,6.0,28,0.21428571428571427
443237698,5,5,5.0,10,0.5
443243016,1,7,1.0,8,0.125
443288206,1,9,1.0,10,0.1
443289037,1,9,1.0,10,0.1
443290666,1,8,1.0,9,0.1111111111111111
443307861,25,2,2.0,27,0.07407407407407407
443308106,8,2,2.0,10,0.2
443308515,9,1,1.0,10,0.1
443315533,2,16,2.0,18,0.1111111111111111
443315805,6,4,4.0,10,0.4
443369833,13,16,13.0,29,0.4482758620689655
443419932,1,8,1.0,9,0.1111111111111111
443436567,2,7,2.0,9,0.2222222222222222
443437717,5,4,4.0,9,0.4444444444444444
443438576,4,6,4.0,10,0.4
443484889,23,7,7.0,30,0.23333333333333334
443484941,9,1,1.0,10,0.1
443485464,3,7,3.0,10,0.3
443495488,1,17,1.0,18,0.05555555555555555
443512168,1,9,1.0,10,0.1
443518084,6,23,6.0,29,0.20689655172413793
443592359,1,9,1.0,10,0.1
443685032,2,7,2.0,9,0.2222222222222222
443754940,6,3,3.0,9,0.3333333333333333
443769561,2,7,2.0,9,0.2222222222222222
443841675,2,7,2.0,9,0.2222222222222222
443842341,3,5,3.0,8,0.375
443843009,19,5,5.0,24,0.20833333333333334
443857487,3,16,3.0,19,0.15789473684210525
443858536,2,16,2.0,18,0.1111111111111111
443870740,4,5,4.0,9,0.4444444444444444
443871479,6,4,4.0,10,0.4
443872476,1,9,1.0,10,0.1
443880133,2,8,2.0,10,0.2
443880579,6,22,6.0,28,0.21428571428571427
443880906,16,4,4.0,20,0.2
443893420,1,9,1.0,10,0.1
443897669,2,8,2.0,10,0.2
443982704,4,6,4.0,10,0.4
443984399,1,8,1.0,9,0.1111111111111111
444003838,3,7,3.0,10,0.3
444006210,6,4,4.0,10,0.4
444006690,2,8,2.0,10,0.2
444020555,6,2,2.0,8,0.25
444021150,2,8,2.0,10,0.2
444021504,1,9,1.0,10,0.1
444021575,7,3,3.0,10,0.3
444021816,2,7,2.0,9,0.2222222222222222
444038426,3,7,3.0,10,0.3
444039357,2,8,2.0,10,0.2
444040905,3,7,3.0,10,0.3
444063497,1,9,1.0,10,0.1
444064464,2,7,2.0,9,0.2222222222222222
444104477,1,7,1.0,8,0.125
444129261,6,3,3.0,9,0.3333333333333333
444180363,10,10,10.0,20,0.5
444180421,2,17,2.0,19,0.10526315789473684
444214194,1,8,1.0,9,0.1111111111111111
444247480,8,2,2.0,10,0.2
444262400,1,8,1.0,9,0.1111111111111111
444262870,1,27,1.0,28,0.03571428571428571
444268589,5,4,4.0,9,0.4444444444444444
444284585,2,6,2.0,8,0.25
444285456,6,4,4.0,10,0.4
444320209,6,3,3.0,9,0.3333333333333333
444367636,5,5,5.0,10,0.5
444396931,2,6,2.0,8,0.25
444412364,1,9,1.0,10,0.1
444429621,3,7,3.0,10,0.3
444432335,2,8,2.0,10,0.2
444472189,7,3,3.0,10,0.3
444474950,1,8,1.0,9,0.1111111111111111
444550470,6,4,4.0,10,0.4
444559329,3,7,3.0,10,0.3
444588550,9,1,1.0,10,0.1
444588772,7,1,1.0,8,0.125
444627926,1,9,1.0,10,0.1
444649076,3,6,3.0,9,0.3333333333333333
444656096,1,8,1.0,9,0.1111111111111111
444735952,2,8,2.0,10,0.2
444781741,1,16,1.0,17,0.058823529411764705
444798145,2,7,2.0,9,0.2222222222222222
444814311,3,7,3.0,10,0.3
444826564,8,22,8.0,30,0.26666666666666666
444841170,9,1,1.0,10,0.1
444865807,2,8,2.0,10,0.2
444893412,1,19,1.0,20,0.05
444929940,2,16,2.0,18,0.1111111111111111
444999069,1,16,1.0,17,0.058823529411764705
445045953,1,8,1.0,9,0.1111111111111111
445089218,2,15,2.0,17,0.11764705882352941
445106063,8,2,2.0,10,0.2
445125806,3,7,3.0,10,0.3
445169947,1,9,1.0,10,0.1
445170883,1,9,1.0,10,0.1
445198335,1,8,1.0,9,0.1111111111111111
445203696,1,18,1.0,19,0.05263157894736842
445219917,2,8,2.0,10,0.2
445223733,4,6,4.0,10,0.4
445225443,10,9,9.0,19,0.47368421052631576
445227879,1,19,1.0,20,0.05
445351151,2,6,2.0,8,0.25
445394351,1,8,1.0,9,0.1111111111111111
445395303,1,9,1.0,10,0.1
445395879,1,8,1.0,9,0.1111111111111111
445412091,7,3,3.0,10,0.3
445412736,8,1,1.0,9,0.1111111111111111
445478357,3,24,3.0,27,0.1111111111111111
445516569,3,6,3.0,9,0.3333333333333333
445561442,1,9,1.0,10,0.1
445588363,1,9,1.0,10,0.1
445591525,2,6,2.0,8,0.25
445617901,8,2,2.0,10,0.2
445680824,3,7,3.0,10,0.3
445683863,1,9,1.0,10,0.1
445763845,2,17,2.0,19,0.10526315789473684
445798731,1,16,1.0,17,0.058823529411764705
445814193,1,28,1.0,29,0.034482758620689655
445815044,8,2,2.0,10,0.2
445860491,1,8,1.0,9,0.1111111111111111
445871156,1,9,1.0,10,0.1
445895120,3,7,3.0,10,0.3
445960880,1,17,1.0,18,0.05555555555555555
445976684,1,19,1.0,20,0.05
446037924,2,8,2.0,10,0.2
446094841,8,2,2.0,10,0.2
446134557,1,17,1.0,18,0.05555555555555555
446150733,1,9,1.0,10,0.1
446200378,8,1,1.0,9,0.1111111111111111
446228446,1,8,1.0,9,0.1111111111111111
446244892,8,2,2.0,10,0.2
446265078,2,17,2.0,19,0.10526315789473684
446271004,2,7,2.0,9,0.2222222222222222
446285425,1,7,1.0,8,0.125
446305354,2,8,2.0,10,0.2
446319672,1,9,1.0,10,0.1
446321101,1,8,1.0,9,0.1111111111111111
446395079,1,8,1.0,9,0.1111111111111111
446427503,5,15,5.0,20,0.25
446442199,1,18,1.0,19,0.05263157894736842
446456312,2,17,2.0,19,0.10526315789473684
446457720,9,19,9.0,28,0.32142857142857145
446464191,1,9,1.0,10,0.1
446466496,4,6,4.0,10,0.4
446467411,3,7,3.0,10,0.3
446516422,1,8,1.0,9,0.1111111111111111
446538901,1,8,1.0,9,0.1111111111111111
446556795,4,5,4.0,9,0.4444444444444444
446558797,2,8,2.0,10,0.2
446559397,1,8,1.0,9,0.1111111111111111
446561007,4,6,4.0,10,0.4
446565389,2,8,2.0,10,0.2
446591531,9,1,1.0,10,0.1
446591558,8,2,2.0,10,0.2
446646752,9,1,1.0,10,0.1
446647583,7,3,3.0,10,0.3
446708574,4,6,4.0,10,0.4
446714511,1,9,1.0,10,0.1
446719403,3,7,3.0,10,0.3
446727108,2,7,2.0,9,0.2222222222222222
446750633,1,8,1.0,9,0.1111111111111111
446750780,1,9,1.0,10,0.1
446751636,1,9,1.0,10,0.1
446801047,23,6,6.0,29,0.20689655172413793
446802811,2,8,2.0,10,0.2
446820568,1,16,1.0,17,0.058823529411764705
446831221,1,16,1.0,17,0.058823529411764705
446849040,1,7,1.0,8,0.125
446852647,2,7,2.0,9,0.2222222222222222
446854005,3,7,3.0,10,0.3
446900390,1,8,1.0,9,0.1111111111111111
446904739,1,7,1.0,8,0.125
446941591,1,8,1.0,9,0.1111111111111111
446945651,1,7,1.0,8,0.125
446962344,3,6,3.0,9,0.3333333333333333
446966781,1,9,1.0,10,0.1
446971621,11,17,11.0,28,0.39285714285714285
446972507,2,8,2.0,10,0.2
446973342,3,7,3.0,10,0.3
446974991,1,8,1.0,9,0.1111111111111111
446975632,2,8,2.0,10,0.2
446991213,1,18,1.0,19,0.05263157894736842
446999643,1,8,1.0,9,0.1111111111111111
447001974,23,7,7.0,30,0.23333333333333334
447115705,2,8,2.0,10,0.2
447117596,1,9,1.0,10,0.1
447118912,2,8,2.0,10,0.2
447136770,1,7,1.0,8,0.125
447165023,7,2,2.0,9,0.2222222222222222
447166549,5,4,4.0,9,0.4444444444444444
447170307,1,9,1.0,10,0.1
447220340,5,3,3.0,8,0.375
447233813,2,18,2.0,20,0.1
447316567,1,15,1.0,16,0.0625
447393275,7,3,3.0,10,0.3
447403046,9,1,1.0,10,0.1
447434619,1,8,1.0,9,0.1111111111111111
447436379,8,2,2.0,10,0.2
447480554,1,9,1.0,10,0.1
447510963,8,2,2.0,10,0.2
447535853,2,8,2.0,10,0.2
447538120,2,7,2.0,9,0.2222222222222222
447538267,8,21,8.0,29,0.27586206896551724
447539177,3,7,3.0,10,0.3
447589775,1,9,1.0,10,0.1
447626592,1,19,1.0,20,0.05
447672830,3,7,3.0,10,0.3
447677679,1,8,1.0,9,0.1111111111111111
447680143,6,4,4.0,10,0.4
447681174,1,18,1.0,19,0.05263157894736842
447682475,1,9,1.0,10,0.1
447699287,2,24,2.0,26,0.07692307692307693
447707062,5,13,5.0,18,0.2777777777777778
447856317,5,4,4.0,9,0.4444444444444444
447861308,5,5,5.0,10,0.5
447861518,8,2,2.0,10,0.2
447877502,1,8,1.0,9,0.1111111111111111
447889530,19,10,10.0,29,0.3448275862068966
447914624,2,8,2.0,10,0.2
447916377,3,7,3.0,10,0.3
447929441,3,7,3.0,10,0.3
447960357,1,17,1.0,18,0.05555555555555555
447988238,1,8,1.0,9,0.1111111111111111
447989347,1,8,1.0,9,0.1111111111111111
447990352,1,9,1.0,10,0.1
448007336,1,18,1.0,19,0.05263157894736842
448072785,1,17,1.0,18,0.05555555555555555
448087044,3,6,3.0,9,0.3333333333333333
448096950,1,9,1.0,10,0.1
448148590,1,9,1.0,10,0.1
448177004,10,18,10.0,28,0.35714285714285715
448211731,1,18,1.0,19,0.05263157894736842
448220185,1,19,1.0,20,0.05
448254769,1,9,1.0,10,0.1
448255329,1,7,1.0,8,0.125
448261057,1,9,1.0,10,0.1
448303712,3,6,3.0,9,0.3333333333333333
448303969,6,3,3.0,9,0.3333333333333333
448304082,7,1,1.0,8,0.125
448351260,1,9,1.0,10,0.1
448401209,1,9,1.0,10,0.1
448401816,1,7,1.0,8,0.125
448424001,6,4,4.0,10,0.4
448429866,3,6,3.0,9,0.3333333333333333
448474675,1,8,1.0,9,0.1111111111111111
448485766,2,25,2.0,27,0.07407407407407407
448486108,4,5,4.0,9,0.4444444444444444
448487650,2,8,2.0,10,0.2
448487899,2,8,2.0,10,0.2
448585414,2,18,2.0,20,0.1
448588023,4,6,4.0,10,0.4
448588944,25,3,3.0,28,0.10714285714285714
448607764,1,9,1.0,10,0.1
448608313,1,8,1.0,9,0.1111111111111111
448618911,2,8,2.0,10,0.2
448629721,4,6,4.0,10,0.4
448663738,3,7,3.0,10,0.3
448663759,9,20,9.0,29,0.3103448275862069
448673994,1,9,1.0,10,0.1
448706743,9,10,9.0,19,0.47368421052631576
448708188,2,7,2.0,9,0.2222222222222222
448716199,1,9,1.0,10,0.1
448716995,3,7,3.0,10,0.3
448717070,1,7,1.0,8,0.125
448737474,12,14,12.0,26,0.46153846153846156
448739791,3,6,3.0,9,0.3333333333333333
448741408,12,18,12.0,30,0.4
448751863,2,8,2.0,10,0.2
448793185,1,9,1.0,10,0.1
448799949,3,5,3.0,8,0.375
448908226,1,9,1.0,10,0.1
448910718,1,9,1.0,10,0.1
448952120,1,8,1.0,9,0.1111111111111111
448982719,9,18,9.0,27,0.3333333333333333
448992542,9,1,1.0,10,0.1
449012097,3,7,3.0,10,0.3
449046342,3,7,3.0,10,0.3
449118379,1,9,1.0,10,0.1
449148023,5,5,5.0,10,0.5
449152128,1,8,1.0,9,0.1111111111111111
449257929,4,5,4.0,9,0.4444444444444444
449269770,1,9,1.0,10,0.1
449269784,1,17,1.0,18,0.05555555555555555
449279026,2,8,2.0,10,0.2
449303426,1,18,1.0,19,0.05263157894736842
449345407,1,8,1.0,9,0.1111111111111111
449345703,5,5,5.0,10,0.5
449361286,1,18,1.0,19,0.05263157894736842
449407985,9,1,1.0,10,0.1
449418322,8,2,2.0,10,0.2
449432221,3,22,3.0,25,0.12
449530229,9,1,1.0,10,0.1
449670458,6,3,3.0,9,0.3333333333333333
449683796,5,4,4.0,9,0.4444444444444444
449760444,6,3,3.0,9,0.3333333333333333
449802175,1,9,1.0,10,0.1
449853182,1,9,1.0,10,0.1
449862019,1,17,1.0,18,0.05555555555555555
449882743,5,4,4.0,9,0.4444444444444444
450007836,1,9,1.0,10,0.1
450015300,1,27,1.0,28,0.03571428571428571
450065772,1,18,1.0,19,0.05263157894736842
450072651,3,7,3.0,10,0.3
450122656,4,6,4.0,10,0.4
450137033,5,14,5.0,19,0.2631578947368421
450144231,2,17,2.0,19,0.10526315789473684
450275172,1,7,1.0,8,0.125
450318326,1,7,1.0,8,0.125
450318630,2,15,2.0,17,0.11764705882352941
450346866,2,8,2.0,10,0.2
450354818,3,6,3.0,9,0.3333333333333333
450356402,1,19,1.0,20,0.05
450415315,1,9,1.0,10,0.1
450415637,2,7,2.0,9,0.2222222222222222
450415951,3,7,3.0,10,0.3
450418073,5,4,4.0,9,0.4444444444444444
450418825,3,6,3.0,9,0.3333333333333333
450458827,2,17,2.0,19,0.10526315789473684
450468892,10,19,10.0,29,0.3448275862068966
450474499,1,19,1.0,20,0.05
450637978,3,7,3.0,10,0.3
450698393,1,19,1.0,20,0.05
450720958,1,9,1.0,10,0.1
450741338,1,19,1.0,20,0.05
450741829,1,18,1.0,19,0.05263157894736842
450752218,1,9,1.0,10,0.1
450763159,1,19,1.0,20,0.05
450861056,3,17,3.0,20,0.15
450872298,1,7,1.0,8,0.125
450873199,1,9,1.0,10,0.1
450875272,2,8,2.0,10,0.2
450876069,4,6,4.0,10,0.4
450904944,12,7,7.0,19,0.3684210526315789
450932921,3,7,3.0,10,0.3
450949302,2,8,2.0,10,0.2
450951531,1,8,1.0,9,0.1111111111111111
450979069,2,7,2.0,9,0.2222222222222222
451001414,1,8,1.0,9,0.1111111111111111
451011632,2,8,2.0,10,0.2
451015248,2,7,2.0,9,0.2222222222222222
451019005,2,8,2.0,10,0.2
451101446,1,8,1.0,9,0.1111111111111111
451102958,1,9,1.0,10,0.1
451121898,2,6,2.0,8,0.25
451123349,1,9,1.0,10,0.1
451127940,3,7,3.0,10,0.3
451130507,1,9,1.0,10,0.1
451131045,4,16,4.0,20,0.2
451134835,1,19,1.0,20,0.05
451135690,1,9,1.0,10,0.1
451137997,2,7,2.0,9,0.2222222222222222
451141116,3,6,3.0,9,0.3333333333333333
451142282,2,8,2.0,10,0.2
451142790,2,8,2.0,10,0.2
451144304,1,8,1.0,9,0.1111111111111111
451144430,3,7,3.0,10,0.3
451144545,2,7,2.0,9,0.2222222222222222
451145436,3,6,3.0,9,0.3333333333333333
451147823,3,6,3.0,9,0.3333333333333333
451153866,2,8,2.0,10,0.2
451154233,1,9,1.0,10,0.1
451156047,7,3,3.0,10,0.3
451189519,1,9,1.0,10,0.1
451197666,1,9,1.0,10,0.1
451242573,5,4,4.0,9,0.4444444444444444
451272050,9,1,1.0,10,0.1
451272533,1,7,1.0,8,0.125
451272775,11,17,11.0,28,0.39285714285714285
451279761,1,18,1.0,19,0.05263157894736842
451317520,2,16,2.0,18,0.1111111111111111
451322193,1,9,1.0,10,0.1
451331738,1,9,1.0,10,0.1
451334656,3,15,3.0,18,0.16666666666666666
451352321,1,9,1.0,10,0.1
451352831,1,9,1.0,10,0.1
451364814,3,6,3.0,9,0.3333333333333333
451365327,26,3,3.0,29,0.10344827586206896
451372973,3,5,3.0,8,0.375
451379176,1,9,1.0,10,0.1
451388968,4,4,4.0,8,0.5
451475220,3,16,3.0,19,0.15789473684210525
451478393,1,9,1.0,10,0.1
451582701,1,19,1.0,20,0.05
451592104,3,6,3.0,9,0.3333333333333333
451618243,1,9,1.0,10,0.1
451623999,23,5,5.0,28,0.17857142857142858
451630792,9,10,9.0,19,0.47368421052631576
451646380,6,3,3.0,9,0.3333333333333333
451685070,3,7,3.0,10,0.3
451696458,1,8,1.0,9,0.1111111111111111
451722087,1,9,1.0,10,0.1
451723023,5,5,5.0,10,0.5
451731520,7,1,1.0,8,0.125
451739199,4,5,4.0,9,0.4444444444444444
451780534,1,9,1.0,10,0.1
451789113,2,8,2.0,10,0.2
451796400,1,19,1.0,20,0.05
451838225,1,9,1.0,10,0.1
451887172,1,19,1.0,20,0.05
451931965,9,1,1.0,10,0.1
451934653,2,18,2.0,20,0.1
451936587,7,3,3.0,10,0.3
451937395,4,6,4.0,10,0.4
452002487,1,9,1.0,10,0.1
452015878,9,1,1.0,10,0.1
452024632,1,8,1.0,9,0.1111111111111111
452043401,4,5,4.0,9,0.4444444444444444
452043621,1,9,1.0,10,0.1
452054512,6,4,4.0,10,0.4
452055172,3,7,3.0,10,0.3
452084329,1,9,1.0,10,0.1
452110700,2,18,2.0,20,0.1
452111081,2,8,2.0,10,0.2
452131467,9,1,1.0,10,0.1
452158312,1,9,1.0,10,0.1
452161954,2,8,2.0,10,0.2
452224169,1,8,1.0,9,0.1111111111111111
452229184,8,1,1.0,9,0.1111111111111111
452262296,5,21,5.0,26,0.19230769230769232
452262376,7,2,2.0,9,0.2222222222222222
452262814,4,6,4.0,10,0.4
452263555,5,15,5.0,20,0.25
452264200,1,17,1.0,18,0.05555555555555555
452281355,1,19,1.0,20,0.05
452288065,4,16,4.0,20,0.2
452290377,2,8,2.0,10,0.2
452293379,8,2,2.0,10,0.2
452306908,5,5,5.0,10,0.5
452322829,1,19,1.0,20,0.05
452352163,18,2,2.0,20,0.1
452367167,2,8,2.0,10,0.2
452372165,3,6,3.0,9,0.3333333333333333
452372414,6,3,3.0,9,0.3333333333333333
452372678,1,9,1.0,10,0.1
452374606,1,8,1.0,9,0.1111111111111111
452374808,5,5,5.0,10,0.5
452378784,5,4,4.0,9,0.4444444444444444
452381917,2,6,2.0,8,0.25
452390823,2,7,2.0,9,0.2222222222222222
452400097,2,15,2.0,17,0.11764705882352941
452402983,2,7,2.0,9,0.2222222222222222
452439882,4,6,4.0,10,0.4
452461222,2,6,2.0,8,0.25
452473527,4,5,4.0,9,0.4444444444444444
452473656,2,8,2.0,10,0.2
452534811,2,27,2.0,29,0.06896551724137931
452572403,3,7,3.0,10,0.3
452624782,2,8,2.0,10,0.2
452626231,2,8,2.0,10,0.2
452626561,5,3,3.0,8,0.375
452662604,2,18,2.0,20,0.1
452674569,1,18,1.0,19,0.05263157894736842
452681048,1,17,1.0,18,0.05555555555555555
452708093,1,8,1.0,9,0.1111111111111111
452741569,1,9,1.0,10,0.1
452774771,2,8,2.0,10,0.2
452776493,1,9,1.0,10,0.1
452786871,1,9,1.0,10,0.1
452804214,5,5,5.0,10,0.5
452804341,1,8,1.0,9,0.1111111111111111
452804590,5,5,5.0,10,0.5
452839304,1,8,1.0,9,0.1111111111111111
452881777,1,8,1.0,9,0.1111111111111111
452885380,1,9,1.0,10,0.1
452910764,2,7,2.0,9,0.2222222222222222
452913731,14,15,14.0,29,0.4827586206896552
452914459,3,7,3.0,10,0.3
452926013,17,12,12.0,29,0.41379310344827586
452940325,1,7,1.0,8,0.125
452941326,8,2,2.0,10,0.2
452955411,1,17,1.0,18,0.05555555555555555
452977139,18,2,2.0,20,0.1
453054404,14,12,12.0,26,0.46153846153846156
453068674,2,8,2.0,10,0.2
453082178,1,8,1.0,9,0.1111111111111111
453102445,4,6,4.0,10,0.4
453128790,2,7,2.0,9,0.2222222222222222
453136943,3,5,3.0,8,0.375
453137058,2,8,2.0,10,0.2
453148541,1,9,1.0,10,0.1
453148848,4,6,4.0,10,0.4
453148938,1,8,1.0,9,0.1111111111111111
453149365,2,8,2.0,10,0.2
453182863,6,4,4.0,10,0.4
453237670,24,4,4.0,28,0.14285714285714285
453250408,2,8,2.0,10,0.2
453282966,1,7,1.0,8,0.125
453288842,6,4,4.0,10,0.4
453301459,9,1,1.0,10,0.1
453302145,7,2,2.0,9,0.2222222222222222
453306505,1,9,1.0,10,0.1
453307180,4,6,4.0,10,0.4
453386039,1,9,1.0,10,0.1
453397655,1,17,1.0,18,0.05555555555555555
453415149,1,8,1.0,9,0.1111111111111111
453440316,2,7,2.0,9,0.2222222222222222
453459554,4,5,4.0,9,0.4444444444444444
453468084,1,9,1.0,10,0.1
453475536,2,8,2.0,10,0.2
453490509,2,7,2.0,9,0.2222222222222222
453492640,1,8,1.0,9,0.1111111111111111
453493150,2,8,2.0,10,0.2
453493249,1,9,1.0,10,0.1
453494389,1,8,1.0,9,0.1111111111111111
453496339,8,1,1.0,9,0.1111111111111111
453502488,1,8,1.0,9,0.1111111111111111
453505355,1,9,1.0,10,0.1
453530713,4,6,4.0,10,0.4
453548371,3,6,3.0,9,0.3333333333333333
453552451,1,9,1.0,10,0.1
453565507,4,6,4.0,10,0.4
453596990,1,8,1.0,9,0.1111111111111111
453601334,7,12,7.0,19,0.3684210526315789
453605446,1,9,1.0,10,0.1
453612645,25,4,4.0,29,0.13793103448275862
453636109,7,1,1.0,8,0.125
453640965,1,18,1.0,19,0.05263157894736842
453705462,2,8,2.0,10,0.2
453759059,1,9,1.0,10,0.1
453797445,2,8,2.0,10,0.2
453801156,2,8,2.0,10,0.2
453812856,1,9,1.0,10,0.1
453857509,1,9,1.0,10,0.1
453861677,1,9,1.0,10,0.1
453862880,4,5,4.0,9,0.4444444444444444
453866057,3,7,3.0,10,0.3
453895759,1,9,1.0,10,0.1
453911773,2,7,2.0,9,0.2222222222222222
453935778,1,9,1.0,10,0.1
453971798,2,8,2.0,10,0.2
453997537,5,5,5.0,10,0.5
454020945,4,5,4.0,9,0.4444444444444444
454022461,6,3,3.0,9,0.3333333333333333
454039592,1,24,1.0,25,0.04
454050409,4,5,4.0,9,0.4444444444444444
454097770,2,8,2.0,10,0.2
454122413,1,18,1.0,19,0.05263157894736842
454129833,3,7,3.0,10,0.3
454141482,3,5,3.0,8,0.375
454142827,1,8,1.0,9,0.1111111111111111
454143720,1,9,1.0,10,0.1
454144793,9,1,1.0,10,0.1
454146092,6,4,4.0,10,0.4
454149196,1,9,1.0,10,0.1
454267328,1,9,1.0,10,0.1
454277116,6,3,3.0,9,0.3333333333333333
454315579,4,6,4.0,10,0.4
454315760,3,7,3.0,10,0.3
454318205,4,6,4.0,10,0.4
454333239,3,5,3.0,8,0.375
454344554,3,7,3.0,10,0.3
454348196,2,18,2.0,20,0.1
454348963,1,8,1.0,9,0.1111111111111111
454360935,2,8,2.0,10,0.2
454376129,5,5,5.0,10,0.5
454426080,8,2,2.0,10,0.2
454426673,1,7,1.0,8,0.125
454430965,2,8,2.0,10,0.2
454431338,1,9,1.0,10,0.1
454433088,1,9,1.0,10,0.1
454433256,1,8,1.0,9,0.1111111111111111
454462227,7,3,3.0,10,0.3
454464390,3,7,3.0,10,0.3
454464461,1,9,1.0,10,0.1
454464828,6,4,4.0,10,0.4
454472125,2,8,2.0,10,0.2
454548413,2,8,2.0,10,0.2
454549598,1,9,1.0,10,0.1
454553193,2,8,2.0,10,0.2
454554517,2,8,2.0,10,0.2
454555102,7,3,3.0,10,0.3
454555659,1,8,1.0,9,0.1111111111111111
454594546,3,6,3.0,9,0.3333333333333333
454607865,2,15,2.0,17,0.11764705882352941
454635171,1,9,1.0,10,0.1
454635298,9,19,9.0,28,0.32142857142857145
454646262,1,9,1.0,10,0.1
454646395,3,7,3.0,10,0.3
454650829,2,8,2.0,10,0.2
454654301,3,6,3.0,9,0.3333333333333333
454663156,4,5,4.0,9,0.4444444444444444
454666239,2,8,2.0,10,0.2
454708404,2,8,2.0,10,0.2
454708769,7,3,3.0,10,0.3
454710262,3,7,3.0,10,0.3
454741454,1,9,1.0,10,0.1
454753892,6,13,6.0,19,0.3157894736842105
454758035,5,5,5.0,10,0.5
454771884,2,8,2.0,10,0.2
454777562,2,8,2.0,10,0.2
454786757,9,1,1.0,10,0.1
454791310,6,4,4.0,10,0.4
454796383,2,8,2.0,10,0.2
454798020,5,5,5.0,10,0.5
454798674,1,28,1.0,29,0.034482758620689655
454801332,1,8,1.0,9,0.1111111111111111
454806767,2,8,2.0,10,0.2
454810375,1,9,1.0,10,0.1
454811425,3,7,3.0,10,0.3
454838949,3,7,3.0,10,0.3
454839528,1,9,1.0,10,0.1
454845468,3,7,3.0,10,0.3
454845713,3,7,3.0,10,0.3
454846614,1,8,1.0,9,0.1111111111111111
454847194,5,4,4.0,9,0.4444444444444444
454847318,5,4,4.0,9,0.4444444444444444
454850259,2,7,2.0,9,0.2222222222222222
454850863,5,4,4.0,9,0.4444444444444444
454850971,2,8,2.0,10,0.2
454855256,3,6,3.0,9,0.3333333333333333
454857424,1,9,1.0,10,0.1
454868888,2,8,2.0,10,0.2
454869763,3,7,3.0,10,0.3
454913738,1,9,1.0,10,0.1
454936463,1,19,1.0,20,0.05
454942372,1,19,1.0,20,0.05
454958028,6,4,4.0,10,0.4
454990842,6,4,4.0,10,0.4
455002537,1,9,1.0,10,0.1
455002613,1,9,1.0,10,0.1
455002669,5,4,4.0,9,0.4444444444444444
455004413,2,8,2.0,10,0.2
455024577,1,9,1.0,10,0.1
455034508,3,26,3.0,29,0.10344827586206896
455036283,7,3,3.0,10,0.3
455036568,2,7,2.0,9,0.2222222222222222
455037747,7,20,7.0,27,0.25925925925925924
455038831,2,8,2.0,10,0.2
455055089,8,1,1.0,9,0.1111111111111111
455055220,1,9,1.0,10,0.1
455055747,17,11,11.0,28,0.39285714285714285
455069948,7,1,1.0,8,0.125
455070882,5,22,5.0,27,0.18518518518518517
455077266,1,18,1.0,19,0.05263157894736842
455144692,9,1,1.0,10,0.1
455155867,2,8,2.0,10,0.2
455165028,2,8,2.0,10,0.2
455175761,1,8,1.0,9,0.1111111111111111
455176431,1,17,1.0,18,0.05555555555555555
455186895,1,7,1.0,8,0.125
455211144,1,9,1.0,10,0.1
455232002,1,8,1.0,9,0.1111111111111111
455276234,2,22,2.0,24,0.08333333333333333
455282726,7,2,2.0,9,0.2222222222222222
455285659,8,2,2.0,10,0.2
455288157,5,5,5.0,10,0.5
455333636,6,3,3.0,9,0.3333333333333333
455376695,1,8,1.0,9,0.1111111111111111
455382585,1,7,1.0,8,0.125
455447676,2,7,2.0,9,0.2222222222222222
455449725,1,26,1.0,27,0.037037037037037035
455487868,1,9,1.0,10,0.1
455558682,5,3,3.0,8,0.375
455563529,1,9,1.0,10,0.1
455579326,8,1,1.0,9,0.1111111111111111
455605289,9,1,1.0,10,0.1
455605826,3,7,3.0,10,0.3
455625158,1,8,1.0,9,0.1111111111111111
455635048,1,9,1.0,10,0.1
455714046,6,4,4.0,10,0.4
455739922,2,18,2.0,20,0.1
455762368,1,9,1.0,10,0.1
455766275,8,21,8.0,29,0.27586206896551724
455767799,1,9,1.0,10,0.1
455771771,2,6,2.0,8,0.25
455776538,1,9,1.0,10,0.1
455776794,2,6,2.0,8,0.25
455778277,2,8,2.0,10,0.2
455790426,7,3,3.0,10,0.3
455792266,4,6,4.0,10,0.4
455819166,2,16,2.0,18,0.1111111111111111
455819291,2,8,2.0,10,0.2
455819631,9,1,1.0,10,0.1
455820274,25,5,5.0,30,0.16666666666666666
455821047,1,9,1.0,10,0.1
455822973,7,3,3.0,10,0.3
455834785,1,9,1.0,10,0.1
455844572,4,5,4.0,9,0.4444444444444444
455844653,2,8,2.0,10,0.2
455844704,5,4,4.0,9,0.4444444444444444
455844803,6,4,4.0,10,0.4
455895107,1,9,1.0,10,0.1
455901500,2,8,2.0,10,0.2
455917609,2,18,2.0,20,0.1
455922811,1,9,1.0,10,0.1
455935317,2,17,2.0,19,0.10526315789473684
455944000,10,10,10.0,20,0.5
455985053,2,8,2.0,10,0.2
455985379,1,9,1.0,10,0.1
456010665,9,10,9.0,19,0.47368421052631576
456051185,3,6,3.0,9,0.3333333333333333
456081410,5,5,5.0,10,0.5
456085076,2,8,2.0,10,0.2
456103414,8,1,1.0,9,0.1111111111111111
456131401,1,17,1.0,18,0.05555555555555555
456205111,1,8,1.0,9,0.1111111111111111
456288571,1,18,1.0,19,0.05263157894736842
456299591,1,17,1.0,18,0.05555555555555555
456311556,1,9,1.0,10,0.1
456353865,6,22,6.0,28,0.21428571428571427
456354663,1,9,1.0,10,0.1
456388921,1,8,1.0,9,0.1111111111111111
456412436,1,9,1.0,10,0.1
456514769,4,6,4.0,10,0.4
456546630,1,7,1.0,8,0.125
456568065,1,19,1.0,20,0.05
456626331,1,19,1.0,20,0.05
456670217,3,6,3.0,9,0.3333333333333333
456673699,2,8,2.0,10,0.2
456675029,3,6,3.0,9,0.3333333333333333
456676001,4,6,4.0,10,0.4
456676078,7,3,3.0,10,0.3
456679264,2,7,2.0,9,0.2222222222222222
456682116,3,7,3.0,10,0.3
456682714,1,9,1.0,10,0.1
456693262,1,8,1.0,9,0.1111111111111111
456704249,1,9,1.0,10,0.1
456706735,3,7,3.0,10,0.3
456707625,1,7,1.0,8,0.125
456712908,4,5,4.0,9,0.4444444444444444
456716106,1,8,1.0,9,0.1111111111111111
456726607,1,9,1.0,10,0.1
456749433,1,9,1.0,10,0.1
456787262,7,22,7.0,29,0.2413793103448276
456810973,3,7,3.0,10,0.3
456811853,2,8,2.0,10,0.2
456812371,2,7,2.0,9,0.2222222222222222
456812514,2,8,2.0,10,0.2
456812738,2,8,2.0,10,0.2
456813149,2,8,2.0,10,0.2
456818060,2,8,2.0,10,0.2
456830803,1,8,1.0,9,0.1111111111111111
456842715,3,7,3.0,10,0.3
456843969,2,18,2.0,20,0.1
456844977,1,9,1.0,10,0.1
456847303,2,8,2.0,10,0.2
456847950,2,8,2.0,10,0.2
456857301,6,3,3.0,9,0.3333333333333333
456862629,1,9,1.0,10,0.1
456863539,1,8,1.0,9,0.1111111111111111
456864301,1,9,1.0,10,0.1
456868935,5,5,5.0,10,0.5
456870520,3,7,3.0,10,0.3
456895229,2,8,2.0,10,0.2
456896279,9,1,1.0,10,0.1
456896551,2,8,2.0,10,0.2
456898032,2,17,2.0,19,0.10526315789473684
456905375,8,2,2.0,10,0.2
456911901,7,3,3.0,10,0.3
456912037,1,9,1.0,10,0.1
456912218,3,6,3.0,9,0.3333333333333333
456912452,8,1,1.0,9,0.1111111111111111
456960360,1,8,1.0,9,0.1111111111111111
457010593,3,7,3.0,10,0.3
457052597,1,9,1.0,10,0.1
457069190,1,7,1.0,8,0.125
457070031,3,5,3.0,8,0.375
457070438,3,7,3.0,10,0.3
457070563,2,8,2.0,10,0.2
457083457,1,18,1.0,19,0.05263157894736842
457111511,4,6,4.0,10,0.4
457129964,2,8,2.0,10,0.2
457181297,1,9,1.0,10,0.1
457190299,3,7,3.0,10,0.3
457203556,1,9,1.0,10,0.1
457206087,6,4,4.0,10,0.4
457212832,3,7,3.0,10,0.3
457222036,3,6,3.0,9,0.3333333333333333
457223479,1,8,1.0,9,0.1111111111111111
457232703,12,8,8.0,20,0.4
457234111,1,8,1.0,9,0.1111111111111111
457256093,6,4,4.0,10,0.4
457256375,2,7,2.0,9,0.2222222222222222
457281807,1,17,1.0,18,0.05555555555555555
457282393,2,8,2.0,10,0.2
457283504,4,6,4.0,10,0.4
457284722,8,2,2.0,10,0.2
457286991,10,18,10.0,28,0.35714285714285715
457287404,3,27,3.0,30,0.1
457289734,2,8,2.0,10,0.2
457291346,15,13,13.0,28,0.4642857142857143
457326463,1,7,1.0,8,0.125
457417171,5,5,5.0,10,0.5
457417873,6,3,3.0,9,0.3333333333333333
457418800,1,9,1.0,10,0.1
457420776,2,8,2.0,10,0.2
457422516,2,8,2.0,10,0.2
457423276,1,8,1.0,9,0.1111111111111111
457428155,5,4,4.0,9,0.4444444444444444
457428669,1,9,1.0,10,0.1
457430601,4,4,4.0,8,0.5
457430969,1,9,1.0,10,0.1
457492208,1,9,1.0,10,0.1
457492771,1,9,1.0,10,0.1
457493022,1,9,1.0,10,0.1
457496075,2,8,2.0,10,0.2
457519163,1,9,1.0,10,0.1
457523083,1,27,1.0,28,0.03571428571428571
457526766,9,1,1.0,10,0.1
457531115,7,3,3.0,10,0.3
457534897,1,9,1.0,10,0.1
457641415,1,9,1.0,10,0.1
457644732,1,8,1.0,9,0.1111111111111111
457675592,1,9,1.0,10,0.1
457678441,7,13,7.0,20,0.35
457693816,25,4,4.0,29,0.13793103448275862
457716520,1,9,1.0,10,0.1
457802502,2,7,2.0,9,0.2222222222222222
457803445,3,7,3.0,10,0.3
457813460,1,8,1.0,9,0.1111111111111111
457917027,1,9,1.0,10,0.1
457925369,5,4,4.0,9,0.4444444444444444
457926987,1,8,1.0,9,0.1111111111111111
457952061,1,9,1.0,10,0.1
457971405,5,13,5.0,18,0.2777777777777778
458047373,7,3,3.0,10,0.3
458122453,5,5,5.0,10,0.5
458139713,3,7,3.0,10,0.3
458184908,2,8,2.0,10,0.2
458187084,4,23,4.0,27,0.14814814814814814
458189928,4,4,4.0,8,0.5
458193416,1,9,1.0,10,0.1
458211447,8,1,1.0,9,0.1111111111111111
458213755,4,6,4.0,10,0.4
458214180,21,7,7.0,28,0.25
458214468,23,6,6.0,29,0.20689655172413793
458215227,1,9,1.0,10,0.1
458222797,5,5,5.0,10,0.5
458235062,5,5,5.0,10,0.5
458239847,2,8,2.0,10,0.2
458263693,7,3,3.0,10,0.3
458268131,7,2,2.0,9,0.2222222222222222
458275244,1,9,1.0,10,0.1
458275921,2,18,2.0,20,0.1
458289233,1,9,1.0,10,0.1
458305143,2,8,2.0,10,0.2
458356282,3,7,3.0,10,0.3
458357306,2,7,2.0,9,0.2222222222222222
458435464,1,9,1.0,10,0.1
458450336,1,8,1.0,9,0.1111111111111111
458451216,2,7,2.0,9,0.2222222222222222
458508411,3,5,3.0,8,0.375
458542855,1,17,1.0,18,0.05555555555555555
458552098,6,2,2.0,8,0.25
458600565,1,18,1.0,19,0.05263157894736842
458625843,6,4,4.0,10,0.4
458634240,1,9,1.0,10,0.1
458639715,3,7,3.0,10,0.3
458640284,1,9,1.0,10,0.1
458642110,2,7,2.0,9,0.2222222222222222
458642423,12,16,12.0,28,0.42857142857142855
458644853,1,8,1.0,9,0.1111111111111111
458645195,3,7,3.0,10,0.3
458669081,5,5,5.0,10,0.5
458679425,1,9,1.0,10,0.1
458679944,3,6,3.0,9,0.3333333333333333
458682098,8,1,1.0,9,0.1111111111111111
458682375,7,3,3.0,10,0.3
458716883,3,7,3.0,10,0.3
458746635,1,18,1.0,19,0.05263157894736842
458823817,1,9,1.0,10,0.1
458839297,1,9,1.0,10,0.1
458970093,1,8,1.0,9,0.1111111111111111
458970702,2,7,2.0,9,0.2222222222222222
458971145,1,9,1.0,10,0.1
458984249,2,28,2.0,30,0.06666666666666667
458991579,1,19,1.0,20,0.05
459003763,1,9,1.0,10,0.1
459021490,1,9,1.0,10,0.1
459028402,1,19,1.0,20,0.05
459049021,9,1,1.0,10,0.1
459055296,9,1,1.0,10,0.1
459110992,1,7,1.0,8,0.125
459121238,2,8,2.0,10,0.2
459123869,3,7,3.0,10,0.3
459126151,5,5,5.0,10,0.5
459135614,1,9,1.0,10,0.1
459147638,1,28,1.0,29,0.034482758620689655
459150201,1,9,1.0,10,0.1
459151587,1,8,1.0,9,0.1111111111111111
459182692,1,9,1.0,10,0.1
459195252,1,9,1.0,10,0.1
459237182,4,4,4.0,8,0.5
459258468,7,1,1.0,8,0.125
459258597,8,2,2.0,10,0.2
459289858,3,6,3.0,9,0.3333333333333333
459291144,2,8,2.0,10,0.2
459305842,1,9,1.0,10,0.1
459346236,5,4,4.0,9,0.4444444444444444
459350494,2,8,2.0,10,0.2
459351108,3,7,3.0,10,0.3
459352036,2,17,2.0,19,0.10526315789473684
459359182,1,9,1.0,10,0.1
459361645,4,6,4.0,10,0.4
459365392,3,7,3.0,10,0.3
459367631,1,9,1.0,10,0.1
459371130,1,9,1.0,10,0.1
459378077,9,1,1.0,10,0.1
459378230,7,1,1.0,8,0.125
459378350,7,3,3.0,10,0.3
459378958,5,3,3.0,8,0.375
459379650,8,2,2.0,10,0.2
459390138,1,9,1.0,10,0.1
459401529,1,15,1.0,16,0.0625
459426564,2,8,2.0,10,0.2
459471735,3,7,3.0,10,0.3
459482308,3,7,3.0,10,0.3
459492052,3,7,3.0,10,0.3
459499483,1,9,1.0,10,0.1
459499929,7,3,3.0,10,0.3
459501270,3,5,3.0,8,0.375
459511911,18,10,10.0,28,0.35714285714285715
459520608,1,18,1.0,19,0.05263157894736842
459540927,1,9,1.0,10,0.1
459568634,1,8,1.0,9,0.1111111111111111
459570953,2,8,2.0,10,0.2
459632548,1,19,1.0,20,0.05
459647871,2,7,2.0,9,0.2222222222222222
459752399,2,8,2.0,10,0.2
459810020,9,1,1.0,10,0.1
459813199,5,5,5.0,10,0.5
459815801,4,6,4.0,10,0.4
459821625,1,9,1.0,10,0.1
459822561,1,8,1.0,9,0.1111111111111111
459830763,1,9,1.0,10,0.1
459862756,1,8,1.0,9,0.1111111111111111
459863096,1,9,1.0,10,0.1
459882626,8,2,2.0,10,0.2
459904682,6,4,4.0,10,0.4
459905368,1,7,1.0,8,0.125
459925017,1,18,1.0,19,0.05263157894736842
459937547,1,19,1.0,20,0.05
459971166,1,9,1.0,10,0.1
459972456,6,4,4.0,10,0.4
459973384,1,7,1.0,8,0.125
459975089,1,7,1.0,8,0.125
459981322,2,8,2.0,10,0.2
460101415,5,4,4.0,9,0.4444444444444444
460101791,3,7,3.0,10,0.3
460111071,1,9,1.0,10,0.1
460117064,2,8,2.0,10,0.2
460118043,4,6,4.0,10,0.4
460189633,2,8,2.0,10,0.2
460190069,4,6,4.0,10,0.4
460211520,1,8,1.0,9,0.1111111111111111
460212029,2,26,2.0,28,0.07142857142857142
460212346,11,17,11.0,28,0.39285714285714285
460252530,1,9,1.0,10,0.1
460279395,1,8,1.0,9,0.1111111111111111
460297537,1,8,1.0,9,0.1111111111111111
460316663,1,18,1.0,19,0.05263157894736842
460347748,2,17,2.0,19,0.10526315789473684
460455714,2,8,2.0,10,0.2
460465424,2,7,2.0,9,0.2222222222222222
460466007,1,9,1.0,10,0.1
460479057,1,9,1.0,10,0.1
460480347,3,6,3.0,9,0.3333333333333333
460485755,2,8,2.0,10,0.2
460501909,1,8,1.0,9,0.1111111111111111
460527400,4,6,4.0,10,0.4
460528684,1,17,1.0,18,0.05555555555555555
460546160,1,8,1.0,9,0.1111111111111111
460558722,2,7,2.0,9,0.2222222222222222
460559748,3,7,3.0,10,0.3
460559897,7,20,7.0,27,0.25925925925925924
460563270,6,3,3.0,9,0.3333333333333333
460563398,9,1,1.0,10,0.1
460563851,2,6,2.0,8,0.25
460563984,8,1,1.0,9,0.1111111111111111
460602983,1,7,1.0,8,0.125
460643552,10,8,8.0,18,0.4444444444444444
460646368,2,8,2.0,10,0.2
460655144,1,8,1.0,9,0.1111111111111111
460691128,1,7,1.0,8,0.125
460694573,2,17,2.0,19,0.10526315789473684
460699744,7,3,3.0,10,0.3
460701036,5,5,5.0,10,0.5
460711967,9,1,1.0,10,0.1
460725222,7,3,3.0,10,0.3
460725809,13,17,13.0,30,0.43333333333333335
460734708,7,3,3.0,10,0.3
460744960,2,8,2.0,10,0.2
460745338,1,8,1.0,9,0.1111111111111111
460746492,5,4,4.0,9,0.4444444444444444
460869503,2,7,2.0,9,0.2222222222222222
460871032,4,21,4.0,25,0.16
460947196,3,25,3.0,28,0.10714285714285714
460974753,2,8,2.0,10,0.2
460985080,1,9,1.0,10,0.1
461003924,1,9,1.0,10,0.1
461009928,7,20,7.0,27,0.25925925925925924
461010992,1,9,1.0,10,0.1
461052500,1,19,1.0,20,0.05
461068019,1,25,1.0,26,0.038461538461538464
461068239,2,8,2.0,10,0.2
461069023,1,9,1.0,10,0.1
461087777,1,9,1.0,10,0.1
461112038,1,9,1.0,10,0.1
461119297,1,9,1.0,10,0.1
461146417,2,8,2.0,10,0.2
461183090,2,8,2.0,10,0.2
461183839,1,9,1.0,10,0.1
461202755,1,8,1.0,9,0.1111111111111111
461204029,2,8,2.0,10,0.2
461205939,1,27,1.0,28,0.03571428571428571
461210837,1,9,1.0,10,0.1
461215595,1,18,1.0,19,0.05263157894736842
461225288,3,7,3.0,10,0.3
461237705,1,9,1.0,10,0.1
461245324,2,16,2.0,18,0.1111111111111111
461281946,1,19,1.0,20,0.05
461287379,1,9,1.0,10,0.1
461289286,3,17,3.0,20,0.15
461333741,3,7,3.0,10,0.3
461355126,2,7,2.0,9,0.2222222222222222
461361180,2,8,2.0,10,0.2
461416371,1,27,1.0,28,0.03571428571428571
461444684,2,18,2.0,20,0.1
461447545,1,8,1.0,9,0.1111111111111111
461452338,1,19,1.0,20,0.05
461454364,3,7,3.0,10,0.3
461454685,2,16,2.0,18,0.1111111111111111
461463192,1,9,1.0,10,0.1
461491872,2,7,2.0,9,0.2222222222222222
461495717,2,6,2.0,8,0.25
461608371,1,18,1.0,19,0.05263157894736842
461657995,2,8,2.0,10,0.2
461658640,1,9,1.0,10,0.1
461659907,2,8,2.0,10,0.2
461687091,1,18,1.0,19,0.05263157894736842
461688069,4,6,4.0,10,0.4
461697187,9,1,1.0,10,0.1
461701174,1,8,1.0,9,0.1111111111111111
461725104,3,7,3.0,10,0.3
461782928,1,9,1.0,10,0.1
461804912,8,2,2.0,10,0.2
461829130,1,19,1.0,20,0.05
461859872,1,9,1.0,10,0.1
461865264,9,1,1.0,10,0.1
461865371,1,8,1.0,9,0.1111111111111111
461926847,4,22,4.0,26,0.15384615384615385
461950688,1,8,1.0,9,0.1111111111111111
461959149,1,8,1.0,9,0.1111111111111111
461974465,1,9,1.0,10,0.1
461974690,8,1,1.0,9,0.1111111111111111
461983083,3,7,3.0,10,0.3
462055895,6,3,3.0,9,0.3333333333333333
462070750,5,5,5.0,10,0.5
462090270,9,11,9.0,20,0.45
462109221,2,7,2.0,9,0.2222222222222222
462115926,1,9,1.0,10,0.1
462123067,1,14,1.0,15,0.06666666666666667
462156785,1,8,1.0,9,0.1111111111111111
462158813,1,19,1.0,20,0.05
462220726,1,9,1.0,10,0.1
462241410,6,3,3.0,9,0.3333333333333333
462247289,2,17,2.0,19,0.10526315789473684
462262901,1,9,1.0,10,0.1
462296036,1,9,1.0,10,0.1
462329238,1,27,1.0,28,0.03571428571428571
462329598,2,26,2.0,28,0.07142857142857142
462331161,2,8,2.0,10,0.2
462333342,8,1,1.0,9,0.1111111111111111
462340838,3,25,3.0,28,0.10714285714285714
462341919,18,9,9.0,27,0.3333333333333333
462344139,9,1,1.0,10,0.1
462364780,1,9,1.0,10,0.1
462378630,1,8,1.0,9,0.1111111111111111
462405950,1,19,1.0,20,0.05
462432916,1,8,1.0,9,0.1111111111111111
462436604,1,9,1.0,10,0.1
462440449,2,8,2.0,10,0.2
462443150,2,8,2.0,10,0.2
462448242,3,6,3.0,9,0.3333333333333333
462453942,1,19,1.0,20,0.05
462454137,1,17,1.0,18,0.05555555555555555
462461464,1,9,1.0,10,0.1
462462476,1,8,1.0,9,0.1111111111111111
462463750,1,9,1.0,10,0.1
462468988,1,9,1.0,10,0.1
462472267,8,2,2.0,10,0.2
462480822,3,7,3.0,10,0.3
462507914,8,2,2.0,10,0.2
462524664,3,7,3.0,10,0.3
462572598,1,9,1.0,10,0.1
462572985,1,9,1.0,10,0.1
462592965,3,5,3.0,8,0.375
462610427,1,9,1.0,10,0.1
462634095,5,4,4.0,9,0.4444444444444444
462637642,3,6,3.0,9,0.3333333333333333
462642728,5,5,5.0,10,0.5
462643107,1,9,1.0,10,0.1
462657316,7,3,3.0,10,0.3
462659773,2,8,2.0,10,0.2
462663067,1,9,1.0,10,0.1
462665555,2,7,2.0,9,0.2222222222222222
462665780,1,9,1.0,10,0.1
462698436,2,8,2.0,10,0.2
462700695,2,8,2.0,10,0.2
462709376,2,7,2.0,9,0.2222222222222222
462719060,2,8,2.0,10,0.2
462725127,2,7,2.0,9,0.2222222222222222
462743780,2,8,2.0,10,0.2
462755890,2,8,2.0,10,0.2
462765138,6,4,4.0,10,0.4
462765853,3,7,3.0,10,0.3
462770407,1,9,1.0,10,0.1
462772493,4,16,4.0,20,0.2
462774927,1,28,1.0,29,0.034482758620689655
462800135,7,3,3.0,10,0.3
462846612,3,6,3.0,9,0.3333333333333333
462849222,4,6,4.0,10,0.4
462855189,6,3,3.0,9,0.3333333333333333
462855292,8,1,1.0,9,0.1111111111111111
462855413,2,7,2.0,9,0.2222222222222222
462855430,2,8,2.0,10,0.2
462859208,4,4,4.0,8,0.5
462867993,2,7,2.0,9,0.2222222222222222
462893222,4,6,4.0,10,0.4
462915127,3,6,3.0,9,0.3333333333333333
462932528,6,19,6.0,25,0.24
462939235,1,8,1.0,9,0.1111111111111111
462947986,1,9,1.0,10,0.1
463060991,2,8,2.0,10,0.2
463061564,1,9,1.0,10,0.1
463063548,1,7,1.0,8,0.125
463067788,1,9,1.0,10,0.1
463081055,1,7,1.0,8,0.125
463094106,5,5,5.0,10,0.5
463094397,1,9,1.0,10,0.1
463105224,1,8,1.0,9,0.1111111111111111
463105606,1,9,1.0,10,0.1
463129343,2,15,2.0,17,0.11764705882352941
463141368,7,20,7.0,27,0.25925925925925924
463146456,2,7,2.0,9,0.2222222222222222
463149942,3,7,3.0,10,0.3
463172850,5,3,3.0,8,0.375
463173187,8,2,2.0,10,0.2
463177159,2,7,2.0,9,0.2222222222222222
463178640,2,8,2.0,10,0.2
463183341,9,1,1.0,10,0.1
463219293,1,9,1.0,10,0.1
463241194,1,7,1.0,8,0.125
463242402,1,8,1.0,9,0.1111111111111111
463242760,1,8,1.0,9,0.1111111111111111
463324293,2,8,2.0,10,0.2
463357432,1,8,1.0,9,0.1111111111111111
463362380,5,13,5.0,18,0.2777777777777778
463379026,2,6,2.0,8,0.25
463379289,1,19,1.0,20,0.05
463400990,3,6,3.0,9,0.3333333333333333
463401587,1,28,1.0,29,0.034482758620689655
463424447,1,9,1.0,10,0.1
463454784,1,9,1.0,10,0.1
463459375,1,9,1.0,10,0.1
463537880,2,8,2.0,10,0.2
463550810,2,18,2.0,20,0.1
463593244,3,16,3.0,19,0.15789473684210525
463595474,1,8,1.0,9,0.1111111111111111
463600916,7,3,3.0,10,0.3
463615573,1,9,1.0,10,0.1
463620382,1,17,1.0,18,0.05555555555555555
463676542,1,9,1.0,10,0.1
463817643,9,1,1.0,10,0.1
463838594,1,18,1.0,19,0.05263157894736842
463850779,1,9,1.0,10,0.1
463866884,1,9,1.0,10,0.1
463908813,2,6,2.0,8,0.25
463933311,1,9,1.0,10,0.1
463940371,7,3,3.0,10,0.3
463940735,5,5,5.0,10,0.5
463943062,1,9,1.0,10,0.1
463943220,1,9,1.0,10,0.1
463944528,1,8,1.0,9,0.1111111111111111
463944649,10,15,10.0,25,0.4
463947385,23,6,6.0,29,0.20689655172413793
463947948,7,3,3.0,10,0.3
463947986,8,2,2.0,10,0.2
463948122,8,1,1.0,9,0.1111111111111111
463951035,1,17,1.0,18,0.05555555555555555
464088646,2,16,2.0,18,0.1111111111111111
464106412,2,7,2.0,9,0.2222222222222222
464108365,1,9,1.0,10,0.1
464121562,1,9,1.0,10,0.1
464123776,2,8,2.0,10,0.2
464124215,1,9,1.0,10,0.1
464124555,5,4,4.0,9,0.4444444444444444
464128212,5,15,5.0,20,0.25
464158458,1,9,1.0,10,0.1
464172874,4,6,4.0,10,0.4
464173325,8,2,2.0,10,0.2
464175940,1,8,1.0,9,0.1111111111111111
464210234,2,8,2.0,10,0.2
464218919,8,2,2.0,10,0.2
464219060,2,8,2.0,10,0.2
464227342,1,8,1.0,9,0.1111111111111111
464228480,4,5,4.0,9,0.4444444444444444
464229853,2,8,2.0,10,0.2
464235997,2,8,2.0,10,0.2
464257995,8,2,2.0,10,0.2
464281092,8,10,8.0,18,0.4444444444444444
464282748,4,5,4.0,9,0.4444444444444444
464285052,1,14,1.0,15,0.06666666666666667
464285387,1,9,1.0,10,0.1
464285925,1,9,1.0,10,0.1
464350503,8,1,1.0,9,0.1111111111111111
464350947,3,6,3.0,9,0.3333333333333333
464383841,1,9,1.0,10,0.1
464387379,1,9,1.0,10,0.1
464420513,1,7,1.0,8,0.125
464432523,2,8,2.0,10,0.2
464433982,7,3,3.0,10,0.3
464434494,2,7,2.0,9,0.2222222222222222
464444563,2,8,2.0,10,0.2
464445746,3,6,3.0,9,0.3333333333333333
464446241,1,28,1.0,29,0.034482758620689655
464451830,9,1,1.0,10,0.1
464462941,2,16,2.0,18,0.1111111111111111
464482883,3,6,3.0,9,0.3333333333333333
464485504,7,3,3.0,10,0.3
464485655,8,2,2.0,10,0.2
464488095,1,9,1.0,10,0.1
464494462,29,1,1.0,30,0.03333333333333333
464496349,3,7,3.0,10,0.3
464502791,6,4,4.0,10,0.4
464504716,8,2,2.0,10,0.2
464524475,2,7,2.0,9,0.2222222222222222
464526733,6,3,3.0,9,0.3333333333333333
464531422,1,9,1.0,10,0.1
464538651,3,7,3.0,10,0.3
464540528,1,8,1.0,9,0.1111111111111111
464544979,1,8,1.0,9,0.1111111111111111
464594428,3,7,3.0,10,0.3
464595945,1,9,1.0,10,0.1
464612380,5,3,3.0,8,0.375
464613322,8,2,2.0,10,0.2
464614661,7,2,2.0,9,0.2222222222222222
464617131,17,11,11.0,28,0.39285714285714285
464617787,9,1,1.0,10,0.1
464623803,2,8,2.0,10,0.2
464629050,3,7,3.0,10,0.3
464641179,2,7,2.0,9,0.2222222222222222
464682974,1,18,1.0,19,0.05263157894736842
464691299,4,6,4.0,10,0.4
464691819,5,4,4.0,9,0.4444444444444444
464692015,7,1,1.0,8,0.125
464693819,1,27,1.0,28,0.03571428571428571
464699227,2,6,2.0,8,0.25
464701621,1,9,1.0,10,0.1
464701979,2,8,2.0,10,0.2
464756047,2,7,2.0,9,0.2222222222222222
464759768,1,7,1.0,8,0.125
464775093,7,2,2.0,9,0.2222222222222222
464775702,1,8,1.0,9,0.1111111111111111
464788965,1,9,1.0,10,0.1
464789873,5,4,4.0,9,0.4444444444444444
464792773,2,8,2.0,10,0.2
464817135,2,8,2.0,10,0.2
464844007,1,9,1.0,10,0.1
464845622,6,3,3.0,9,0.3333333333333333
464853423,3,7,3.0,10,0.3
464856706,1,8,1.0,9,0.1111111111111111
464858695,1,9,1.0,10,0.1
464862729,2,8,2.0,10,0.2
464870338,4,15,4.0,19,0.21052631578947367
464875367,2,8,2.0,10,0.2
464889804,3,6,3.0,9,0.3333333333333333
464902298,5,5,5.0,10,0.5
464902935,6,3,3.0,9,0.3333333333333333
464913747,4,5,4.0,9,0.4444444444444444
464917591,2,7,2.0,9,0.2222222222222222
464920688,2,7,2.0,9,0.2222222222222222
464922010,6,4,4.0,10,0.4
464968946,1,9,1.0,10,0.1
464979087,1,17,1.0,18,0.05555555555555555
464987775,3,7,3.0,10,0.3
465010513,1,9,1.0,10,0.1
465024458,3,7,3.0,10,0.3
465037846,1,8,1.0,9,0.1111111111111111
465042745,1,19,1.0,20,0.05
465088763,2,16,2.0,18,0.1111111111111111
465152114,2,17,2.0,19,0.10526315789473684
465164742,1,8,1.0,9,0.1111111111111111
465185642,1,8,1.0,9,0.1111111111111111
465230774,17,1,1.0,18,0.05555555555555555
465328229,1,9,1.0,10,0.1
465363526,1,9,1.0,10,0.1
465366362,1,19,1.0,20,0.05
465371568,1,8,1.0,9,0.1111111111111111
465396691,8,2,2.0,10,0.2
465411762,9,20,9.0,29,0.3103448275862069
465421791,2,27,2.0,29,0.06896551724137931
465422088,5,5,5.0,10,0.5
465422574,2,7,2.0,9,0.2222222222222222
465431498,2,8,2.0,10,0.2
465439037,3,7,3.0,10,0.3
465442392,1,9,1.0,10,0.1
465443685,1,8,1.0,9,0.1111111111111111
465450053,1,19,1.0,20,0.05
465486368,11,18,11.0,29,0.3793103448275862
465487707,8,2,2.0,10,0.2
465488942,23,5,5.0,28,0.17857142857142858
465519018,1,8,1.0,9,0.1111111111111111
465519374,1,8,1.0,9,0.1111111111111111
465523822,1,19,1.0,20,0.05
465533261,1,9,1.0,10,0.1
465534110,5,5,5.0,10,0.5
465535068,4,6,4.0,10,0.4
465535915,2,7,2.0,9,0.2222222222222222
465540519,4,6,4.0,10,0.4
465552894,1,18,1.0,19,0.05263157894736842
465582664,3,23,3.0,26,0.11538461538461539
465583890,1,9,1.0,10,0.1
465636405,4,6,4.0,10,0.4
465639357,1,19,1.0,20,0.05
465679194,1,9,1.0,10,0.1
465694543,1,8,1.0,9,0.1111111111111111
465724512,3,5,3.0,8,0.375
465759882,1,18,1.0,19,0.05263157894736842
465814555,9,1,1.0,10,0.1
465815521,2,8,2.0,10,0.2
465828445,2,7,2.0,9,0.2222222222222222
465855215,2,7,2.0,9,0.2222222222222222
465865959,1,9,1.0,10,0.1
465877256,1,19,1.0,20,0.05
465877930,9,1,1.0,10,0.1
465918641,2,6,2.0,8,0.25
465920240,1,8,1.0,9,0.1111111111111111
465922978,1,9,1.0,10,0.1
465939136,1,19,1.0,20,0.05
465958271,2,6,2.0,8,0.25
465960436,12,7,7.0,19,0.3684210526315789
465965532,3,7,3.0,10,0.3
466058385,8,2,2.0,10,0.2
466059824,3,7,3.0,10,0.3
466060821,8,2,2.0,10,0.2
466104957,2,18,2.0,20,0.1
466148152,1,18,1.0,19,0.05263157894736842
466171218,3,7,3.0,10,0.3
466187989,7,3,3.0,10,0.3
466189410,3,7,3.0,10,0.3
466190006,3,7,3.0,10,0.3
466227436,1,8,1.0,9,0.1111111111111111
466278998,1,9,1.0,10,0.1
466279772,4,5,4.0,9,0.4444444444444444
466281123,3,6,3.0,9,0.3333333333333333
466283693,4,6,4.0,10,0.4
466285150,2,8,2.0,10,0.2
466318552,3,7,3.0,10,0.3
466318600,3,6,3.0,9,0.3333333333333333
466318819,12,18,12.0,30,0.4
466319271,6,4,4.0,10,0.4
466319491,8,1,1.0,9,0.1111111111111111
466320454,15,13,13.0,28,0.4642857142857143
466320595,4,5,4.0,9,0.4444444444444444
466324472,2,7,2.0,9,0.2222222222222222
466324759,7,2,2.0,9,0.2222222222222222
466363571,3,7,3.0,10,0.3
466363737,1,8,1.0,9,0.1111111111111111
466364313,1,18,1.0,19,0.05263157894736842
466367829,3,7,3.0,10,0.3
466396962,1,9,1.0,10,0.1
466400409,2,8,2.0,10,0.2
466406270,4,6,4.0,10,0.4
466417470,1,8,1.0,9,0.1111111111111111
466428754,1,7,1.0,8,0.125
466476652,12,18,12.0,30,0.4
466513644,1,19,1.0,20,0.05
466551958,1,9,1.0,10,0.1
466577243,2,8,2.0,10,0.2
466599103,4,6,4.0,10,0.4
466656705,27,2,2.0,29,0.06896551724137931
466678731,11,16,11.0,27,0.4074074074074074
466679328,6,4,4.0,10,0.4
466694342,1,8,1.0,9,0.1111111111111111
466701820,4,6,4.0,10,0.4
466704065,4,6,4.0,10,0.4
466720417,8,1,1.0,9,0.1111111111111111
466731504,2,8,2.0,10,0.2
466763123,1,9,1.0,10,0.1
466795633,4,6,4.0,10,0.4
466795784,8,1,1.0,9,0.1111111111111111
466795914,8,2,2.0,10,0.2
466809110,1,9,1.0,10,0.1
466823245,2,7,2.0,9,0.2222222222222222
466823475,5,4,4.0,9,0.4444444444444444
466828470,2,8,2.0,10,0.2
466846641,1,9,1.0,10,0.1
466855035,7,3,3.0,10,0.3
466885790,6,13,6.0,19,0.3157894736842105
466894960,1,8,1.0,9,0.1111111111111111
466895543,4,5,4.0,9,0.4444444444444444
466897168,2,8,2.0,10,0.2
466898685,1,7,1.0,8,0.125
466901325,3,7,3.0,10,0.3
466902430,5,4,4.0,9,0.4444444444444444
466922529,5,4,4.0,9,0.4444444444444444
466923147,6,3,3.0,9,0.3333333333333333
466952116,1,17,1.0,18,0.05555555555555555
466990810,1,9,1.0,10,0.1
466991024,3,6,3.0,9,0.3333333333333333
466998915,2,17,2.0,19,0.10526315789473684
467017120,1,9,1.0,10,0.1
467067532,1,7,1.0,8,0.125
467073263,1,7,1.0,8,0.125
467074215,5,4,4.0,9,0.4444444444444444
467076982,6,4,4.0,10,0.4
467077351,3,7,3.0,10,0.3
467082338,4,6,4.0,10,0.4
467135980,4,6,4.0,10,0.4
467140457,7,3,3.0,10,0.3
467140852,7,3,3.0,10,0.3
467140991,3,6,3.0,9,0.3333333333333333
467147083,14,6,6.0,20,0.3
467148616,1,9,1.0,10,0.1
467148953,8,2,2.0,10,0.2
467149329,5,4,4.0,9,0.4444444444444444
467149644,1,9,1.0,10,0.1
467150121,8,1,1.0,9,0.1111111111111111
467152719,3,7,3.0,10,0.3
467153802,4,6,4.0,10,0.4
467170433,2,8,2.0,10,0.2
467200250,2,7,2.0,9,0.2222222222222222
467205245,1,8,1.0,9,0.1111111111111111
467241099,4,6,4.0,10,0.4
467241954,1,8,1.0,9,0.1111111111111111
467243188,4,14,4.0,18,0.2222222222222222
467244820,5,5,5.0,10,0.5
467245957,9,1,1.0,10,0.1
467246804,5,5,5.0,10,0.5
467248395,3,7,3.0,10,0.3
467249995,3,6,3.0,9,0.3333333333333333
467251049,1,9,1.0,10,0.1
467254059,7,2,2.0,9,0.2222222222222222
467264401,6,3,3.0,9,0.3333333333333333
467277733,1,9,1.0,10,0.1
467285777,2,7,2.0,9,0.2222222222222222
467309810,1,9,1.0,10,0.1
467334193,2,17,2.0,19,0.10526315789473684
467348707,6,22,6.0,28,0.21428571428571427
467349565,1,27,1.0,28,0.03571428571428571
467397722,1,17,1.0,18,0.05555555555555555
467403464,1,7,1.0,8,0.125
467411970,1,18,1.0,19,0.05263157894736842
467433138,2,8,2.0,10,0.2
467445615,1,9,1.0,10,0.1
467514943,1,8,1.0,9,0.1111111111111111
467532949,1,18,1.0,19,0.05263157894736842
467570236,1,8,1.0,9,0.1111111111111111
467594292,8,2,2.0,10,0.2
467594443,21,7,7.0,28,0.25
467597636,1,9,1.0,10,0.1
467695557,2,7,2.0,9,0.2222222222222222
467759180,1,9,1.0,10,0.1
467759898,6,4,4.0,10,0.4
467791983,1,28,1.0,29,0.034482758620689655
467831673,1,8,1.0,9,0.1111111111111111
467841229,1,15,1.0,16,0.0625
467843087,1,9,1.0,10,0.1
467848477,4,6,4.0,10,0.4
467893860,8,2,2.0,10,0.2
467924853,1,8,1.0,9,0.1111111111111111
468032222,2,7,2.0,9,0.2222222222222222
468039221,5,4,4.0,9,0.4444444444444444
468042507,3,7,3.0,10,0.3
468042705,19,8,8.0,27,0.2962962962962963
468058350,4,16,4.0,20,0.2
468092597,2,8,2.0,10,0.2
468102429,24,2,2.0,26,0.07692307692307693
468103135,5,5,5.0,10,0.5
468112364,24,3,3.0,27,0.1111111111111111
468146107,1,9,1.0,10,0.1
468151769,1,17,1.0,18,0.05555555555555555
468152729,1,19,1.0,20,0.05
468214279,3,5,3.0,8,0.375
468215877,1,9,1.0,10,0.1
468232844,3,7,3.0,10,0.3
468233186,5,5,5.0,10,0.5
468233343,4,5,4.0,9,0.4444444444444444
468236699,1,19,1.0,20,0.05
468266635,4,6,4.0,10,0.4
468334077,8,2,2.0,10,0.2
468336064,9,1,1.0,10,0.1
468336653,26,2,2.0,28,0.07142857142857142
468369431,1,19,1.0,20,0.05
468469507,14,5,5.0,19,0.2631578947368421
468573995,8,2,2.0,10,0.2
468574205,17,1,1.0,18,0.05555555555555555
468594053,1,9,1.0,10,0.1
468594167,4,6,4.0,10,0.4
468614340,3,7,3.0,10,0.3
468616434,1,8,1.0,9,0.1111111111111111
468616872,5,13,5.0,18,0.2777777777777778
468620921,1,9,1.0,10,0.1
468624606,1,9,1.0,10,0.1
468692364,6,4,4.0,10,0.4
468697958,18,12,12.0,30,0.4
468709838,3,7,3.0,10,0.3
468776643,9,1,1.0,10,0.1
468783874,3,7,3.0,10,0.3
468784071,3,7,3.0,10,0.3
468784251,3,7,3.0,10,0.3
468784415,1,9,1.0,10,0.1
468785874,1,9,1.0,10,0.1
468786397,1,8,1.0,9,0.1111111111111111
468787842,5,5,5.0,10,0.5
468789124,3,6,3.0,9,0.3333333333333333
468789421,2,8,2.0,10,0.2
468795792,4,5,4.0,9,0.4444444444444444
468798125,3,6,3.0,9,0.3333333333333333
468801937,2,7,2.0,9,0.2222222222222222
468802020,8,2,2.0,10,0.2
468804834,6,2,2.0,8,0.25
468805687,1,9,1.0,10,0.1
468814711,1,9,1.0,10,0.1
468858008,3,6,3.0,9,0.3333333333333333
468858500,3,7,3.0,10,0.3
468886072,1,9,1.0,10,0.1
468909200,8,2,2.0,10,0.2
468919415,15,14,14.0,29,0.4827586206896552
468919629,5,3,3.0,8,0.375
468929287,5,24,5.0,29,0.1724137931034483
468930244,1,7,1.0,8,0.125
468960439,2,8,2.0,10,0.2
469114402,5,5,5.0,10,0.5
469161801,3,7,3.0,10,0.3
469162480,2,8,2.0,10,0.2
469203818,1,8,1.0,9,0.1111111111111111
469215712,4,6,4.0,10,0.4
469232547,16,2,2.0,18,0.1111111111111111
469233599,5,5,5.0,10,0.5
469237398,9,1,1.0,10,0.1
469248222,1,9,1.0,10,0.1
469260887,1,18,1.0,19,0.05263157894736842
469276882,26,2,2.0,28,0.07142857142857142
469277218,8,2,2.0,10,0.2
469301315,1,9,1.0,10,0.1
469301940,8,2,2.0,10,0.2
469302712,4,6,4.0,10,0.4
469303203,4,6,4.0,10,0.4
469338866,1,9,1.0,10,0.1
469369372,1,8,1.0,9,0.1111111111111111
469375841,4,6,4.0,10,0.4
469382922,1,9,1.0,10,0.1
469406662,5,5,5.0,10,0.5
469427723,9,1,1.0,10,0.1
469513789,1,18,1.0,19,0.05263157894736842
469554459,2,8,2.0,10,0.2
469555973,6,3,3.0,9,0.3333333333333333
469556482,8,2,2.0,10,0.2
469587230,2,8,2.0,10,0.2
469588506,4,5,4.0,9,0.4444444444444444
469589605,2,6,2.0,8,0.25
469591537,6,3,3.0,9,0.3333333333333333
469592854,6,4,4.0,10,0.4
469594600,1,7,1.0,8,0.125
469596239,3,5,3.0,8,0.375
469600155,2,18,2.0,20,0.1
469666825,2,8,2.0,10,0.2
469690085,1,8,1.0,9,0.1111111111111111
469771598,2,18,2.0,20,0.1
469863156,1,9,1.0,10,0.1
469867831,1,7,1.0,8,0.125
469898955,4,6,4.0,10,0.4
469899652,3,7,3.0,10,0.3
469901462,5,5,5.0,10,0.5
469904951,1,19,1.0,20,0.05
469912673,1,8,1.0,9,0.1111111111111111
469913141,1,9,1.0,10,0.1
469913478,1,9,1.0,10,0.1
469937916,2,8,2.0,10,0.2
469962653,1,9,1.0,10,0.1
469970434,1,8,1.0,9,0.1111111111111111
469986042,9,10,9.0,19,0.47368421052631576
470043412,9,1,1.0,10,0.1
470044527,2,24,2.0,26,0.07692307692307693
470097487,2,7,2.0,9,0.2222222222222222
470136306,1,9,1.0,10,0.1
470153946,3,17,3.0,20,0.15
470169671,8,1,1.0,9,0.1111111111111111
470170170,2,8,2.0,10,0.2
470282026,1,9,1.0,10,0.1
470282341,1,7,1.0,8,0.125
470283751,7,3,3.0,10,0.3
470284766,1,8,1.0,9,0.1111111111111111
470292558,1,9,1.0,10,0.1
470356950,1,8,1.0,9,0.1111111111111111
470380715,8,18,8.0,26,0.3076923076923077
470380956,1,9,1.0,10,0.1
470381177,6,23,6.0,29,0.20689655172413793
470397652,1,9,1.0,10,0.1
470492278,2,8,2.0,10,0.2
470493234,2,8,2.0,10,0.2
470502581,2,7,2.0,9,0.2222222222222222
470532598,1,9,1.0,10,0.1
470556060,5,5,5.0,10,0.5
470569085,9,1,1.0,10,0.1
470574628,28,1,1.0,29,0.034482758620689655
470586065,6,4,4.0,10,0.4
470586675,1,8,1.0,9,0.1111111111111111
470587430,1,9,1.0,10,0.1
470621978,2,8,2.0,10,0.2
470634731,1,19,1.0,20,0.05
470635783,1,9,1.0,10,0.1
470676251,2,6,2.0,8,0.25
470683386,1,8,1.0,9,0.1111111111111111
470688322,1,9,1.0,10,0.1
470720450,1,18,1.0,19,0.05263157894736842
470725589,2,18,2.0,20,0.1
470738073,1,9,1.0,10,0.1
470742318,1,8,1.0,9,0.1111111111111111
470743024,3,6,3.0,9,0.3333333333333333
470754544,6,3,3.0,9,0.3333333333333333
470779475,1,19,1.0,20,0.05
470819150,1,8,1.0,9,0.1111111111111111
470832484,3,7,3.0,10,0.3
470856527,2,8,2.0,10,0.2
470857923,4,6,4.0,10,0.4
470872644,7,2,2.0,9,0.2222222222222222
470889657,8,2,2.0,10,0.2
470908143,2,17,2.0,19,0.10526315789473684
470926233,2,7,2.0,9,0.2222222222222222
470926747,6,4,4.0,10,0.4
470926923,6,2,2.0,8,0.25
470929117,3,7,3.0,10,0.3
470965994,4,6,4.0,10,0.4
471056870,6,2,2.0,8,0.25
471135117,1,19,1.0,20,0.05
471139064,1,19,1.0,20,0.05
471149155,1,17,1.0,18,0.05555555555555555
471159883,2,8,2.0,10,0.2
471159958,1,17,1.0,18,0.05555555555555555
471160200,4,6,4.0,10,0.4
471165566,4,6,4.0,10,0.4
471168764,2,8,2.0,10,0.2
471172646,6,3,3.0,9,0.3333333333333333
471268412,1,28,1.0,29,0.034482758620689655
471269053,8,1,1.0,9,0.1111111111111111
471293363,2,7,2.0,9,0.2222222222222222
471299373,1,8,1.0,9,0.1111111111111111
471356626,6,3,3.0,9,0.3333333333333333
471357064,1,8,1.0,9,0.1111111111111111
471363811,2,8,2.0,10,0.2
471389950,4,6,4.0,10,0.4
471401192,1,9,1.0,10,0.1
471427849,7,2,2.0,9,0.2222222222222222
471428608,3,7,3.0,10,0.3
471429726,3,7,3.0,10,0.3
471433251,3,7,3.0,10,0.3
471433399,4,6,4.0,10,0.4
471436116,3,7,3.0,10,0.3
471438552,3,6,3.0,9,0.3333333333333333
471439189,9,1,1.0,10,0.1
471439848,21,9,9.0,30,0.3
471536326,1,9,1.0,10,0.1
471670425,3,16,3.0,19,0.15789473684210525
471675541,2,8,2.0,10,0.2
471798156,4,5,4.0,9,0.4444444444444444
471829260,3,6,3.0,9,0.3333333333333333
471830350,2,7,2.0,9,0.2222222222222222
471832832,6,14,6.0,20,0.3
471924330,1,9,1.0,10,0.1
471970092,3,16,3.0,19,0.15789473684210525
471971914,3,17,3.0,20,0.15
471991528,3,7,3.0,10,0.3
471991849,7,1,1.0,8,0.125
472002535,5,22,5.0,27,0.18518518518518517
472091025,2,18,2.0,20,0.1
472141888,1,15,1.0,16,0.0625
472159563,2,8,2.0,10,0.2
472177953,9,1,1.0,10,0.1
472179056,1,9,1.0,10,0.1
472285853,1,7,1.0,8,0.125
472290115,5,4,4.0,9,0.4444444444444444
472290699,9,10,9.0,19,0.47368421052631576
472292347,3,6,3.0,9,0.3333333333333333
472315668,7,22,7.0,29,0.2413793103448276
472321299,2,8,2.0,10,0.2
472321406,1,9,1.0,10,0.1
472331798,6,14,6.0,20,0.3
472355783,5,5,5.0,10,0.5
472402528,4,6,4.0,10,0.4
472402730,1,9,1.0,10,0.1
472403352,1,8,1.0,9,0.1111111111111111
472404202,9,1,1.0,10,0.1
472404806,1,9,1.0,10,0.1
472405176,7,2,2.0,9,0.2222222222222222
472406116,3,7,3.0,10,0.3
472452455,1,9,1.0,10,0.1
472505586,2,8,2.0,10,0.2
472509587,1,9,1.0,10,0.1
472510608,6,13,6.0,19,0.3157894736842105
472511596,5,5,5.0,10,0.5
472512231,2,8,2.0,10,0.2
472512582,8,2,2.0,10,0.2
472513990,9,1,1.0,10,0.1
472547842,3,6,3.0,9,0.3333333333333333
472548106,1,24,1.0,25,0.04
472549167,6,4,4.0,10,0.4
472549955,3,7,3.0,10,0.3
472550604,4,6,4.0,10,0.4
472569572,1,7,1.0,8,0.125
472630712,1,7,1.0,8,0.125
472655430,3,7,3.0,10,0.3
472688002,5,20,5.0,25,0.2
472692716,2,17,2.0,19,0.10526315789473684
472704216,1,8,1.0,9,0.1111111111111111
472706009,5,15,5.0,20,0.25
472706391,1,9,1.0,10,0.1
472731096,1,8,1.0,9,0.1111111111111111
472734756,1,19,1.0,20,0.05
472785631,9,1,1.0,10,0.1
472785686,8,2,2.0,10,0.2
472809886,7,3,3.0,10,0.3
472810705,6,3,3.0,9,0.3333333333333333
472871273,10,15,10.0,25,0.4
472887721,3,17,3.0,20,0.15
472895827,9,11,9.0,20,0.45
472900165,1,9,1.0,10,0.1
472911644,7,2,2.0,9,0.2222222222222222
472953913,4,25,4.0,29,0.13793103448275862
472966933,5,5,5.0,10,0.5
472970918,8,2,2.0,10,0.2
472973854,4,6,4.0,10,0.4
472976249,2,17,2.0,19,0.10526315789473684
473010755,1,17,1.0,18,0.05555555555555555
473012807,2,8,2.0,10,0.2
473019650,1,9,1.0,10,0.1
473022905,1,9,1.0,10,0.1
473043562,1,18,1.0,19,0.05263157894736842
473052786,7,2,2.0,9,0.2222222222222222
473056479,1,9,1.0,10,0.1
473057156,2,8,2.0,10,0.2
473058588,1,27,1.0,28,0.03571428571428571
473059332,1,8,1.0,9,0.1111111111111111
473061258,1,9,1.0,10,0.1
473061493,3,6,3.0,9,0.3333333333333333
473062040,1,9,1.0,10,0.1
473077304,4,6,4.0,10,0.4
473086526,2,7,2.0,9,0.2222222222222222
473093807,2,7,2.0,9,0.2222222222222222
473100368,1,8,1.0,9,0.1111111111111111
473101104,6,4,4.0,10,0.4
473101355,1,19,1.0,20,0.05
473103550,6,3,3.0,9,0.3333333333333333
473106557,4,25,4.0,29,0.13793103448275862
473122304,4,6,4.0,10,0.4
473137442,4,5,4.0,9,0.4444444444444444
473137766,3,7,3.0,10,0.3
473153044,1,9,1.0,10,0.1
473153215,2,7,2.0,9,0.2222222222222222
473167995,1,18,1.0,19,0.05263157894736842
473217722,1,17,1.0,18,0.05555555555555555
473273409,2,6,2.0,8,0.25
473273985,3,7,3.0,10,0.3
473294585,3,6,3.0,9,0.3333333333333333
473294716,6,3,3.0,9,0.3333333333333333
473296303,6,11,6.0,17,0.35294117647058826
473310295,1,7,1.0,8,0.125
473321374,1,7,1.0,8,0.125
473322444,2,8,2.0,10,0.2
473324406,1,8,1.0,9,0.1111111111111111
473338358,3,7,3.0,10,0.3
473339576,5,4,4.0,9,0.4444444444444444
473343693,2,18,2.0,20,0.1
473347047,1,9,1.0,10,0.1
473349642,1,8,1.0,9,0.1111111111111111
473349714,1,9,1.0,10,0.1
473352538,1,8,1.0,9,0.1111111111111111
473355662,2,6,2.0,8,0.25
473371412,1,17,1.0,18,0.05555555555555555
473392249,7,20,7.0,27,0.25925925925925924
473412746,2,7,2.0,9,0.2222222222222222
473417166,1,18,1.0,19,0.05263157894736842
473437825,9,18,9.0,27,0.3333333333333333
473438318,1,9,1.0,10,0.1
473439769,2,8,2.0,10,0.2
473440153,5,4,4.0,9,0.4444444444444444
473442858,4,5,4.0,9,0.4444444444444444
473459931,4,6,4.0,10,0.4
473509605,3,7,3.0,10,0.3
473546404,1,9,1.0,10,0.1
473547096,1,8,1.0,9,0.1111111111111111
473598435,21,8,8.0,29,0.27586206896551724
473609410,1,8,1.0,9,0.1111111111111111
473616659,3,6,3.0,9,0.3333333333333333
473716474,2,18,2.0,20,0.1
473727383,3,7,3.0,10,0.3
473731402,2,7,2.0,9,0.2222222222222222
473753858,1,19,1.0,20,0.05
473754122,8,2,2.0,10,0.2
473754491,24,3,3.0,27,0.1111111111111111
473772042,1,19,1.0,20,0.05
473772148,5,5,5.0,10,0.5
473837293,1,9,1.0,10,0.1
473845507,5,5,5.0,10,0.5
473856746,22,6,6.0,28,0.21428571428571427
473857466,8,2,2.0,10,0.2
473895512,1,8,1.0,9,0.1111111111111111
473905416,2,17,2.0,19,0.10526315789473684
473917017,4,5,4.0,9,0.4444444444444444
473917448,1,9,1.0,10,0.1
473920589,9,1,1.0,10,0.1
473920907,1,7,1.0,8,0.125
473921115,6,22,6.0,28,0.21428571428571427
473929781,7,3,3.0,10,0.3
473943127,1,19,1.0,20,0.05
473956521,7,12,7.0,19,0.3684210526315789
473971556,1,19,1.0,20,0.05
473995306,8,1,1.0,9,0.1111111111111111
474009032,1,8,1.0,9,0.1111111111111111
474018213,1,17,1.0,18,0.05555555555555555
474028128,3,24,3.0,27,0.1111111111111111
474033159,1,8,1.0,9,0.1111111111111111
474072605,5,4,4.0,9,0.4444444444444444
474079475,1,9,1.0,10,0.1
474093263,3,7,3.0,10,0.3
474104045,1,17,1.0,18,0.05555555555555555
474112343,1,18,1.0,19,0.05263157894736842
474135437,6,2,2.0,8,0.25
474135616,5,5,5.0,10,0.5
474146181,8,2,2.0,10,0.2
474165721,1,8,1.0,9,0.1111111111111111
474186261,1,9,1.0,10,0.1
474199620,3,6,3.0,9,0.3333333333333333
474218561,4,15,4.0,19,0.21052631578947367
474230107,6,4,4.0,10,0.4
474249593,1,8,1.0,9,0.1111111111111111
474288788,6,21,6.0,27,0.2222222222222222
474296673,3,7,3.0,10,0.3
474300564,7,3,3.0,10,0.3
474320037,1,7,1.0,8,0.125
474344977,7,3,3.0,10,0.3
474367020,8,2,2.0,10,0.2
474367492,1,9,1.0,10,0.1
474380979,1,17,1.0,18,0.05555555555555555
474383637,3,6,3.0,9,0.3333333333333333
474389515,3,7,3.0,10,0.3
474403137,1,15,1.0,16,0.0625
474487647,1,8,1.0,9,0.1111111111111111
474503267,1,9,1.0,10,0.1
474516121,1,8,1.0,9,0.1111111111111111
474523576,2,8,2.0,10,0.2
474570662,9,1,1.0,10,0.1
474572312,7,3,3.0,10,0.3
474574046,1,9,1.0,10,0.1
474575249,5,5,5.0,10,0.5
474576321,4,6,4.0,10,0.4
474578209,1,8,1.0,9,0.1111111111111111
474604464,1,9,1.0,10,0.1
474626847,1,9,1.0,10,0.1
474662320,1,9,1.0,10,0.1
474689982,1,17,1.0,18,0.05555555555555555
474762680,8,1,1.0,9,0.1111111111111111
474775653,6,4,4.0,10,0.4
474789080,1,19,1.0,20,0.05
474820921,1,9,1.0,10,0.1
474874706,1,18,1.0,19,0.05263157894736842
474895297,1,16,1.0,17,0.058823529411764705
474909302,1,9,1.0,10,0.1
474912566,13,14,13.0,27,0.48148148148148145
474912862,2,7,2.0,9,0.2222222222222222
474914491,4,6,4.0,10,0.4
474936915,4,6,4.0,10,0.4
474937959,9,1,1.0,10,0.1
474938398,2,7,2.0,9,0.2222222222222222
474944976,1,8,1.0,9,0.1111111111111111
474961930,7,3,3.0,10,0.3
474962446,1,9,1.0,10,0.1
474969276,5,5,5.0,10,0.5
474969794,2,27,2.0,29,0.06896551724137931
474970884,2,8,2.0,10,0.2
474971940,1,9,1.0,10,0.1
474973873,2,8,2.0,10,0.2
474975876,2,8,2.0,10,0.2
475014558,1,9,1.0,10,0.1
475057064,3,7,3.0,10,0.3
475057173,4,6,4.0,10,0.4
475070737,2,16,2.0,18,0.1111111111111111
475180737,2,8,2.0,10,0.2
475207449,9,9,9.0,18,0.5
475208858,2,26,2.0,28,0.07142857142857142
475209563,4,23,4.0,27,0.14814814814814814
475209715,4,5,4.0,9,0.4444444444444444
475211894,1,27,1.0,28,0.03571428571428571
475212659,2,7,2.0,9,0.2222222222222222
475222371,2,8,2.0,10,0.2
475226079,3,17,3.0,20,0.15
475227067,1,9,1.0,10,0.1
475230682,7,3,3.0,10,0.3
475233747,2,7,2.0,9,0.2222222222222222
475294238,4,5,4.0,9,0.4444444444444444
475298302,2,7,2.0,9,0.2222222222222222
475299572,6,24,6.0,30,0.2
475302492,6,3,3.0,9,0.3333333333333333
475324570,3,16,3.0,19,0.15789473684210525
475335027,4,6,4.0,10,0.4
475359944,2,6,2.0,8,0.25
475380932,1,9,1.0,10,0.1
475455530,1,9,1.0,10,0.1
475465457,2,8,2.0,10,0.2
475469794,2,8,2.0,10,0.2
475479996,1,8,1.0,9,0.1111111111111111
475510052,1,9,1.0,10,0.1
475518206,1,9,1.0,10,0.1
475519897,6,3,3.0,9,0.3333333333333333
475522101,2,8,2.0,10,0.2
475531224,3,25,3.0,28,0.10714285714285714
475548412,1,9,1.0,10,0.1
475565322,1,9,1.0,10,0.1
475574773,3,7,3.0,10,0.3
475585976,1,9,1.0,10,0.1
475591006,2,8,2.0,10,0.2
475628522,2,8,2.0,10,0.2
475633889,3,7,3.0,10,0.3
475687314,5,24,5.0,29,0.1724137931034483
475688394,2,8,2.0,10,0.2
475695322,9,1,1.0,10,0.1
475706607,1,9,1.0,10,0.1
475707144,1,9,1.0,10,0.1
475711528,1,8,1.0,9,0.1111111111111111
475714579,5,5,5.0,10,0.5
475723825,7,2,2.0,9,0.2222222222222222
475725364,3,7,3.0,10,0.3
475729514,6,4,4.0,10,0.4
475739901,3,6,3.0,9,0.3333333333333333
475742904,7,1,1.0,8,0.125
475742994,9,1,1.0,10,0.1
475743375,1,9,1.0,10,0.1
475743866,1,9,1.0,10,0.1
475746823,2,7,2.0,9,0.2222222222222222
475747550,1,18,1.0,19,0.05263157894736842
475753526,1,25,1.0,26,0.038461538461538464
475757076,2,18,2.0,20,0.1
475792872,9,1,1.0,10,0.1
475798999,1,8,1.0,9,0.1111111111111111
475826896,3,17,3.0,20,0.15
475838077,4,6,4.0,10,0.4
475869225,3,6,3.0,9,0.3333333333333333
475870808,2,7,2.0,9,0.2222222222222222
475891543,1,9,1.0,10,0.1
475896323,1,19,1.0,20,0.05
475897166,6,4,4.0,10,0.4
475913661,3,5,3.0,8,0.375
475974374,1,9,1.0,10,0.1
475977414,1,8,1.0,9,0.1111111111111111
475997951,5,4,4.0,9,0.4444444444444444
475999251,1,9,1.0,10,0.1
476009560,8,2,2.0,10,0.2
476020413,1,19,1.0,20,0.05
476033540,4,6,4.0,10,0.4
476038845,1,8,1.0,9,0.1111111111111111
476053094,1,9,1.0,10,0.1
476062402,1,28,1.0,29,0.034482758620689655
476079422,1,8,1.0,9,0.1111111111111111
476107081,1,9,1.0,10,0.1
476108802,4,6,4.0,10,0.4
476109351,2,7,2.0,9,0.2222222222222222
476109426,10,20,10.0,30,0.3333333333333333
476109550,8,2,2.0,10,0.2
476117296,1,9,1.0,10,0.1
476119862,4,6,4.0,10,0.4
476122908,6,4,4.0,10,0.4
476123572,1,9,1.0,10,0.1
476138061,4,5,4.0,9,0.4444444444444444
476138412,14,6,6.0,20,0.3
476172892,2,8,2.0,10,0.2
476184461,1,9,1.0,10,0.1
476187449,1,9,1.0,10,0.1
476200145,1,9,1.0,10,0.1
476258964,9,1,1.0,10,0.1
476259335,9,1,1.0,10,0.1
476279066,1,17,1.0,18,0.05555555555555555
476301768,9,1,1.0,10,0.1
476467975,1,9,1.0,10,0.1
476486498,1,8,1.0,9,0.1111111111111111
476497572,1,9,1.0,10,0.1
476502056,1,7,1.0,8,0.125
476504589,1,9,1.0,10,0.1
476507761,8,1,1.0,9,0.1111111111111111
476523464,1,9,1.0,10,0.1
476561867,1,9,1.0,10,0.1
476600576,2,7,2.0,9,0.2222222222222222
476621103,3,6,3.0,9,0.3333333333333333
476687974,3,7,3.0,10,0.3
476705492,1,9,1.0,10,0.1
476722619,1,9,1.0,10,0.1
476725307,3,7,3.0,10,0.3
476726380,1,8,1.0,9,0.1111111111111111
476728247,1,9,1.0,10,0.1
476728457,1,9,1.0,10,0.1
476738071,1,8,1.0,9,0.1111111111111111
476803316,1,8,1.0,9,0.1111111111111111
476812852,4,6,4.0,10,0.4
476843069,11,18,11.0,29,0.3793103448275862
476846304,15,4,4.0,19,0.21052631578947367
476846307,5,5,5.0,10,0.5
476848673,4,6,4.0,10,0.4
476849488,3,5,3.0,8,0.375
476863742,3,7,3.0,10,0.3
476864721,8,1,1.0,9,0.1111111111111111
476865615,5,5,5.0,10,0.5
476865725,4,6,4.0,10,0.4
476866206,8,2,2.0,10,0.2
476868572,5,4,4.0,9,0.4444444444444444
476871498,3,7,3.0,10,0.3
476872934,2,8,2.0,10,0.2
476881986,1,19,1.0,20,0.05
476883240,1,17,1.0,18,0.05555555555555555
476920391,8,1,1.0,9,0.1111111111111111
476922438,2,8,2.0,10,0.2
476949687,4,5,4.0,9,0.4444444444444444
476979897,2,6,2.0,8,0.25
476980002,2,8,2.0,10,0.2
477002313,22,6,6.0,28,0.21428571428571427
477002475,1,9,1.0,10,0.1
477008745,8,2,2.0,10,0.2
477090790,5,4,4.0,9,0.4444444444444444
477092882,1,9,1.0,10,0.1
477185645,3,5,3.0,8,0.375
477210222,2,18,2.0,20,0.1
477235862,3,6,3.0,9,0.3333333333333333
477239429,2,8,2.0,10,0.2
477239759,2,8,2.0,10,0.2
477240605,2,8,2.0,10,0.2
477242919,8,1,1.0,9,0.1111111111111111
477242986,3,6,3.0,9,0.3333333333333333
477322481,2,8,2.0,10,0.2
477323548,1,29,1.0,30,0.03333333333333333
477324228,1,8,1.0,9,0.1111111111111111
477333639,2,8,2.0,10,0.2
477334070,1,9,1.0,10,0.1
477335741,3,6,3.0,9,0.3333333333333333
477339887,4,5,4.0,9,0.4444444444444444
477347738,2,7,2.0,9,0.2222222222222222
477348744,9,1,1.0,10,0.1
477348868,9,1,1.0,10,0.1
477474202,18,1,1.0,19,0.05263157894736842
477487777,1,9,1.0,10,0.1
477488144,4,5,4.0,9,0.4444444444444444
477489587,2,18,2.0,20,0.1
477489913,2,18,2.0,20,0.1
477490808,1,7,1.0,8,0.125
477514267,1,9,1.0,10,0.1
477516593,1,8,1.0,9,0.1111111111111111
477518615,2,8,2.0,10,0.2
477595414,1,9,1.0,10,0.1
477601354,1,9,1.0,10,0.1
477606130,8,2,2.0,10,0.2
477665363,19,8,8.0,27,0.2962962962962963
477701409,26,2,2.0,28,0.07142857142857142
477714287,2,16,2.0,18,0.1111111111111111
477761120,1,8,1.0,9,0.1111111111111111
477762882,3,6,3.0,9,0.3333333333333333
477779124,1,9,1.0,10,0.1
477783049,2,8,2.0,10,0.2
477784964,7,3,3.0,10,0.3
477795287,2,8,2.0,10,0.2
477838806,1,9,1.0,10,0.1
477931685,2,8,2.0,10,0.2
477962151,1,9,1.0,10,0.1
477963423,1,9,1.0,10,0.1
477969112,7,1,1.0,8,0.125
477969737,9,1,1.0,10,0.1
478047751,1,9,1.0,10,0.1
478175065,7,2,2.0,9,0.2222222222222222
478175339,9,1,1.0,10,0.1
478175729,7,2,2.0,9,0.2222222222222222
478176563,6,3,3.0,9,0.3333333333333333
478204895,1,9,1.0,10,0.1
478222348,1,19,1.0,20,0.05
478239046,1,9,1.0,10,0.1
478252421,2,8,2.0,10,0.2
478253165,1,9,1.0,10,0.1
478264725,2,8,2.0,10,0.2
478278060,1,9,1.0,10,0.1
478279103,1,9,1.0,10,0.1
478321383,7,3,3.0,10,0.3
478365128,3,6,3.0,9,0.3333333333333333
478400080,1,9,1.0,10,0.1
478401348,2,7,2.0,9,0.2222222222222222
478407924,3,7,3.0,10,0.3
478412451,1,7,1.0,8,0.125
478453454,5,5,5.0,10,0.5
478554412,1,9,1.0,10,0.1
478570436,1,7,1.0,8,0.125
478585497,1,9,1.0,10,0.1
478597658,3,6,3.0,9,0.3333333333333333
478597787,3,7,3.0,10,0.3
478600569,7,3,3.0,10,0.3
478608028,18,1,1.0,19,0.05263157894736842
478625295,4,4,4.0,8,0.5
478628644,2,8,2.0,10,0.2
478635090,1,9,1.0,10,0.1
478652635,1,18,1.0,19,0.05263157894736842
478679859,3,27,3.0,30,0.1
478680145,3,6,3.0,9,0.3333333333333333
478694631,9,1,1.0,10,0.1
478700778,1,9,1.0,10,0.1
478706285,1,18,1.0,19,0.05263157894736842
478797404,1,18,1.0,19,0.05263157894736842
478810747,2,8,2.0,10,0.2
478822216,2,15,2.0,17,0.11764705882352941
478850049,2,16,2.0,18,0.1111111111111111
478859423,7,3,3.0,10,0.3
478943957,1,9,1.0,10,0.1
478954165,1,8,1.0,9,0.1111111111111111
478965331,1,9,1.0,10,0.1
478996442,1,9,1.0,10,0.1
478996768,1,9,1.0,10,0.1
479009332,5,4,4.0,9,0.4444444444444444
479068791,8,18,8.0,26,0.3076923076923077
479068860,1,9,1.0,10,0.1
479068936,3,6,3.0,9,0.3333333333333333
479078857,6,13,6.0,19,0.3157894736842105
479083083,2,7,2.0,9,0.2222222222222222
479105637,1,7,1.0,8,0.125
479125553,1,18,1.0,19,0.05263157894736842
479129996,1,8,1.0,9,0.1111111111111111
479148208,7,3,3.0,10,0.3
479179851,1,9,1.0,10,0.1
479229011,2,8,2.0,10,0.2
479247365,1,8,1.0,9,0.1111111111111111
479267154,2,7,2.0,9,0.2222222222222222
479267419,2,8,2.0,10,0.2
479270666,2,8,2.0,10,0.2
479290168,1,17,1.0,18,0.05555555555555555
479344431,3,6,3.0,9,0.3333333333333333
479346272,7,3,3.0,10,0.3
479355233,1,18,1.0,19,0.05263157894736842
479488922,13,6,6.0,19,0.3157894736842105
479493938,9,17,9.0,26,0.34615384615384615
479495037,5,5,5.0,10,0.5
479497476,4,6,4.0,10,0.4
479553848,3,7,3.0,10,0.3
479560761,6,4,4.0,10,0.4
479561483,6,4,4.0,10,0.4
479561572,5,5,5.0,10,0.5
479566928,1,19,1.0,20,0.05
479580920,7,3,3.0,10,0.3
479582933,1,9,1.0,10,0.1
479583375,5,5,5.0,10,0.5
479585265,11,15,11.0,26,0.4230769230769231
479605227,6,3,3.0,9,0.3333333333333333
479624074,2,24,2.0,26,0.07692307692307693
479626334,2,8,2.0,10,0.2
479626928,1,9,1.0,10,0.1
479634393,2,8,2.0,10,0.2
479641456,1,9,1.0,10,0.1
479643762,1,9,1.0,10,0.1
479643996,4,6,4.0,10,0.4
479671183,1,9,1.0,10,0.1
479697582,5,13,5.0,18,0.2777777777777778
479726619,1,7,1.0,8,0.125
479770414,7,13,7.0,20,0.35
479790730,4,15,4.0,19,0.21052631578947367
479792753,1,9,1.0,10,0.1
479799335,1,8,1.0,9,0.1111111111111111
479822826,9,1,1.0,10,0.1
479883013,1,18,1.0,19,0.05263157894736842
479885960,6,21,6.0,27,0.2222222222222222
479898531,2,7,2.0,9,0.2222222222222222
479900357,1,9,1.0,10,0.1
479921846,1,9,1.0,10,0.1
479927293,2,8,2.0,10,0.2
479928971,5,5,5.0,10,0.5
479945400,1,8,1.0,9,0.1111111111111111
480019190,4,6,4.0,10,0.4
480024461,1,8,1.0,9,0.1111111111111111
480025031,2,7,2.0,9,0.2222222222222222
480066460,7,2,2.0,9,0.2222222222222222
480067021,4,6,4.0,10,0.4
480068507,5,5,5.0,10,0.5
480069763,3,6,3.0,9,0.3333333333333333
480070087,6,3,3.0,9,0.3333333333333333
480070608,1,8,1.0,9,0.1111111111111111
480071780,5,22,5.0,27,0.18518518518518517
480082477,1,9,1.0,10,0.1
480102504,2,8,2.0,10,0.2
480105414,2,8,2.0,10,0.2
480133375,2,18,2.0,20,0.1
480154536,2,17,2.0,19,0.10526315789473684
480156382,1,8,1.0,9,0.1111111111111111
480231085,4,4,4.0,8,0.5
480232223,22,5,5.0,27,0.18518518518518517
480233086,2,8,2.0,10,0.2
480260708,1,7,1.0,8,0.125
480288513,1,8,1.0,9,0.1111111111111111
480307670,1,8,1.0,9,0.1111111111111111
480366769,2,16,2.0,18,0.1111111111111111
480419404,3,16,3.0,19,0.15789473684210525
480440259,6,4,4.0,10,0.4
480455468,3,6,3.0,9,0.3333333333333333
480484038,1,8,1.0,9,0.1111111111111111
480528425,10,10,10.0,20,0.5
480548707,1,9,1.0,10,0.1
480549460,1,9,1.0,10,0.1
480555191,3,7,3.0,10,0.3
480571656,1,9,1.0,10,0.1
480578852,2,8,2.0,10,0.2
480580517,8,1,1.0,9,0.1111111111111111
480580756,20,9,9.0,29,0.3103448275862069
480581252,2,8,2.0,10,0.2
480582170,8,1,1.0,9,0.1111111111111111
480583508,3,7,3.0,10,0.3
480599969,9,1,1.0,10,0.1
480603621,1,8,1.0,9,0.1111111111111111
480608440,2,7,2.0,9,0.2222222222222222
480622406,2,7,2.0,9,0.2222222222222222
480631671,2,6,2.0,8,0.25
480632100,1,9,1.0,10,0.1
480633959,2,8,2.0,10,0.2
480639897,2,8,2.0,10,0.2
480648072,1,8,1.0,9,0.1111111111111111
480654046,3,7,3.0,10,0.3
480734302,3,23,3.0,26,0.11538461538461539
480737507,8,1,1.0,9,0.1111111111111111
480741780,2,28,2.0,30,0.06666666666666667
480752897,8,1,1.0,9,0.1111111111111111
480755729,1,9,1.0,10,0.1
480820820,3,7,3.0,10,0.3
480844343,4,6,4.0,10,0.4
480845986,2,8,2.0,10,0.2
480847662,1,8,1.0,9,0.1111111111111111
480861960,1,17,1.0,18,0.05555555555555555
480929134,2,7,2.0,9,0.2222222222222222
480930367,15,14,14.0,29,0.4827586206896552
480947228,3,7,3.0,10,0.3
480950230,1,9,1.0,10,0.1
480950640,1,9,1.0,10,0.1
480951625,2,7,2.0,9,0.2222222222222222
480998681,2,8,2.0,10,0.2
481003157,2,7,2.0,9,0.2222222222222222
481010149,1,9,1.0,10,0.1
481012425,2,8,2.0,10,0.2
481108951,1,9,1.0,10,0.1
481127948,1,29,1.0,30,0.03333333333333333
481180825,2,18,2.0,20,0.1
481195069,1,9,1.0,10,0.1
481234849,1,28,1.0,29,0.034482758620689655
481239102,4,15,4.0,19,0.21052631578947367
481271621,2,7,2.0,9,0.2222222222222222
481323585,3,6,3.0,9,0.3333333333333333
481331290,1,8,1.0,9,0.1111111111111111
481338340,3,7,3.0,10,0.3
481353777,1,8,1.0,9,0.1111111111111111
481354038,2,7,2.0,9,0.2222222222222222
481356598,1,9,1.0,10,0.1
481359452,4,4,4.0,8,0.5
481360515,2,8,2.0,10,0.2
481360711,5,4,4.0,9,0.4444444444444444
481361168,5,3,3.0,8,0.375
481362589,1,9,1.0,10,0.1
481362730,3,7,3.0,10,0.3
481382208,1,18,1.0,19,0.05263157894736842
481473031,2,7,2.0,9,0.2222222222222222
481476052,6,3,3.0,9,0.3333333333333333
481477625,2,8,2.0,10,0.2
481554649,1,8,1.0,9,0.1111111111111111
481586324,5,5,5.0,10,0.5
481586612,1,8,1.0,9,0.1111111111111111
481590253,1,9,1.0,10,0.1
481624606,2,8,2.0,10,0.2
481629797,4,14,4.0,18,0.2222222222222222
481669403,3,16,3.0,19,0.15789473684210525
481676955,1,9,1.0,10,0.1
481721525,6,3,3.0,9,0.3333333333333333
481738089,1,8,1.0,9,0.1111111111111111
481740514,1,9,1.0,10,0.1
481744406,4,6,4.0,10,0.4
481744875,4,6,4.0,10,0.4
481746800,1,9,1.0,10,0.1
481749489,2,8,2.0,10,0.2
481751927,8,1,1.0,9,0.1111111111111111
481753060,3,7,3.0,10,0.3
481760359,7,21,7.0,28,0.25
481766186,4,5,4.0,9,0.4444444444444444
481778408,4,14,4.0,18,0.2222222222222222
481781353,1,9,1.0,10,0.1
481786781,1,26,1.0,27,0.037037037037037035
481794373,23,5,5.0,28,0.17857142857142858
481862787,2,8,2.0,10,0.2
481864163,1,7,1.0,8,0.125
481868319,1,8,1.0,9,0.1111111111111111
481870910,1,7,1.0,8,0.125
481934740,7,3,3.0,10,0.3
481936227,1,8,1.0,9,0.1111111111111111
481969878,6,2,2.0,8,0.25
481970432,25,5,5.0,30,0.16666666666666666
481970841,8,2,2.0,10,0.2
481976011,8,2,2.0,10,0.2
481978214,1,18,1.0,19,0.05263157894736842
482010418,1,19,1.0,20,0.05
482050115,1,9,1.0,10,0.1
482085856,1,9,1.0,10,0.1
482091202,5,5,5.0,10,0.5
482096464,5,5,5.0,10,0.5
482107496,7,3,3.0,10,0.3
482109727,4,6,4.0,10,0.4
482115267,1,9,1.0,10,0.1
482132329,1,19,1.0,20,0.05
482134625,2,8,2.0,10,0.2
482145669,1,19,1.0,20,0.05
482152916,3,7,3.0,10,0.3
482166423,2,7,2.0,9,0.2222222222222222
482176085,1,16,1.0,17,0.058823529411764705
482186201,1,17,1.0,18,0.05555555555555555
482190289,1,8,1.0,9,0.1111111111111111
482201021,5,5,5.0,10,0.5
482288430,3,6,3.0,9,0.3333333333333333
482293572,2,7,2.0,9,0.2222222222222222
482297762,2,7,2.0,9,0.2222222222222222
482307025,9,10,9.0,19,0.47368421052631576
482309019,2,8,2.0,10,0.2
482309216,1,9,1.0,10,0.1
482310004,8,2,2.0,10,0.2
482351956,1,8,1.0,9,0.1111111111111111
482352787,4,6,4.0,10,0.4
482354288,1,8,1.0,9,0.1111111111111111
482374171,1,8,1.0,9,0.1111111111111111
482384764,2,7,2.0,9,0.2222222222222222
482421992,1,18,1.0,19,0.05263157894736842
482442470,3,7,3.0,10,0.3
482460630,4,6,4.0,10,0.4
482462754,2,8,2.0,10,0.2
482463611,1,8,1.0,9,0.1111111111111111
482464044,4,4,4.0,8,0.5
482464360,5,5,5.0,10,0.5
482464968,5,5,5.0,10,0.5
482467022,1,9,1.0,10,0.1
482467150,3,7,3.0,10,0.3
482521146,5,5,5.0,10,0.5
482539699,3,26,3.0,29,0.10344827586206896
482558097,1,19,1.0,20,0.05
482561683,1,8,1.0,9,0.1111111111111111
482601344,6,2,2.0,8,0.25
482601494,8,2,2.0,10,0.2
482646198,1,9,1.0,10,0.1
482675742,12,16,12.0,28,0.42857142857142855
482677217,4,6,4.0,10,0.4
482696354,1,9,1.0,10,0.1
482753053,1,19,1.0,20,0.05
482829449,2,8,2.0,10,0.2
482830494,3,7,3.0,10,0.3
482831014,1,8,1.0,9,0.1111111111111111
482833231,3,6,3.0,9,0.3333333333333333
482833919,1,18,1.0,19,0.05263157894736842
482836003,2,17,2.0,19,0.10526315789473684
482839444,3,7,3.0,10,0.3
482864991,1,9,1.0,10,0.1
482865056,5,5,5.0,10,0.5
482865149,9,1,1.0,10,0.1
482887132,2,8,2.0,10,0.2
482888060,1,7,1.0,8,0.125
482912926,4,6,4.0,10,0.4
482993625,1,16,1.0,17,0.058823529411764705
483003112,3,7,3.0,10,0.3
483048218,1,8,1.0,9,0.1111111111111111
483082166,3,7,3.0,10,0.3
483165030,1,9,1.0,10,0.1
483268598,20,9,9.0,29,0.3103448275862069
483329776,1,8,1.0,9,0.1111111111111111
483388083,8,2,2.0,10,0.2
483444156,4,5,4.0,9,0.4444444444444444
483459697,1,15,1.0,16,0.0625
483472249,3,7,3.0,10,0.3
483472691,1,9,1.0,10,0.1
483526631,2,8,2.0,10,0.2
483584137,1,8,1.0,9,0.1111111111111111
483593908,3,7,3.0,10,0.3
483597237,9,1,1.0,10,0.1
483597950,9,1,1.0,10,0.1
483609836,3,5,3.0,8,0.375
483612216,6,4,4.0,10,0.4
483612776,3,7,3.0,10,0.3
483618214,9,1,1.0,10,0.1
483619175,1,9,1.0,10,0.1
483661685,2,14,2.0,16,0.125
483713661,1,7,1.0,8,0.125
483734578,1,9,1.0,10,0.1
483745087,2,17,2.0,19,0.10526315789473684
483765807,1,17,1.0,18,0.05555555555555555
483828814,1,9,1.0,10,0.1
483835354,8,2,2.0,10,0.2
483839378,1,7,1.0,8,0.125
483922436,6,12,6.0,18,0.3333333333333333
483947746,1,9,1.0,10,0.1
483948099,1,19,1.0,20,0.05
483981530,3,6,3.0,9,0.3333333333333333
484026052,2,16,2.0,18,0.1111111111111111
484048092,6,4,4.0,10,0.4
484061137,1,8,1.0,9,0.1111111111111111
484099041,1,18,1.0,19,0.05263157894736842
484100488,2,7,2.0,9,0.2222222222222222
484107129,6,4,4.0,10,0.4
484108942,5,4,4.0,9,0.4444444444444444
484225049,1,8,1.0,9,0.1111111111111111
484241413,1,9,1.0,10,0.1
484248285,1,18,1.0,19,0.05263157894736842
484260399,3,7,3.0,10,0.3
484290240,1,8,1.0,9,0.1111111111111111
484291170,1,7,1.0,8,0.125
484294571,8,1,1.0,9,0.1111111111111111
484332949,1,9,1.0,10,0.1
484374182,7,3,3.0,10,0.3
484374727,1,9,1.0,10,0.1
484382409,2,8,2.0,10,0.2
484400148,1,8,1.0,9,0.1111111111111111
484496818,1,15,1.0,16,0.0625
484557460,2,6,2.0,8,0.25
484557957,5,5,5.0,10,0.5
484559216,3,7,3.0,10,0.3
484574692,1,9,1.0,10,0.1
484588347,2,7,2.0,9,0.2222222222222222
484590404,1,8,1.0,9,0.1111111111111111
484592674,1,18,1.0,19,0.05263157894736842
484603961,5,5,5.0,10,0.5
484606611,3,7,3.0,10,0.3
484618719,1,9,1.0,10,0.1
484626664,9,1,1.0,10,0.1
484636359,1,8,1.0,9,0.1111111111111111
484637390,4,4,4.0,8,0.5
484637505,4,24,4.0,28,0.14285714285714285
484639095,2,17,2.0,19,0.10526315789473684
484640947,1,9,1.0,10,0.1
484647951,3,7,3.0,10,0.3
484687775,1,18,1.0,19,0.05263157894736842
484701701,2,8,2.0,10,0.2
484708584,2,8,2.0,10,0.2
484728836,1,9,1.0,10,0.1
484779071,3,7,3.0,10,0.3
484779351,1,28,1.0,29,0.034482758620689655
484804479,1,19,1.0,20,0.05
484823700,2,7,2.0,9,0.2222222222222222
484847119,1,8,1.0,9,0.1111111111111111
484848491,1,8,1.0,9,0.1111111111111111
484895845,4,6,4.0,10,0.4
484896802,16,10,10.0,26,0.38461538461538464
484969056,4,6,4.0,10,0.4
484985897,1,8,1.0,9,0.1111111111111111
484999525,2,8,2.0,10,0.2
485004220,2,8,2.0,10,0.2
485021491,4,5,4.0,9,0.4444444444444444
485035243,2,7,2.0,9,0.2222222222222222
485068088,5,4,4.0,9,0.4444444444444444
485069083,9,1,1.0,10,0.1
485123164,1,9,1.0,10,0.1
485145411,1,19,1.0,20,0.05
485190208,3,17,3.0,20,0.15
485198090,1,9,1.0,10,0.1
485225160,1,9,1.0,10,0.1
485240021,9,1,1.0,10,0.1
485244164,6,2,2.0,8,0.25
485299678,1,29,1.0,30,0.03333333333333333
485302585,1,19,1.0,20,0.05
485306941,4,4,4.0,8,0.5
485308522,8,2,2.0,10,0.2
485366627,1,9,1.0,10,0.1
485368998,1,7,1.0,8,0.125
485372895,7,2,2.0,9,0.2222222222222222
485375295,1,9,1.0,10,0.1
485375479,1,9,1.0,10,0.1
485375847,1,8,1.0,9,0.1111111111111111
485380044,4,16,4.0,20,0.2
485381096,1,9,1.0,10,0.1
485519257,2,8,2.0,10,0.2
485537573,1,9,1.0,10,0.1
485543297,1,8,1.0,9,0.1111111111111111
485566753,3,5,3.0,8,0.375
485583080,3,6,3.0,9,0.3333333333333333
485584235,3,7,3.0,10,0.3
485585361,2,8,2.0,10,0.2
485585879,2,7,2.0,9,0.2222222222222222
485586529,7,2,2.0,9,0.2222222222222222
485586823,9,1,1.0,10,0.1
485587940,9,1,1.0,10,0.1
485603920,2,8,2.0,10,0.2
485614659,1,8,1.0,9,0.1111111111111111
485629399,2,16,2.0,18,0.1111111111111111
485634376,1,7,1.0,8,0.125
485634840,7,2,2.0,9,0.2222222222222222
485666407,7,2,2.0,9,0.2222222222222222
485707533,1,18,1.0,19,0.05263157894736842
485778211,1,9,1.0,10,0.1
485817838,1,19,1.0,20,0.05
485828580,1,7,1.0,8,0.125
485846137,9,1,1.0,10,0.1
485888983,1,8,1.0,9,0.1111111111111111
485915103,1,9,1.0,10,0.1
485918020,1,7,1.0,8,0.125
485919872,3,27,3.0,30,0.1
485920137,2,8,2.0,10,0.2
485923776,1,9,1.0,10,0.1
485941313,8,20,8.0,28,0.2857142857142857
485941754,7,2,2.0,9,0.2222222222222222
485942704,3,6,3.0,9,0.3333333333333333
485944351,3,26,3.0,29,0.10344827586206896
485950205,1,8,1.0,9,0.1111111111111111
485954135,1,9,1.0,10,0.1
485955534,2,8,2.0,10,0.2
485974419,2,8,2.0,10,0.2
485995545,2,7,2.0,9,0.2222222222222222
485996723,2,8,2.0,10,0.2
486020011,1,9,1.0,10,0.1
486022723,1,8,1.0,9,0.1111111111111111
486152931,1,8,1.0,9,0.1111111111111111
486154123,3,7,3.0,10,0.3
486189747,1,8,1.0,9,0.1111111111111111
486196463,3,6,3.0,9,0.3333333333333333
486267996,3,6,3.0,9,0.3333333333333333
486268414,4,6,4.0,10,0.4
486297780,2,6,2.0,8,0.25
486340892,3,7,3.0,10,0.3
486356440,4,6,4.0,10,0.4
486359796,1,9,1.0,10,0.1
486375015,1,19,1.0,20,0.05
486375509,1,9,1.0,10,0.1
486398203,1,18,1.0,19,0.05263157894736842
486663858,1,8,1.0,9,0.1111111111111111
486668813,1,17,1.0,18,0.05555555555555555
486687417,2,8,2.0,10,0.2
486687597,2,8,2.0,10,0.2
486691934,7,3,3.0,10,0.3
486693507,3,7,3.0,10,0.3
486698867,6,3,3.0,9,0.3333333333333333
486721568,3,6,3.0,9,0.3333333333333333
486723581,1,9,1.0,10,0.1
486723831,2,8,2.0,10,0.2
486724133,2,8,2.0,10,0.2
486724591,6,4,4.0,10,0.4
486727584,4,5,4.0,9,0.4444444444444444
486757068,1,17,1.0,18,0.05555555555555555
486792729,1,9,1.0,10,0.1
486827556,1,9,1.0,10,0.1
486828041,4,14,4.0,18,0.2222222222222222
486831893,5,5,5.0,10,0.5
486839857,7,2,2.0,9,0.2222222222222222
486876089,1,15,1.0,16,0.0625
486894931,1,9,1.0,10,0.1
486895228,1,9,1.0,10,0.1
486955004,1,9,1.0,10,0.1
486957687,1,9,1.0,10,0.1
487088486,7,2,2.0,9,0.2222222222222222
487140390,1,16,1.0,17,0.058823529411764705
487149140,1,8,1.0,9,0.1111111111111111
487149286,1,17,1.0,18,0.05555555555555555
487155797,1,9,1.0,10,0.1
487180763,1,9,1.0,10,0.1
487180904,2,7,2.0,9,0.2222222222222222
487181878,8,21,8.0,29,0.27586206896551724
487188214,2,6,2.0,8,0.25
487201118,2,8,2.0,10,0.2
487210696,3,7,3.0,10,0.3
487213696,5,5,5.0,10,0.5
487221657,4,6,4.0,10,0.4
487238054,1,9,1.0,10,0.1
487241983,1,9,1.0,10,0.1
487242636,1,28,1.0,29,0.034482758620689655
487248784,4,4,4.0,8,0.5
487262934,7,2,2.0,9,0.2222222222222222
487319435,6,2,2.0,8,0.25
487329339,1,9,1.0,10,0.1
487329640,2,7,2.0,9,0.2222222222222222
487331667,1,8,1.0,9,0.1111111111111111
487341772,3,7,3.0,10,0.3
487407529,1,16,1.0,17,0.058823529411764705
487445660,1,8,1.0,9,0.1111111111111111
487451560,1,28,1.0,29,0.034482758620689655
487554382,1,8,1.0,9,0.1111111111111111
487554680,2,26,2.0,28,0.07142857142857142
487576779,1,9,1.0,10,0.1
487581622,1,9,1.0,10,0.1
487581863,1,8,1.0,9,0.1111111111111111
487614204,4,6,4.0,10,0.4
487614388,3,7,3.0,10,0.3
487615638,6,4,4.0,10,0.4
487649596,6,2,2.0,8,0.25
487684511,2,8,2.0,10,0.2
487714600,9,1,1.0,10,0.1
487726340,1,9,1.0,10,0.1
487734731,7,3,3.0,10,0.3
487736663,12,14,12.0,26,0.46153846153846156
487772837,1,9,1.0,10,0.1
487806041,1,9,1.0,10,0.1
487807556,3,7,3.0,10,0.3
487808455,3,7,3.0,10,0.3
487817025,4,6,4.0,10,0.4
487849111,1,8,1.0,9,0.1111111111111111
487850690,1,8,1.0,9,0.1111111111111111
487856994,4,6,4.0,10,0.4
487857914,4,5,4.0,9,0.4444444444444444
487858021,3,7,3.0,10,0.3
487859742,6,4,4.0,10,0.4
487872346,13,6,6.0,19,0.3157894736842105
487872381,3,7,3.0,10,0.3
487872430,2,6,2.0,8,0.25
487872506,5,5,5.0,10,0.5
487919599,8,2,2.0,10,0.2
487928502,5,4,4.0,9,0.4444444444444444
487963438,1,9,1.0,10,0.1
487964000,1,9,1.0,10,0.1
488003985,1,7,1.0,8,0.125
488027753,3,7,3.0,10,0.3
488028792,1,9,1.0,10,0.1
488050581,3,6,3.0,9,0.3333333333333333
488051455,8,19,8.0,27,0.2962962962962963
488053376,1,8,1.0,9,0.1111111111111111
488054856,5,23,5.0,28,0.17857142857142858
488055388,5,5,5.0,10,0.5
488066150,2,8,2.0,10,0.2
488092200,5,5,5.0,10,0.5
488170793,3,7,3.0,10,0.3
488171071,1,28,1.0,29,0.034482758620689655
488176713,2,25,2.0,27,0.07407407407407407
488200386,1,9,1.0,10,0.1
488206323,4,13,4.0,17,0.23529411764705882
488235911,5,13,5.0,18,0.2777777777777778
488245178,2,6,2.0,8,0.25
488253494,1,8,1.0,9,0.1111111111111111
488269633,1,8,1.0,9,0.1111111111111111
488283383,1,8,1.0,9,0.1111111111111111
488314490,1,9,1.0,10,0.1
488365908,1,18,1.0,19,0.05263157894736842
488369234,9,1,1.0,10,0.1
488384542,2,8,2.0,10,0.2
488390719,1,8,1.0,9,0.1111111111111111
488391876,6,4,4.0,10,0.4
488432611,2,8,2.0,10,0.2
488445030,7,13,7.0,20,0.35
488447179,2,8,2.0,10,0.2
488447304,2,7,2.0,9,0.2222222222222222
488447480,5,5,5.0,10,0.5
488447622,4,4,4.0,8,0.5
488447699,4,5,4.0,9,0.4444444444444444
488449289,2,8,2.0,10,0.2
488450136,2,8,2.0,10,0.2
488451008,6,3,3.0,9,0.3333333333333333
488451106,2,8,2.0,10,0.2
488456957,1,9,1.0,10,0.1
488516830,1,17,1.0,18,0.05555555555555555
488541400,1,9,1.0,10,0.1
488542747,3,7,3.0,10,0.3
488600156,1,19,1.0,20,0.05
488612099,2,7,2.0,9,0.2222222222222222
488620481,1,9,1.0,10,0.1
488626733,1,8,1.0,9,0.1111111111111111
488648098,1,19,1.0,20,0.05
488665703,8,2,2.0,10,0.2
488666136,6,4,4.0,10,0.4
488671825,2,8,2.0,10,0.2
488686339,1,7,1.0,8,0.125
488692314,1,27,1.0,28,0.03571428571428571
488701589,1,8,1.0,9,0.1111111111111111
488702158,4,6,4.0,10,0.4
488702483,4,6,4.0,10,0.4
488704108,7,3,3.0,10,0.3
488705367,5,4,4.0,9,0.4444444444444444
488706525,2,8,2.0,10,0.2
488721342,1,9,1.0,10,0.1
488750026,1,8,1.0,9,0.1111111111111111
488763936,6,4,4.0,10,0.4
488866934,1,18,1.0,19,0.05263157894736842
488891838,1,9,1.0,10,0.1
488900844,1,8,1.0,9,0.1111111111111111
488910324,1,9,1.0,10,0.1
488930139,3,7,3.0,10,0.3
488955553,3,7,3.0,10,0.3
488980084,9,1,1.0,10,0.1
488981313,2,8,2.0,10,0.2
488988274,1,9,1.0,10,0.1
489013051,1,19,1.0,20,0.05
489053558,6,4,4.0,10,0.4
489058844,8,2,2.0,10,0.2
489059056,9,1,1.0,10,0.1
489061362,2,8,2.0,10,0.2
489072640,1,18,1.0,19,0.05263157894736842
489077330,3,6,3.0,9,0.3333333333333333
489078962,6,4,4.0,10,0.4
489080105,6,2,2.0,8,0.25
489107264,1,9,1.0,10,0.1
489136528,5,3,3.0,8,0.375
489172550,4,5,4.0,9,0.4444444444444444
489183027,2,7,2.0,9,0.2222222222222222
489184712,4,6,4.0,10,0.4
489206371,2,7,2.0,9,0.2222222222222222
489207253,8,2,2.0,10,0.2
489207275,9,1,1.0,10,0.1
489207432,2,8,2.0,10,0.2
489207560,2,7,2.0,9,0.2222222222222222
489212589,7,3,3.0,10,0.3
489221082,3,17,3.0,20,0.15
489256496,3,7,3.0,10,0.3
489263332,2,7,2.0,9,0.2222222222222222
489263407,1,17,1.0,18,0.05555555555555555
489277363,2,7,2.0,9,0.2222222222222222
489280991,3,7,3.0,10,0.3
489322569,1,18,1.0,19,0.05263157894736842
489364597,2,8,2.0,10,0.2
489366511,4,5,4.0,9,0.4444444444444444
489373729,4,6,4.0,10,0.4
489373840,1,9,1.0,10,0.1
489374175,2,8,2.0,10,0.2
489374359,1,9,1.0,10,0.1
489403366,1,8,1.0,9,0.1111111111111111
489418476,1,8,1.0,9,0.1111111111111111
489418740,1,9,1.0,10,0.1
489422407,1,9,1.0,10,0.1
489424354,1,9,1.0,10,0.1
489431227,1,8,1.0,9,0.1111111111111111
489440699,1,8,1.0,9,0.1111111111111111
489440805,9,17,9.0,26,0.34615384615384615
489463290,1,16,1.0,17,0.058823529411764705
489485871,18,1,1.0,19,0.05263157894736842
489492400,4,6,4.0,10,0.4
489521064,2,7,2.0,9,0.2222222222222222
489539853,1,9,1.0,10,0.1
489579225,1,9,1.0,10,0.1
489583782,1,19,1.0,20,0.05
489584176,4,15,4.0,19,0.21052631578947367
489584428,3,7,3.0,10,0.3
489623422,2,17,2.0,19,0.10526315789473684
489630350,2,8,2.0,10,0.2
489720548,1,18,1.0,19,0.05263157894736842
489730081,2,8,2.0,10,0.2
489763825,1,9,1.0,10,0.1
489768547,8,2,2.0,10,0.2
489770160,7,2,2.0,9,0.2222222222222222
489772601,7,3,3.0,10,0.3
489779480,2,7,2.0,9,0.2222222222222222
489791564,1,9,1.0,10,0.1
489791722,1,9,1.0,10,0.1
489861302,1,9,1.0,10,0.1
489863217,1,9,1.0,10,0.1
490009927,2,7,2.0,9,0.2222222222222222
490010343,1,9,1.0,10,0.1
490010809,3,7,3.0,10,0.3
490033845,1,8,1.0,9,0.1111111111111111
490070858,3,7,3.0,10,0.3
490154453,12,7,7.0,19,0.3684210526315789
490159476,1,17,1.0,18,0.05555555555555555
490301705,1,9,1.0,10,0.1
490307876,2,18,2.0,20,0.1
490325983,1,9,1.0,10,0.1
490355894,8,2,2.0,10,0.2
490363706,1,9,1.0,10,0.1
490387852,8,1,1.0,9,0.1111111111111111
490492106,2,8,2.0,10,0.2
490499083,3,25,3.0,28,0.10714285714285714
490500846,5,13,5.0,18,0.2777777777777778
490557088,7,22,7.0,29,0.2413793103448276
490569543,11,16,11.0,27,0.4074074074074074
490572532,7,3,3.0,10,0.3
490574500,4,6,4.0,10,0.4
490597780,1,7,1.0,8,0.125
490661050,1,8,1.0,9,0.1111111111111111
490698516,1,7,1.0,8,0.125
490708869,1,9,1.0,10,0.1
490723432,1,9,1.0,10,0.1
490781498,1,9,1.0,10,0.1
490914635,1,8,1.0,9,0.1111111111111111
490953140,2,6,2.0,8,0.25
490957068,1,9,1.0,10,0.1
490957640,3,7,3.0,10,0.3
490975569,4,23,4.0,27,0.14814814814814814
490977081,1,8,1.0,9,0.1111111111111111
491023049,1,17,1.0,18,0.05555555555555555
491054675,4,15,4.0,19,0.21052631578947367
491059222,8,2,2.0,10,0.2
491059442,6,4,4.0,10,0.4
491116363,1,7,1.0,8,0.125
491116529,1,27,1.0,28,0.03571428571428571
491163401,2,8,2.0,10,0.2
491176156,3,17,3.0,20,0.15
491264697,6,3,3.0,9,0.3333333333333333
491264811,1,26,1.0,27,0.037037037037037035
491286605,2,7,2.0,9,0.2222222222222222
491291684,7,2,2.0,9,0.2222222222222222
491455441,14,15,14.0,29,0.4827586206896552
491478078,1,9,1.0,10,0.1
491478368,2,7,2.0,9,0.2222222222222222
491478701,4,6,4.0,10,0.4
491486077,1,9,1.0,10,0.1
491504170,1,8,1.0,9,0.1111111111111111
491519399,4,5,4.0,9,0.4444444444444444
491519738,3,7,3.0,10,0.3
491575916,1,7,1.0,8,0.125
491579711,1,7,1.0,8,0.125
491602008,8,2,2.0,10,0.2
491602132,8,2,2.0,10,0.2
491608360,2,6,2.0,8,0.25
491611304,2,7,2.0,9,0.2222222222222222
491611800,2,6,2.0,8,0.25
491612100,1,9,1.0,10,0.1
491618415,5,4,4.0,9,0.4444444444444444
491619369,3,7,3.0,10,0.3
491626579,2,8,2.0,10,0.2
491645299,3,7,3.0,10,0.3
491668715,1,17,1.0,18,0.05555555555555555
491688218,1,9,1.0,10,0.1
491712815,1,9,1.0,10,0.1
491712865,1,8,1.0,9,0.1111111111111111
491717801,1,9,1.0,10,0.1
491717852,2,7,2.0,9,0.2222222222222222
491732419,1,9,1.0,10,0.1
491737241,3,6,3.0,9,0.3333333333333333
491825326,2,17,2.0,19,0.10526315789473684
491832201,4,5,4.0,9,0.4444444444444444
491845357,7,3,3.0,10,0.3
491866040,9,1,1.0,10,0.1
491877590,1,19,1.0,20,0.05
491882680,1,9,1.0,10,0.1
491889131,1,9,1.0,10,0.1
491890302,1,9,1.0,10,0.1
491891484,1,9,1.0,10,0.1
491891895,26,2,2.0,28,0.07142857142857142
491892561,15,14,14.0,29,0.4827586206896552
491974416,1,8,1.0,9,0.1111111111111111
491976584,2,8,2.0,10,0.2
492020781,1,9,1.0,10,0.1
492044278,9,1,1.0,10,0.1
492071157,8,2,2.0,10,0.2
492071491,7,2,2.0,9,0.2222222222222222
492075424,1,7,1.0,8,0.125
492096551,1,7,1.0,8,0.125
492114135,3,6,3.0,9,0.3333333333333333
492117058,2,16,2.0,18,0.1111111111111111
492141090,1,19,1.0,20,0.05
492182635,1,9,1.0,10,0.1
492193435,1,9,1.0,10,0.1
492254540,2,17,2.0,19,0.10526315789473684
492283858,7,1,1.0,8,0.125
492291426,1,18,1.0,19,0.05263157894736842
492317023,2,8,2.0,10,0.2
492323775,4,6,4.0,10,0.4
492326649,1,7,1.0,8,0.125
492332820,3,7,3.0,10,0.3
492333466,1,18,1.0,19,0.05263157894736842
492335255,1,7,1.0,8,0.125
492340174,1,8,1.0,9,0.1111111111111111
492352563,5,5,5.0,10,0.5
492377046,5,5,5.0,10,0.5
492377793,7,2,2.0,9,0.2222222222222222
492384067,6,3,3.0,9,0.3333333333333333
492385040,1,8,1.0,9,0.1111111111111111
492388492,2,8,2.0,10,0.2
492390429,1,18,1.0,19,0.05263157894736842
492391627,1,9,1.0,10,0.1
492398669,2,7,2.0,9,0.2222222222222222
492412939,1,9,1.0,10,0.1
492426693,3,7,3.0,10,0.3
492474707,1,9,1.0,10,0.1
492502480,4,5,4.0,9,0.4444444444444444
492503544,4,6,4.0,10,0.4
492509931,3,6,3.0,9,0.3333333333333333
492527884,1,9,1.0,10,0.1
492555937,1,9,1.0,10,0.1
492560106,1,9,1.0,10,0.1
492561095,1,8,1.0,9,0.1111111111111111
492577542,1,9,1.0,10,0.1
492578337,6,23,6.0,29,0.20689655172413793
492603389,19,8,8.0,27,0.2962962962962963
492603838,5,5,5.0,10,0.5
492604516,24,3,3.0,27,0.1111111111111111
492605543,3,6,3.0,9,0.3333333333333333
492626485,2,17,2.0,19,0.10526315789473684
492661483,1,8,1.0,9,0.1111111111111111
492663491,2,8,2.0,10,0.2
492668343,1,8,1.0,9,0.1111111111111111
492669953,4,6,4.0,10,0.4
492672106,5,5,5.0,10,0.5
492674509,2,8,2.0,10,0.2
492678581,3,6,3.0,9,0.3333333333333333
492685690,1,9,1.0,10,0.1
492685982,1,9,1.0,10,0.1
492697107,1,9,1.0,10,0.1
492701391,1,9,1.0,10,0.1
492729622,3,7,3.0,10,0.3
492742852,1,8,1.0,9,0.1111111111111111
492763059,1,9,1.0,10,0.1
492769166,1,8,1.0,9,0.1111111111111111
492826759,1,8,1.0,9,0.1111111111111111
492869757,2,7,2.0,9,0.2222222222222222
492877576,4,15,4.0,19,0.21052631578947367
492878376,3,7,3.0,10,0.3
492878961,7,12,7.0,19,0.3684210526315789
492882081,1,9,1.0,10,0.1
492920620,1,9,1.0,10,0.1
492938849,1,18,1.0,19,0.05263157894736842
492944317,1,9,1.0,10,0.1
492970196,2,7,2.0,9,0.2222222222222222
493018998,1,19,1.0,20,0.05
493025361,4,6,4.0,10,0.4
493027054,5,5,5.0,10,0.5
493042702,1,9,1.0,10,0.1
493048895,1,8,1.0,9,0.1111111111111111
493061721,2,8,2.0,10,0.2
493076409,9,11,9.0,20,0.45
493103595,1,18,1.0,19,0.05263157894736842
493128100,1,9,1.0,10,0.1
493204241,7,2,2.0,9,0.2222222222222222
493228360,1,8,1.0,9,0.1111111111111111
493248708,6,3,3.0,9,0.3333333333333333
493248790,2,7,2.0,9,0.2222222222222222
493248866,6,3,3.0,9,0.3333333333333333
493275796,2,8,2.0,10,0.2
493277304,2,28,2.0,30,0.06666666666666667
493281276,2,7,2.0,9,0.2222222222222222
493287410,1,9,1.0,10,0.1
493309139,1,16,1.0,17,0.058823529411764705
493314363,3,6,3.0,9,0.3333333333333333
493380903,4,5,4.0,9,0.4444444444444444
493387446,1,9,1.0,10,0.1
493393916,7,2,2.0,9,0.2222222222222222
493395125,1,9,1.0,10,0.1
493396427,6,22,6.0,28,0.21428571428571427
493397196,2,7,2.0,9,0.2222222222222222
493397665,2,7,2.0,9,0.2222222222222222
493398042,3,7,3.0,10,0.3
493399783,1,8,1.0,9,0.1111111111111111
493401484,1,9,1.0,10,0.1
493401649,1,8,1.0,9,0.1111111111111111
493451667,8,2,2.0,10,0.2
493469129,4,6,4.0,10,0.4
493496688,5,5,5.0,10,0.5
493497652,1,9,1.0,10,0.1
493534216,25,2,2.0,27,0.07407407407407407
493535002,2,8,2.0,10,0.2
493537426,2,6,2.0,8,0.25
493562964,1,9,1.0,10,0.1
493563624,20,7,7.0,27,0.25925925925925924
493567125,1,8,1.0,9,0.1111111111111111
493569431,1,8,1.0,9,0.1111111111111111
493571501,3,6,3.0,9,0.3333333333333333
493576738,1,9,1.0,10,0.1
493580259,2,8,2.0,10,0.2
493581404,2,8,2.0,10,0.2
493582014,1,8,1.0,9,0.1111111111111111
493582331,2,7,2.0,9,0.2222222222222222
493586355,1,9,1.0,10,0.1
493591285,1,8,1.0,9,0.1111111111111111
493591686,3,7,3.0,10,0.3
493601878,1,9,1.0,10,0.1
493604581,3,7,3.0,10,0.3
493608177,1,8,1.0,9,0.1111111111111111
493629727,1,9,1.0,10,0.1
493649909,9,1,1.0,10,0.1
493686945,2,8,2.0,10,0.2
493688938,4,25,4.0,29,0.13793103448275862
493694504,4,6,4.0,10,0.4
493699465,1,9,1.0,10,0.1
493704852,6,4,4.0,10,0.4
493726164,10,7,7.0,17,0.4117647058823529
493768870,8,2,2.0,10,0.2
493769524,1,9,1.0,10,0.1
493772107,1,9,1.0,10,0.1
493774297,2,8,2.0,10,0.2
493777420,2,7,2.0,9,0.2222222222222222
493844950,2,8,2.0,10,0.2
493850890,1,9,1.0,10,0.1
493910048,1,9,1.0,10,0.1
493916347,6,4,4.0,10,0.4
493927263,3,7,3.0,10,0.3
493927543,2,8,2.0,10,0.2
493940258,3,7,3.0,10,0.3
493940841,1,8,1.0,9,0.1111111111111111
493941017,3,6,3.0,9,0.3333333333333333
493942445,4,4,4.0,8,0.5
493943343,1,9,1.0,10,0.1
493944386,1,9,1.0,10,0.1
493944685,2,7,2.0,9,0.2222222222222222
493963776,4,6,4.0,10,0.4
493964058,7,3,3.0,10,0.3
493964083,2,8,2.0,10,0.2
493966759,2,8,2.0,10,0.2
493997010,2,8,2.0,10,0.2
493998204,1,7,1.0,8,0.125
493999229,1,19,1.0,20,0.05
494006669,1,8,1.0,9,0.1111111111111111
494064483,6,4,4.0,10,0.4
494085695,7,3,3.0,10,0.3
494085844,4,6,4.0,10,0.4
494093599,12,13,12.0,25,0.48
494099597,1,9,1.0,10,0.1
494147765,5,5,5.0,10,0.5
494149481,3,6,3.0,9,0.3333333333333333
494164963,8,2,2.0,10,0.2
494166346,9,1,1.0,10,0.1
494184507,4,6,4.0,10,0.4
494192438,1,9,1.0,10,0.1
494197033,5,4,4.0,9,0.4444444444444444
494197800,7,3,3.0,10,0.3
494223761,1,18,1.0,19,0.05263157894736842
494235588,2,15,2.0,17,0.11764705882352941
494310673,5,25,5.0,30,0.16666666666666666
494335255,1,8,1.0,9,0.1111111111111111
494349100,2,7,2.0,9,0.2222222222222222
494375998,2,17,2.0,19,0.10526315789473684
494382066,2,7,2.0,9,0.2222222222222222
494402373,3,7,3.0,10,0.3
494403142,3,7,3.0,10,0.3
494451021,1,9,1.0,10,0.1
494468511,2,7,2.0,9,0.2222222222222222
494469019,3,7,3.0,10,0.3
494469550,3,6,3.0,9,0.3333333333333333
494469732,2,8,2.0,10,0.2
494475565,1,8,1.0,9,0.1111111111111111
494477899,2,17,2.0,19,0.10526315789473684
494480629,23,6,6.0,29,0.20689655172413793
494521995,2,7,2.0,9,0.2222222222222222
494530934,2,7,2.0,9,0.2222222222222222
494544316,1,7,1.0,8,0.125
494659274,2,7,2.0,9,0.2222222222222222
494681159,7,3,3.0,10,0.3
494681683,5,4,4.0,9,0.4444444444444444
494682404,6,4,4.0,10,0.4
494682940,6,4,4.0,10,0.4
494683728,2,7,2.0,9,0.2222222222222222
494686802,2,17,2.0,19,0.10526315789473684
494687242,1,19,1.0,20,0.05
494702273,2,8,2.0,10,0.2
494774173,1,9,1.0,10,0.1
494775780,4,5,4.0,9,0.4444444444444444
494778585,3,7,3.0,10,0.3
494780487,4,5,4.0,9,0.4444444444444444
494780684,1,8,1.0,9,0.1111111111111111
494790190,4,5,4.0,9,0.4444444444444444
494822573,1,9,1.0,10,0.1
494829620,3,25,3.0,28,0.10714285714285714
494842835,2,8,2.0,10,0.2
494847893,1,9,1.0,10,0.1
494863416,8,1,1.0,9,0.1111111111111111
494864468,1,7,1.0,8,0.125
494890746,2,16,2.0,18,0.1111111111111111
494913067,4,5,4.0,9,0.4444444444444444
494932708,19,10,10.0,29,0.3448275862068966
494961150,5,5,5.0,10,0.5
494966533,1,8,1.0,9,0.1111111111111111
495025603,7,1,1.0,8,0.125
495030594,7,2,2.0,9,0.2222222222222222
495045544,6,4,4.0,10,0.4
495076455,1,9,1.0,10,0.1
495092217,2,8,2.0,10,0.2
495092847,1,9,1.0,10,0.1
495109328,14,16,14.0,30,0.4666666666666667
495109606,4,5,4.0,9,0.4444444444444444
495111887,1,7,1.0,8,0.125
495121330,1,9,1.0,10,0.1
495163043,9,1,1.0,10,0.1
495177123,1,19,1.0,20,0.05
495187987,1,8,1.0,9,0.1111111111111111
495188103,1,8,1.0,9,0.1111111111111111
495190616,1,9,1.0,10,0.1
495193141,7,23,7.0,30,0.23333333333333334
495194918,1,26,1.0,27,0.037037037037037035
495236674,2,8,2.0,10,0.2
495269425,1,8,1.0,9,0.1111111111111111
495303163,8,2,2.0,10,0.2
495326364,2,8,2.0,10,0.2
495331302,7,2,2.0,9,0.2222222222222222
495331690,2,7,2.0,9,0.2222222222222222
495336404,6,4,4.0,10,0.4
495336631,5,5,5.0,10,0.5
495340436,2,8,2.0,10,0.2
495342155,1,8,1.0,9,0.1111111111111111
495342935,1,8,1.0,9,0.1111111111111111
495344173,1,8,1.0,9,0.1111111111111111
495346256,15,15,15.0,30,0.5
495352463,1,9,1.0,10,0.1
495354691,1,9,1.0,10,0.1
495367441,2,7,2.0,9,0.2222222222222222
495368510,1,9,1.0,10,0.1
495374589,2,8,2.0,10,0.2
495383201,5,5,5.0,10,0.5
495388485,6,4,4.0,10,0.4
495388839,3,5,3.0,8,0.375
495393610,4,5,4.0,9,0.4444444444444444
495398703,1,9,1.0,10,0.1
495431429,1,9,1.0,10,0.1
495474370,1,9,1.0,10,0.1
495475414,5,4,4.0,9,0.4444444444444444
495478028,1,9,1.0,10,0.1
495496506,2,7,2.0,9,0.2222222222222222
495504251,2,8,2.0,10,0.2
495508580,1,8,1.0,9,0.1111111111111111
495568388,5,5,5.0,10,0.5
495568746,4,6,4.0,10,0.4
495570236,19,1,1.0,20,0.05
495571539,5,14,5.0,19,0.2631578947368421
495637774,5,5,5.0,10,0.5
495638164,2,7,2.0,9,0.2222222222222222
495651383,7,22,7.0,29,0.2413793103448276
495653375,1,19,1.0,20,0.05
495657443,1,8,1.0,9,0.1111111111111111
495660637,8,17,8.0,25,0.32
495671581,1,9,1.0,10,0.1
495672700,2,8,2.0,10,0.2
495688508,4,6,4.0,10,0.4
495690338,7,22,7.0,29,0.2413793103448276
495691984,8,1,1.0,9,0.1111111111111111
495693360,7,2,2.0,9,0.2222222222222222
495695975,5,4,4.0,9,0.4444444444444444
495709474,1,9,1.0,10,0.1
495712703,1,9,1.0,10,0.1
495745661,1,9,1.0,10,0.1
495824177,2,17,2.0,19,0.10526315789473684
495852878,2,8,2.0,10,0.2
495917121,1,19,1.0,20,0.05
495923953,1,8,1.0,9,0.1111111111111111
495924777,3,7,3.0,10,0.3
495988159,2,17,2.0,19,0.10526315789473684
496085913,1,27,1.0,28,0.03571428571428571
496121860,3,6,3.0,9,0.3333333333333333
496160913,3,6,3.0,9,0.3333333333333333
496168300,4,5,4.0,9,0.4444444444444444
496168922,4,5,4.0,9,0.4444444444444444
496177635,1,8,1.0,9,0.1111111111111111
496189151,5,5,5.0,10,0.5
496189341,1,9,1.0,10,0.1
496216078,2,8,2.0,10,0.2
496222495,3,6,3.0,9,0.3333333333333333
496229423,1,8,1.0,9,0.1111111111111111
496230544,2,8,2.0,10,0.2
496238800,3,6,3.0,9,0.3333333333333333
496242888,7,3,3.0,10,0.3
496265571,1,8,1.0,9,0.1111111111111111
496266535,2,8,2.0,10,0.2
496267696,3,7,3.0,10,0.3
496276688,1,8,1.0,9,0.1111111111111111
496280049,2,8,2.0,10,0.2
496282101,1,19,1.0,20,0.05
496285667,2,7,2.0,9,0.2222222222222222
496343898,3,7,3.0,10,0.3
496345357,1,9,1.0,10,0.1
496444389,8,2,2.0,10,0.2
496482200,1,8,1.0,9,0.1111111111111111
496491618,9,1,1.0,10,0.1
496536256,8,2,2.0,10,0.2
496561576,1,17,1.0,18,0.05555555555555555
496565796,5,4,4.0,9,0.4444444444444444
496566395,16,13,13.0,29,0.4482758620689655
496567345,5,3,3.0,8,0.375
496567550,3,5,3.0,8,0.375
496568407,3,7,3.0,10,0.3
496568847,1,9,1.0,10,0.1
496593537,1,8,1.0,9,0.1111111111111111
496603854,2,18,2.0,20,0.1
496610289,3,7,3.0,10,0.3
496622936,1,18,1.0,19,0.05263157894736842
496637578,1,8,1.0,9,0.1111111111111111
496644210,1,9,1.0,10,0.1
496647996,2,17,2.0,19,0.10526315789473684
496654278,4,5,4.0,9,0.4444444444444444
496654427,3,7,3.0,10,0.3
496667126,3,7,3.0,10,0.3
496667926,1,8,1.0,9,0.1111111111111111
496669018,3,7,3.0,10,0.3
496669461,1,9,1.0,10,0.1
496719331,3,5,3.0,8,0.375
496725790,1,9,1.0,10,0.1
496739946,2,16,2.0,18,0.1111111111111111
496782181,3,6,3.0,9,0.3333333333333333
496782353,1,9,1.0,10,0.1
496784058,4,6,4.0,10,0.4
496814558,1,19,1.0,20,0.05
496821485,1,19,1.0,20,0.05
496828762,2,17,2.0,19,0.10526315789473684
496830941,3,6,3.0,9,0.3333333333333333
496869445,2,8,2.0,10,0.2
496924087,2,15,2.0,17,0.11764705882352941
496935736,3,7,3.0,10,0.3
496976784,1,7,1.0,8,0.125
497010586,18,2,2.0,20,0.1
497011109,8,2,2.0,10,0.2
497011833,18,1,1.0,19,0.05263157894736842
497012036,1,8,1.0,9,0.1111111111111111
497013203,3,6,3.0,9,0.3333333333333333
497019236,1,16,1.0,17,0.058823529411764705
497049499,2,8,2.0,10,0.2
497051488,3,7,3.0,10,0.3
497051772,2,8,2.0,10,0.2
497107101,1,9,1.0,10,0.1
497143697,4,6,4.0,10,0.4
497145913,19,9,9.0,28,0.32142857142857145
497146547,1,9,1.0,10,0.1
497150191,3,7,3.0,10,0.3
497151257,4,5,4.0,9,0.4444444444444444
497155619,4,6,4.0,10,0.4
497157078,19,10,10.0,29,0.3448275862068966
497157478,1,9,1.0,10,0.1
497175950,4,6,4.0,10,0.4
497191419,8,2,2.0,10,0.2
497207314,2,8,2.0,10,0.2
497214980,3,17,3.0,20,0.15
497225032,1,8,1.0,9,0.1111111111111111
497234238,4,4,4.0,8,0.5
497236249,2,8,2.0,10,0.2
497237798,9,1,1.0,10,0.1
497238363,2,16,2.0,18,0.1111111111111111
497244257,9,1,1.0,10,0.1
497247364,4,6,4.0,10,0.4
497275714,1,9,1.0,10,0.1
497285595,3,6,3.0,9,0.3333333333333333
497287860,1,8,1.0,9,0.1111111111111111
497326467,9,1,1.0,10,0.1
497343324,16,3,3.0,19,0.15789473684210525
497344886,1,9,1.0,10,0.1
497349760,1,7,1.0,8,0.125
497364066,2,8,2.0,10,0.2
497376793,26,2,2.0,28,0.07142857142857142
497377289,4,5,4.0,9,0.4444444444444444
497402986,1,9,1.0,10,0.1
497441913,5,14,5.0,19,0.2631578947368421
497442006,2,7,2.0,9,0.2222222222222222
497500257,5,24,5.0,29,0.1724137931034483
497501615,1,9,1.0,10,0.1
497522465,1,8,1.0,9,0.1111111111111111
497545517,2,8,2.0,10,0.2
497545798,1,9,1.0,10,0.1
497552320,2,7,2.0,9,0.2222222222222222
497557227,5,5,5.0,10,0.5
497558391,3,6,3.0,9,0.3333333333333333
497559255,4,5,4.0,9,0.4444444444444444
497565739,3,6,3.0,9,0.3333333333333333
497626711,1,9,1.0,10,0.1
497628298,1,9,1.0,10,0.1
497644529,2,8,2.0,10,0.2
497650913,1,8,1.0,9,0.1111111111111111
497651533,3,6,3.0,9,0.3333333333333333
497651837,7,3,3.0,10,0.3
497652242,2,6,2.0,8,0.25
497652357,1,8,1.0,9,0.1111111111111111
497652578,4,6,4.0,10,0.4
497652725,2,8,2.0,10,0.2
497652968,2,8,2.0,10,0.2
497654204,1,9,1.0,10,0.1
497654687,1,8,1.0,9,0.1111111111111111
497700418,3,7,3.0,10,0.3
497700616,7,3,3.0,10,0.3
497735529,1,8,1.0,9,0.1111111111111111
497789827,1,8,1.0,9,0.1111111111111111
497790217,1,9,1.0,10,0.1
497792051,3,7,3.0,10,0.3
497799768,2,7,2.0,9,0.2222222222222222
497810335,2,7,2.0,9,0.2222222222222222
497810724,8,2,2.0,10,0.2
497810803,9,1,1.0,10,0.1
497810866,1,18,1.0,19,0.05263157894736842
497814249,1,19,1.0,20,0.05
497827254,9,1,1.0,10,0.1
497844570,1,9,1.0,10,0.1
497879819,8,1,1.0,9,0.1111111111111111
497888699,1,18,1.0,19,0.05263157894736842
497922550,3,7,3.0,10,0.3
497922900,3,7,3.0,10,0.3
497931666,1,9,1.0,10,0.1
497948001,1,19,1.0,20,0.05
497982421,1,9,1.0,10,0.1
497983877,1,21,1.0,22,0.045454545454545456
497983964,1,9,1.0,10,0.1
497985954,1,9,1.0,10,0.1
497990019,1,25,1.0,26,0.038461538461538464
497995882,4,6,4.0,10,0.4
498066049,1,9,1.0,10,0.1
498068071,1,9,1.0,10,0.1
498080902,1,9,1.0,10,0.1
498086331,2,6,2.0,8,0.25
498122141,3,7,3.0,10,0.3
498147451,2,8,2.0,10,0.2
498150764,5,3,3.0,8,0.375
498152552,2,8,2.0,10,0.2
498153042,2,8,2.0,10,0.2
498160207,1,9,1.0,10,0.1
498177188,1,9,1.0,10,0.1
498237915,8,2,2.0,10,0.2
498238236,1,9,1.0,10,0.1
498238257,4,26,4.0,30,0.13333333333333333
498239376,1,27,1.0,28,0.03571428571428571
498272495,2,17,2.0,19,0.10526315789473684
498273644,1,8,1.0,9,0.1111111111111111
498274074,2,7,2.0,9,0.2222222222222222
498280694,1,9,1.0,10,0.1
498282756,1,8,1.0,9,0.1111111111111111
498287671,1,9,1.0,10,0.1
498289458,3,7,3.0,10,0.3
498290990,4,5,4.0,9,0.4444444444444444
498297462,6,4,4.0,10,0.4
498298268,5,5,5.0,10,0.5
498298626,4,6,4.0,10,0.4
498328762,1,8,1.0,9,0.1111111111111111
498334567,2,26,2.0,28,0.07142857142857142
498375651,4,5,4.0,9,0.4444444444444444
498421119,7,3,3.0,10,0.3
498461643,4,5,4.0,9,0.4444444444444444
498495501,1,7,1.0,8,0.125
498502207,7,2,2.0,9,0.2222222222222222
498523519,7,3,3.0,10,0.3
498523837,4,6,4.0,10,0.4
498524022,6,3,3.0,9,0.3333333333333333
498545015,6,4,4.0,10,0.4
498551068,2,8,2.0,10,0.2
498564533,3,7,3.0,10,0.3
498565945,1,9,1.0,10,0.1
498567478,3,7,3.0,10,0.3
498568144,3,6,3.0,9,0.3333333333333333
498569781,8,2,2.0,10,0.2
498573505,1,8,1.0,9,0.1111111111111111
498620994,1,9,1.0,10,0.1
498623258,9,1,1.0,10,0.1
498654957,1,27,1.0,28,0.03571428571428571
498667122,1,18,1.0,19,0.05263157894736842
498677645,3,17,3.0,20,0.15
498681815,1,9,1.0,10,0.1
498696795,1,8,1.0,9,0.1111111111111111
498724252,1,9,1.0,10,0.1
498729462,4,13,4.0,17,0.23529411764705882
498747444,1,9,1.0,10,0.1
498750193,6,4,4.0,10,0.4
498751340,2,8,2.0,10,0.2
498752937,1,8,1.0,9,0.1111111111111111
498753111,6,4,4.0,10,0.4
498772152,3,17,3.0,20,0.15
498839767,2,17,2.0,19,0.10526315789473684
498877582,8,2,2.0,10,0.2
498879495,23,7,7.0,30,0.23333333333333334
498882652,1,9,1.0,10,0.1
498889210,3,7,3.0,10,0.3
498912973,1,9,1.0,10,0.1
498972186,1,9,1.0,10,0.1
499040447,2,17,2.0,19,0.10526315789473684
499050574,1,9,1.0,10,0.1
499054703,1,9,1.0,10,0.1
499062811,1,9,1.0,10,0.1
499068472,5,4,4.0,9,0.4444444444444444
499072271,1,18,1.0,19,0.05263157894736842
499090130,2,28,2.0,30,0.06666666666666667
499116265,2,8,2.0,10,0.2
499116362,1,9,1.0,10,0.1
499120550,1,8,1.0,9,0.1111111111111111
499173562,4,6,4.0,10,0.4
499186412,1,8,1.0,9,0.1111111111111111
499190220,2,8,2.0,10,0.2
499193574,1,9,1.0,10,0.1
499228734,7,11,7.0,18,0.3888888888888889
499249728,5,3,3.0,8,0.375
499271581,5,5,5.0,10,0.5
499291135,2,17,2.0,19,0.10526315789473684
499308254,1,25,1.0,26,0.038461538461538464
499316249,1,8,1.0,9,0.1111111111111111
499387612,1,19,1.0,20,0.05
499483408,2,17,2.0,19,0.10526315789473684
499524867,2,7,2.0,9,0.2222222222222222
499531737,4,5,4.0,9,0.4444444444444444
499568265,1,8,1.0,9,0.1111111111111111
499584797,1,7,1.0,8,0.125
499600531,1,8,1.0,9,0.1111111111111111
499603591,7,1,1.0,8,0.125
499617263,19,10,10.0,29,0.3448275862068966
499617804,7,3,3.0,10,0.3
499618153,9,1,1.0,10,0.1
499619231,6,3,3.0,9,0.3333333333333333
499640445,1,7,1.0,8,0.125
499645671,3,6,3.0,9,0.3333333333333333
499671717,2,8,2.0,10,0.2
499703090,2,17,2.0,19,0.10526315789473684
499706092,4,6,4.0,10,0.4
499713934,3,7,3.0,10,0.3
499776117,2,8,2.0,10,0.2
499779307,4,5,4.0,9,0.4444444444444444
499779597,5,5,5.0,10,0.5
499790208,3,6,3.0,9,0.3333333333333333
499790400,1,9,1.0,10,0.1
499790488,4,6,4.0,10,0.4
499790615,1,9,1.0,10,0.1
499790983,3,7,3.0,10,0.3
499800432,2,8,2.0,10,0.2
499804747,1,17,1.0,18,0.05555555555555555
499834735,2,8,2.0,10,0.2
499842479,9,9,9.0,18,0.5
499878903,6,22,6.0,28,0.21428571428571427
499888126,3,7,3.0,10,0.3
499896220,3,7,3.0,10,0.3
499908858,2,7,2.0,9,0.2222222222222222
499913139,1,9,1.0,10,0.1
499928897,1,8,1.0,9,0.1111111111111111
499956344,8,2,2.0,10,0.2
499956678,22,5,5.0,27,0.18518518518518517
499958470,8,2,2.0,10,0.2
499968071,4,22,4.0,26,0.15384615384615385
499976031,8,1,1.0,9,0.1111111111111111
499983227,1,9,1.0,10,0.1
499987769,3,7,3.0,10,0.3
499988739,3,7,3.0,10,0.3
499989277,2,8,2.0,10,0.2
499992841,4,5,4.0,9,0.4444444444444444
499993175,6,21,6.0,27,0.2222222222222222
500009158,6,22,6.0,28,0.21428571428571427
500009161,1,19,1.0,20,0.05
500070249,6,4,4.0,10,0.4
500089270,2,7,2.0,9,0.2222222222222222
500089699,2,8,2.0,10,0.2
500090057,2,7,2.0,9,0.2222222222222222
500104890,2,8,2.0,10,0.2
500110078,8,2,2.0,10,0.2
500185755,1,7,1.0,8,0.125
500215753,4,5,4.0,9,0.4444444444444444
500249753,2,8,2.0,10,0.2
500321272,1,9,1.0,10,0.1
500323229,1,18,1.0,19,0.05263157894736842
500350775,3,6,3.0,9,0.3333333333333333
500359714,3,7,3.0,10,0.3
500379308,2,17,2.0,19,0.10526315789473684
500380243,3,16,3.0,19,0.15789473684210525
500394436,1,17,1.0,18,0.05555555555555555
500396065,3,7,3.0,10,0.3
500396232,2,8,2.0,10,0.2
500399851,1,17,1.0,18,0.05555555555555555
500417374,5,5,5.0,10,0.5
500432907,4,5,4.0,9,0.4444444444444444
500435987,6,11,6.0,17,0.35294117647058826
500439669,4,6,4.0,10,0.4
500439857,2,8,2.0,10,0.2
500462312,14,14,14.0,28,0.5
500463314,5,4,4.0,9,0.4444444444444444
500490181,2,8,2.0,10,0.2
500494324,1,9,1.0,10,0.1
500495274,4,4,4.0,8,0.5
500511892,3,7,3.0,10,0.3
500512399,3,7,3.0,10,0.3
500514489,2,8,2.0,10,0.2
500521276,1,8,1.0,9,0.1111111111111111
500521743,1,8,1.0,9,0.1111111111111111
500535358,1,7,1.0,8,0.125
500554740,19,10,10.0,29,0.3448275862068966
500560866,1,8,1.0,9,0.1111111111111111
500580964,2,7,2.0,9,0.2222222222222222
500610294,7,2,2.0,9,0.2222222222222222
500614452,6,4,4.0,10,0.4
500614622,2,7,2.0,9,0.2222222222222222
500640962,1,7,1.0,8,0.125
500672904,2,7,2.0,9,0.2222222222222222
500703771,4,6,4.0,10,0.4
500704324,1,9,1.0,10,0.1
500711378,7,2,2.0,9,0.2222222222222222
500721631,1,8,1.0,9,0.1111111111111111
500725575,1,8,1.0,9,0.1111111111111111
500748614,3,6,3.0,9,0.3333333333333333
500782120,1,7,1.0,8,0.125
500822266,9,1,1.0,10,0.1
500834558,8,2,2.0,10,0.2
500861727,7,3,3.0,10,0.3
500863626,1,9,1.0,10,0.1
500874951,2,18,2.0,20,0.1
500948044,2,8,2.0,10,0.2
500949741,2,7,2.0,9,0.2222222222222222
500953764,1,19,1.0,20,0.05
500955062,2,7,2.0,9,0.2222222222222222
500961477,1,9,1.0,10,0.1
500993739,7,2,2.0,9,0.2222222222222222
500995808,2,8,2.0,10,0.2
500998334,9,1,1.0,10,0.1
501005783,1,9,1.0,10,0.1
501090702,22,6,6.0,28,0.21428571428571427
501091070,5,5,5.0,10,0.5
501092486,2,6,2.0,8,0.25
501093640,2,8,2.0,10,0.2
501094514,2,8,2.0,10,0.2
501099572,1,24,1.0,25,0.04
501100977,19,1,1.0,20,0.05
501154712,1,9,1.0,10,0.1
501173506,4,14,4.0,18,0.2222222222222222
501181882,2,8,2.0,10,0.2
501213036,5,5,5.0,10,0.5
501269886,1,19,1.0,20,0.05
501326391,3,7,3.0,10,0.3
501327253,1,8,1.0,9,0.1111111111111111
501331169,1,9,1.0,10,0.1
501336881,1,18,1.0,19,0.05263157894736842
501338796,1,19,1.0,20,0.05
501379535,7,3,3.0,10,0.3
501381490,7,3,3.0,10,0.3
501387779,5,4,4.0,9,0.4444444444444444
501393476,2,8,2.0,10,0.2
501396692,9,1,1.0,10,0.1
501396818,7,2,2.0,9,0.2222222222222222
501397705,8,2,2.0,10,0.2
501397911,8,1,1.0,9,0.1111111111111111
501398546,8,1,1.0,9,0.1111111111111111
501408599,4,5,4.0,9,0.4444444444444444
501491106,1,17,1.0,18,0.05555555555555555
501495445,4,15,4.0,19,0.21052631578947367
501502743,1,9,1.0,10,0.1
501503926,3,7,3.0,10,0.3
501548879,4,15,4.0,19,0.21052631578947367
501553506,1,19,1.0,20,0.05
501629879,1,8,1.0,9,0.1111111111111111
501642151,1,17,1.0,18,0.05555555555555555
501645378,1,19,1.0,20,0.05
501675053,7,3,3.0,10,0.3
501716989,6,21,6.0,27,0.2222222222222222
501720100,9,1,1.0,10,0.1
501720306,9,1,1.0,10,0.1
501720862,9,1,1.0,10,0.1
501724717,1,16,1.0,17,0.058823529411764705
501725894,2,8,2.0,10,0.2
501732942,5,4,4.0,9,0.4444444444444444
501739205,1,8,1.0,9,0.1111111111111111
501761021,2,8,2.0,10,0.2
501762314,1,8,1.0,9,0.1111111111111111
501764010,5,5,5.0,10,0.5
501768256,8,2,2.0,10,0.2
501769446,1,8,1.0,9,0.1111111111111111
501788246,3,6,3.0,9,0.3333333333333333
501815115,9,1,1.0,10,0.1
501820313,2,8,2.0,10,0.2
501841498,1,19,1.0,20,0.05
501855855,4,6,4.0,10,0.4
501856225,4,15,4.0,19,0.21052631578947367
501856960,2,7,2.0,9,0.2222222222222222
501857102,1,9,1.0,10,0.1
501866351,3,7,3.0,10,0.3
501867294,6,3,3.0,9,0.3333333333333333
501897893,8,1,1.0,9,0.1111111111111111
501938933,7,3,3.0,10,0.3
501954272,5,4,4.0,9,0.4444444444444444
501956331,1,9,1.0,10,0.1
501964040,1,9,1.0,10,0.1
502061938,8,1,1.0,9,0.1111111111111111
502127290,8,1,1.0,9,0.1111111111111111
502178576,1,9,1.0,10,0.1
502216491,1,18,1.0,19,0.05263157894736842
502263802,4,6,4.0,10,0.4
502298639,1,9,1.0,10,0.1
502311739,1,8,1.0,9,0.1111111111111111
502313215,2,7,2.0,9,0.2222222222222222
502332323,6,4,4.0,10,0.4
502347300,1,9,1.0,10,0.1
502347514,2,7,2.0,9,0.2222222222222222
502348181,1,8,1.0,9,0.1111111111111111
502348738,7,2,2.0,9,0.2222222222222222
502352012,8,2,2.0,10,0.2
502363395,1,7,1.0,8,0.125
502388182,1,9,1.0,10,0.1
502394583,2,7,2.0,9,0.2222222222222222
502395631,1,9,1.0,10,0.1
502395780,1,9,1.0,10,0.1
502447547,3,5,3.0,8,0.375
502456224,4,6,4.0,10,0.4
502491117,5,5,5.0,10,0.5
502510538,5,5,5.0,10,0.5
502517718,4,5,4.0,9,0.4444444444444444
502553573,1,9,1.0,10,0.1
502582249,3,5,3.0,8,0.375
502644986,6,4,4.0,10,0.4
502651140,4,6,4.0,10,0.4
502667467,1,9,1.0,10,0.1
502670746,3,6,3.0,9,0.3333333333333333
502679573,1,8,1.0,9,0.1111111111111111
502733888,3,7,3.0,10,0.3
502738766,2,7,2.0,9,0.2222222222222222
502778315,1,9,1.0,10,0.1
502798796,2,7,2.0,9,0.2222222222222222
502801296,1,8,1.0,9,0.1111111111111111
502921841,1,9,1.0,10,0.1
502924219,2,8,2.0,10,0.2
502925281,1,8,1.0,9,0.1111111111111111
502942287,1,8,1.0,9,0.1111111111111111
502956908,1,9,1.0,10,0.1
502998248,1,9,1.0,10,0.1
502998583,1,28,1.0,29,0.034482758620689655
503001485,3,7,3.0,10,0.3
503003391,3,6,3.0,9,0.3333333333333333
503015121,1,18,1.0,19,0.05263157894736842
503019455,1,29,1.0,30,0.03333333333333333
503024584,2,27,2.0,29,0.06896551724137931
503031591,1,9,1.0,10,0.1
503031702,8,2,2.0,10,0.2
503033866,6,2,2.0,8,0.25
503034391,1,9,1.0,10,0.1
503035244,1,19,1.0,20,0.05
503105880,28,2,2.0,30,0.06666666666666667
503106436,2,6,2.0,8,0.25
503106554,2,8,2.0,10,0.2
503107028,3,7,3.0,10,0.3
503108584,5,5,5.0,10,0.5
503109255,5,5,5.0,10,0.5
503110991,1,9,1.0,10,0.1
503114345,3,7,3.0,10,0.3
503116470,3,7,3.0,10,0.3
503120280,2,8,2.0,10,0.2
503123222,1,9,1.0,10,0.1
503131550,1,9,1.0,10,0.1
503136132,1,9,1.0,10,0.1
503138642,4,5,4.0,9,0.4444444444444444
503144240,1,9,1.0,10,0.1
503146275,2,8,2.0,10,0.2
503156915,3,7,3.0,10,0.3
503228731,7,2,2.0,9,0.2222222222222222
503229268,2,8,2.0,10,0.2
503251664,1,8,1.0,9,0.1111111111111111
503254750,2,7,2.0,9,0.2222222222222222
503259738,1,9,1.0,10,0.1
503264811,26,1,1.0,27,0.037037037037037035
503265302,4,6,4.0,10,0.4
503266391,8,2,2.0,10,0.2
503268723,1,8,1.0,9,0.1111111111111111
503277121,4,6,4.0,10,0.4
503364461,1,9,1.0,10,0.1
503368115,1,8,1.0,9,0.1111111111111111
503419844,1,17,1.0,18,0.05555555555555555
503439900,3,17,3.0,20,0.15
503471396,1,18,1.0,19,0.05263157894736842
503476168,1,9,1.0,10,0.1
503488413,1,9,1.0,10,0.1
503497029,3,7,3.0,10,0.3
503552219,1,9,1.0,10,0.1
503558001,2,7,2.0,9,0.2222222222222222
503569655,5,4,4.0,9,0.4444444444444444
503572723,6,4,4.0,10,0.4
503584848,1,9,1.0,10,0.1
503628072,4,15,4.0,19,0.21052631578947367
503650416,2,8,2.0,10,0.2
503651321,9,1,1.0,10,0.1
503664391,3,7,3.0,10,0.3
503668549,1,19,1.0,20,0.05
503671279,2,25,2.0,27,0.07407407407407407
503671547,2,26,2.0,28,0.07142857142857142
503792668,1,18,1.0,19,0.05263157894736842
503861617,1,19,1.0,20,0.05
503869978,1,9,1.0,10,0.1
503911019,4,15,4.0,19,0.21052631578947367
503914266,1,8,1.0,9,0.1111111111111111
503925515,2,8,2.0,10,0.2
503942602,1,7,1.0,8,0.125
503943145,3,7,3.0,10,0.3
503951414,1,9,1.0,10,0.1
503974613,2,7,2.0,9,0.2222222222222222
504000724,2,7,2.0,9,0.2222222222222222
504003443,7,3,3.0,10,0.3
504032612,2,8,2.0,10,0.2
504033366,5,5,5.0,10,0.5
504041773,1,7,1.0,8,0.125
504068651,16,4,4.0,20,0.2
504071662,6,3,3.0,9,0.3333333333333333
504086950,1,9,1.0,10,0.1
504089243,1,9,1.0,10,0.1
504089938,1,9,1.0,10,0.1
504135984,9,1,1.0,10,0.1
504136139,9,1,1.0,10,0.1
504136646,9,1,1.0,10,0.1
504137377,1,9,1.0,10,0.1
504138598,1,9,1.0,10,0.1
504140615,1,9,1.0,10,0.1
504143668,5,5,5.0,10,0.5
504144085,7,3,3.0,10,0.3
504144677,10,10,10.0,20,0.5
504145199,8,1,1.0,9,0.1111111111111111
504166821,1,9,1.0,10,0.1
504171974,1,8,1.0,9,0.1111111111111111
504185698,8,2,2.0,10,0.2
504207590,2,8,2.0,10,0.2
504235362,6,3,3.0,9,0.3333333333333333
504235566,3,6,3.0,9,0.3333333333333333
504324808,2,7,2.0,9,0.2222222222222222
504347877,2,17,2.0,19,0.10526315789473684
504405666,27,3,3.0,30,0.1
504405733,5,24,5.0,29,0.1724137931034483
504439182,1,9,1.0,10,0.1
504455067,2,8,2.0,10,0.2
504552368,1,8,1.0,9,0.1111111111111111
504570375,4,6,4.0,10,0.4
504586594,5,3,3.0,8,0.375
504594982,1,19,1.0,20,0.05
504598250,1,9,1.0,10,0.1
504600449,2,7,2.0,9,0.2222222222222222
504602892,1,9,1.0,10,0.1
504605668,7,3,3.0,10,0.3
504661936,1,17,1.0,18,0.05555555555555555
504670528,3,7,3.0,10,0.3
504690422,4,5,4.0,9,0.4444444444444444
504735412,5,5,5.0,10,0.5
504743261,1,9,1.0,10,0.1
504783731,1,18,1.0,19,0.05263157894736842
504804819,1,9,1.0,10,0.1
504807669,5,3,3.0,8,0.375
504868857,6,4,4.0,10,0.4
504870137,1,8,1.0,9,0.1111111111111111
504870918,1,9,1.0,10,0.1
504889636,2,17,2.0,19,0.10526315789473684
504958033,1,9,1.0,10,0.1
504976527,3,6,3.0,9,0.3333333333333333
504978233,2,8,2.0,10,0.2
504999834,1,8,1.0,9,0.1111111111111111
505025355,2,8,2.0,10,0.2
505025895,7,3,3.0,10,0.3
505025967,7,3,3.0,10,0.3
505026136,1,7,1.0,8,0.125
505026187,1,9,1.0,10,0.1
505031483,6,3,3.0,9,0.3333333333333333
505036042,9,1,1.0,10,0.1
505036649,1,8,1.0,9,0.1111111111111111
505037691,11,16,11.0,27,0.4074074074074074
505043821,7,3,3.0,10,0.3
505051493,3,7,3.0,10,0.3
505091525,4,6,4.0,10,0.4
505112913,1,17,1.0,18,0.05555555555555555
505164931,3,7,3.0,10,0.3
505196697,3,7,3.0,10,0.3
505197017,1,19,1.0,20,0.05
505197549,1,9,1.0,10,0.1
505200877,4,15,4.0,19,0.21052631578947367
505209412,1,9,1.0,10,0.1
505210271,2,8,2.0,10,0.2
505211388,3,7,3.0,10,0.3
505241377,8,2,2.0,10,0.2
505241487,14,16,14.0,30,0.4666666666666667
505243460,27,1,1.0,28,0.03571428571428571
505244726,2,8,2.0,10,0.2
505245814,3,7,3.0,10,0.3
505309994,2,16,2.0,18,0.1111111111111111
505315803,2,7,2.0,9,0.2222222222222222
505388557,3,7,3.0,10,0.3
505402383,1,9,1.0,10,0.1
505404888,2,7,2.0,9,0.2222222222222222
505421939,5,5,5.0,10,0.5
505422572,1,9,1.0,10,0.1
505423216,2,7,2.0,9,0.2222222222222222
505423922,2,8,2.0,10,0.2
505433715,1,8,1.0,9,0.1111111111111111
505491443,2,8,2.0,10,0.2
505492708,3,5,3.0,8,0.375
505492803,2,8,2.0,10,0.2
505494177,1,9,1.0,10,0.1
505494355,8,2,2.0,10,0.2
505499524,1,7,1.0,8,0.125
505501765,7,3,3.0,10,0.3
505515998,1,9,1.0,10,0.1
505551567,18,10,10.0,28,0.35714285714285715
505557229,1,17,1.0,18,0.05555555555555555
505557504,4,6,4.0,10,0.4
505583662,1,8,1.0,9,0.1111111111111111
505590586,1,16,1.0,17,0.058823529411764705
505608507,8,1,1.0,9,0.1111111111111111
505609414,4,6,4.0,10,0.4
505614642,8,1,1.0,9,0.1111111111111111
505651214,1,8,1.0,9,0.1111111111111111
505660819,5,13,5.0,18,0.2777777777777778
505685120,2,7,2.0,9,0.2222222222222222
505719716,1,9,1.0,10,0.1
505746199,2,7,2.0,9,0.2222222222222222
505794010,3,7,3.0,10,0.3
505796881,5,4,4.0,9,0.4444444444444444
505803246,7,2,2.0,9,0.2222222222222222
505809015,6,4,4.0,10,0.4
505809236,1,8,1.0,9,0.1111111111111111
505813321,3,7,3.0,10,0.3
505885611,11,17,11.0,28,0.39285714285714285
505896201,7,2,2.0,9,0.2222222222222222
505921471,2,8,2.0,10,0.2
505982938,2,8,2.0,10,0.2
505987670,2,7,2.0,9,0.2222222222222222
506017709,2,17,2.0,19,0.10526315789473684
506033342,1,17,1.0,18,0.05555555555555555
506072874,27,1,1.0,28,0.03571428571428571
506081830,1,8,1.0,9,0.1111111111111111
506095403,1,9,1.0,10,0.1
506122013,1,9,1.0,10,0.1
506125165,1,9,1.0,10,0.1
506126573,1,8,1.0,9,0.1111111111111111
506132980,2,7,2.0,9,0.2222222222222222
506139066,1,8,1.0,9,0.1111111111111111
506183111,3,5,3.0,8,0.375
506305819,5,5,5.0,10,0.5
506342701,2,8,2.0,10,0.2
506356628,4,5,4.0,9,0.4444444444444444
506378030,2,8,2.0,10,0.2
506403719,1,9,1.0,10,0.1
506454415,2,8,2.0,10,0.2
506456181,1,8,1.0,9,0.1111111111111111
506459097,2,8,2.0,10,0.2
506459992,4,6,4.0,10,0.4
506462429,3,6,3.0,9,0.3333333333333333
506492712,6,13,6.0,19,0.3157894736842105
506532031,1,9,1.0,10,0.1
506561023,1,9,1.0,10,0.1
506592522,4,6,4.0,10,0.4
506593073,8,1,1.0,9,0.1111111111111111
506639413,3,7,3.0,10,0.3
506649694,2,8,2.0,10,0.2
506651771,3,7,3.0,10,0.3
506660271,8,1,1.0,9,0.1111111111111111
506701389,2,6,2.0,8,0.25
506730282,1,29,1.0,30,0.03333333333333333
506748659,3,7,3.0,10,0.3
506751389,6,4,4.0,10,0.4
506753241,5,4,4.0,9,0.4444444444444444
506765621,2,7,2.0,9,0.2222222222222222
506877747,2,8,2.0,10,0.2
506879047,8,1,1.0,9,0.1111111111111111
506936933,3,25,3.0,28,0.10714285714285714
506942460,6,4,4.0,10,0.4
506952504,3,6,3.0,9,0.3333333333333333
506958144,5,5,5.0,10,0.5
506986316,4,6,4.0,10,0.4
506988486,1,8,1.0,9,0.1111111111111111
507005199,1,9,1.0,10,0.1
507032940,2,8,2.0,10,0.2
507033594,1,8,1.0,9,0.1111111111111111
507038105,1,9,1.0,10,0.1
507045402,1,19,1.0,20,0.05
507046175,2,7,2.0,9,0.2222222222222222
507047034,1,8,1.0,9,0.1111111111111111
507079851,8,2,2.0,10,0.2
507082848,3,7,3.0,10,0.3
507092852,3,7,3.0,10,0.3
507093216,1,8,1.0,9,0.1111111111111111
507093927,1,18,1.0,19,0.05263157894736842
507094267,1,9,1.0,10,0.1
507097257,2,7,2.0,9,0.2222222222222222
507126076,2,8,2.0,10,0.2
507151775,1,9,1.0,10,0.1
507205083,2,8,2.0,10,0.2
507217976,7,19,7.0,26,0.2692307692307692
507219118,6,3,3.0,9,0.3333333333333333
507251044,1,8,1.0,9,0.1111111111111111
507268733,1,8,1.0,9,0.1111111111111111
507275995,7,3,3.0,10,0.3
507288061,2,8,2.0,10,0.2
507290441,5,5,5.0,10,0.5
507292746,3,7,3.0,10,0.3
507333683,2,6,2.0,8,0.25
507374345,2,8,2.0,10,0.2
507396437,4,5,4.0,9,0.4444444444444444
507401078,5,5,5.0,10,0.5
507402763,5,5,5.0,10,0.5
507418454,8,2,2.0,10,0.2
507420557,2,7,2.0,9,0.2222222222222222
507448973,2,17,2.0,19,0.10526315789473684
507483587,1,8,1.0,9,0.1111111111111111
507483985,1,9,1.0,10,0.1
507484355,7,2,2.0,9,0.2222222222222222
507546222,1,18,1.0,19,0.05263157894736842
507558212,2,17,2.0,19,0.10526315789473684
507559384,1,9,1.0,10,0.1
507575103,3,7,3.0,10,0.3
507584731,2,8,2.0,10,0.2
507585388,8,1,1.0,9,0.1111111111111111
507587051,9,1,1.0,10,0.1
507630848,4,6,4.0,10,0.4
507779465,6,3,3.0,9,0.3333333333333333
507784301,2,6,2.0,8,0.25
507788792,1,9,1.0,10,0.1
507792137,1,8,1.0,9,0.1111111111111111
507793725,1,7,1.0,8,0.125
507802051,1,17,1.0,18,0.05555555555555555
507846018,6,4,4.0,10,0.4
507847018,1,9,1.0,10,0.1
507851335,5,5,5.0,10,0.5
507853396,3,6,3.0,9,0.3333333333333333
507953175,2,8,2.0,10,0.2
507953242,1,8,1.0,9,0.1111111111111111
507953296,2,8,2.0,10,0.2
507953340,16,13,13.0,29,0.4482758620689655
507953372,1,9,1.0,10,0.1
507953880,8,2,2.0,10,0.2
507998796,28,1,1.0,29,0.034482758620689655
507999398,1,15,1.0,16,0.0625
508006246,1,9,1.0,10,0.1
508009983,1,28,1.0,29,0.034482758620689655
508021225,1,8,1.0,9,0.1111111111111111
508023393,1,9,1.0,10,0.1
508024376,3,7,3.0,10,0.3
508024557,2,26,2.0,28,0.07142857142857142
508033753,4,5,4.0,9,0.4444444444444444
508050199,1,25,1.0,26,0.038461538461538464
508060325,8,2,2.0,10,0.2
508067867,1,19,1.0,20,0.05
508072197,1,9,1.0,10,0.1
508087303,1,9,1.0,10,0.1
508089547,4,6,4.0,10,0.4
508089729,7,3,3.0,10,0.3
508109537,1,16,1.0,17,0.058823529411764705
508153051,2,8,2.0,10,0.2
508221286,4,5,4.0,9,0.4444444444444444
508221974,7,3,3.0,10,0.3
508222361,3,7,3.0,10,0.3
508222690,3,7,3.0,10,0.3
508305474,3,7,3.0,10,0.3
508305880,7,3,3.0,10,0.3
508312968,1,9,1.0,10,0.1
508314786,1,8,1.0,9,0.1111111111111111
508316690,5,5,5.0,10,0.5
508345493,3,6,3.0,9,0.3333333333333333
508348994,1,9,1.0,10,0.1
508362122,2,8,2.0,10,0.2
508379403,1,8,1.0,9,0.1111111111111111
508433400,2,6,2.0,8,0.25
508466277,8,2,2.0,10,0.2
508469967,1,9,1.0,10,0.1
508495211,8,2,2.0,10,0.2
508542154,16,4,4.0,20,0.2
508542273,8,2,2.0,10,0.2
508585571,1,8,1.0,9,0.1111111111111111
508661641,1,8,1.0,9,0.1111111111111111
508662372,2,8,2.0,10,0.2
508665329,3,6,3.0,9,0.3333333333333333
508684665,2,6,2.0,8,0.25
508684922,1,8,1.0,9,0.1111111111111111
508738032,2,18,2.0,20,0.1
508793411,4,6,4.0,10,0.4
508800848,1,8,1.0,9,0.1111111111111111
508801913,1,9,1.0,10,0.1
508807439,16,4,4.0,20,0.2
508812278,1,9,1.0,10,0.1
508814647,7,3,3.0,10,0.3
508831175,1,9,1.0,10,0.1
508848343,1,8,1.0,9,0.1111111111111111
508852538,4,4,4.0,8,0.5
508854646,3,7,3.0,10,0.3
508863000,2,8,2.0,10,0.2
508863285,4,4,4.0,8,0.5
508866570,7,2,2.0,9,0.2222222222222222
508866659,21,8,8.0,29,0.27586206896551724
508875459,2,6,2.0,8,0.25
508941909,2,16,2.0,18,0.1111111111111111
508948361,1,9,1.0,10,0.1
508951535,1,9,1.0,10,0.1
508951752,12,17,12.0,29,0.41379310344827586
508967448,6,3,3.0,9,0.3333333333333333
508981268,1,7,1.0,8,0.125
508983969,5,4,4.0,9,0.4444444444444444
508986940,1,8,1.0,9,0.1111111111111111
509016149,4,6,4.0,10,0.4
509041452,1,9,1.0,10,0.1
509051133,1,9,1.0,10,0.1
509079636,3,17,3.0,20,0.15
509084655,2,18,2.0,20,0.1
509104254,2,17,2.0,19,0.10526315789473684
509107227,9,1,1.0,10,0.1
509111626,1,9,1.0,10,0.1
509131311,3,6,3.0,9,0.3333333333333333
509131546,1,8,1.0,9,0.1111111111111111
509141160,2,7,2.0,9,0.2222222222222222
509144755,4,5,4.0,9,0.4444444444444444
509145339,1,9,1.0,10,0.1
509146701,5,4,4.0,9,0.4444444444444444
509234135,2,8,2.0,10,0.2
509260442,7,3,3.0,10,0.3
509276049,2,8,2.0,10,0.2
509311574,2,8,2.0,10,0.2
509352784,1,8,1.0,9,0.1111111111111111
509355127,7,3,3.0,10,0.3
509379327,2,7,2.0,9,0.2222222222222222
509379603,6,4,4.0,10,0.4
509426447,1,17,1.0,18,0.05555555555555555
509428061,1,9,1.0,10,0.1
509465935,8,1,1.0,9,0.1111111111111111
509474036,23,6,6.0,29,0.20689655172413793
509488333,1,9,1.0,10,0.1
509585260,1,8,1.0,9,0.1111111111111111
509591550,1,8,1.0,9,0.1111111111111111
509591689,2,7,2.0,9,0.2222222222222222
509608110,1,18,1.0,19,0.05263157894736842
509617231,1,9,1.0,10,0.1
509619779,1,9,1.0,10,0.1
509659018,2,8,2.0,10,0.2
509659063,8,2,2.0,10,0.2
509672993,1,8,1.0,9,0.1111111111111111
509702132,21,9,9.0,30,0.3
509752506,1,17,1.0,18,0.05555555555555555
509805042,1,8,1.0,9,0.1111111111111111
509806916,1,9,1.0,10,0.1
509810484,1,9,1.0,10,0.1
509813762,8,1,1.0,9,0.1111111111111111
509817394,1,9,1.0,10,0.1
509824256,1,19,1.0,20,0.05
509825684,1,8,1.0,9,0.1111111111111111
509871818,5,5,5.0,10,0.5
509872006,5,5,5.0,10,0.5
509872591,7,2,2.0,9,0.2222222222222222
509872943,2,8,2.0,10,0.2
509873712,22,4,4.0,26,0.15384615384615385
509874649,19,10,10.0,29,0.3448275862068966
509876336,3,6,3.0,9,0.3333333333333333
509897643,4,6,4.0,10,0.4
509944018,2,15,2.0,17,0.11764705882352941
509996408,1,9,1.0,10,0.1
509996768,2,28,2.0,30,0.06666666666666667
510014059,3,26,3.0,29,0.10344827586206896
510084605,2,7,2.0,9,0.2222222222222222
510087124,2,8,2.0,10,0.2
510110077,8,1,1.0,9,0.1111111111111111
510116182,5,5,5.0,10,0.5
510147232,11,14,11.0,25,0.44
510173167,2,7,2.0,9,0.2222222222222222
510207254,4,6,4.0,10,0.4
510208417,9,1,1.0,10,0.1
510209546,1,9,1.0,10,0.1
510224390,1,8,1.0,9,0.1111111111111111
510296035,1,9,1.0,10,0.1
510304001,4,14,4.0,18,0.2222222222222222
510337947,1,9,1.0,10,0.1
510339793,4,5,4.0,9,0.4444444444444444
510341582,5,5,5.0,10,0.5
510342170,1,18,1.0,19,0.05263157894736842
510343948,3,7,3.0,10,0.3
510347939,2,8,2.0,10,0.2
510363585,17,12,12.0,29,0.41379310344827586
510364126,1,9,1.0,10,0.1
510391828,2,8,2.0,10,0.2
510393977,4,5,4.0,9,0.4444444444444444
510399469,5,4,4.0,9,0.4444444444444444
510407926,1,18,1.0,19,0.05263157894736842
510456284,2,8,2.0,10,0.2
510466792,3,6,3.0,9,0.3333333333333333
510497344,2,7,2.0,9,0.2222222222222222
510531737,1,16,1.0,17,0.058823529411764705
510598127,6,4,4.0,10,0.4
510605427,4,6,4.0,10,0.4
510605845,19,1,1.0,20,0.05
510658820,3,6,3.0,9,0.3333333333333333
510689622,1,19,1.0,20,0.05
510727388,1,8,1.0,9,0.1111111111111111
510784740,1,9,1.0,10,0.1
510793731,1,7,1.0,8,0.125
510801028,2,6,2.0,8,0.25
510816550,1,8,1.0,9,0.1111111111111111
510821806,2,8,2.0,10,0.2
510827489,1,18,1.0,19,0.05263157894736842
510841169,7,3,3.0,10,0.3
510841381,13,5,5.0,18,0.2777777777777778
510841449,1,8,1.0,9,0.1111111111111111
510842957,13,15,13.0,28,0.4642857142857143
510859704,8,2,2.0,10,0.2
510940644,5,5,5.0,10,0.5
510944520,6,4,4.0,10,0.4
510958510,1,9,1.0,10,0.1
510974936,8,21,8.0,29,0.27586206896551724
510987429,1,9,1.0,10,0.1
511005677,2,7,2.0,9,0.2222222222222222
511025000,1,18,1.0,19,0.05263157894736842
511118207,1,9,1.0,10,0.1
511122050,5,5,5.0,10,0.5
511123995,3,7,3.0,10,0.3
511126269,3,7,3.0,10,0.3
511132548,4,6,4.0,10,0.4
511135493,3,6,3.0,9,0.3333333333333333
511136963,4,5,4.0,9,0.4444444444444444
511137857,2,7,2.0,9,0.2222222222222222
511143878,1,9,1.0,10,0.1
511147117,7,3,3.0,10,0.3
511152871,4,6,4.0,10,0.4
511153057,1,9,1.0,10,0.1
511153398,4,6,4.0,10,0.4
511193353,1,19,1.0,20,0.05
511228987,1,8,1.0,9,0.1111111111111111
511258126,7,3,3.0,10,0.3
511279908,1,8,1.0,9,0.1111111111111111
511302577,5,4,4.0,9,0.4444444444444444
511304108,1,9,1.0,10,0.1
511305130,2,8,2.0,10,0.2
511330107,4,6,4.0,10,0.4
511339064,1,9,1.0,10,0.1
511340071,3,16,3.0,19,0.15789473684210525
511353234,3,6,3.0,9,0.3333333333333333
511356215,1,9,1.0,10,0.1
511358253,2,8,2.0,10,0.2
511358549,1,16,1.0,17,0.058823529411764705
511370087,15,14,14.0,29,0.4827586206896552
511435112,2,8,2.0,10,0.2
511484921,7,2,2.0,9,0.2222222222222222
511544494,2,7,2.0,9,0.2222222222222222
511547342,7,2,2.0,9,0.2222222222222222
511560574,3,7,3.0,10,0.3
511705242,2,7,2.0,9,0.2222222222222222
511705388,2,8,2.0,10,0.2
511746550,1,7,1.0,8,0.125
511768142,1,9,1.0,10,0.1
511814234,7,3,3.0,10,0.3
511880391,1,9,1.0,10,0.1
511881368,1,9,1.0,10,0.1
511899829,2,17,2.0,19,0.10526315789473684
511900914,4,6,4.0,10,0.4
511901863,4,6,4.0,10,0.4
511947658,1,8,1.0,9,0.1111111111111111
511965082,1,18,1.0,19,0.05263157894736842
511972041,1,18,1.0,19,0.05263157894736842
511979827,8,2,2.0,10,0.2
512020924,1,8,1.0,9,0.1111111111111111
512047332,1,9,1.0,10,0.1
512077666,8,2,2.0,10,0.2
512090053,4,6,4.0,10,0.4
512090554,1,8,1.0,9,0.1111111111111111
512091530,4,6,4.0,10,0.4
512092943,3,7,3.0,10,0.3
512097359,7,3,3.0,10,0.3
512120051,4,6,4.0,10,0.4
512120121,4,24,4.0,28,0.14285714285714285
512120341,5,4,4.0,9,0.4444444444444444
512121819,2,8,2.0,10,0.2
512122628,1,8,1.0,9,0.1111111111111111
512123514,2,7,2.0,9,0.2222222222222222
512123676,3,7,3.0,10,0.3
512126120,2,16,2.0,18,0.1111111111111111
512206888,6,3,3.0,9,0.3333333333333333
512207631,8,2,2.0,10,0.2
512214487,5,3,3.0,8,0.375
512241315,8,2,2.0,10,0.2
512256817,1,9,1.0,10,0.1
512256990,19,9,9.0,28,0.32142857142857145
512279832,7,3,3.0,10,0.3
512280032,2,6,2.0,8,0.25
512281704,3,5,3.0,8,0.375
512284377,5,4,4.0,9,0.4444444444444444
512404489,1,9,1.0,10,0.1
512598819,5,5,5.0,10,0.5
512695605,1,7,1.0,8,0.125
512861990,1,9,1.0,10,0.1
512879162,1,7,1.0,8,0.125
512917950,6,3,3.0,9,0.3333333333333333
512918360,7,3,3.0,10,0.3
512946161,4,6,4.0,10,0.4
512946371,15,5,5.0,20,0.25
512999027,12,17,12.0,29,0.41379310344827586
513043799,3,7,3.0,10,0.3
513072093,1,9,1.0,10,0.1
513163846,1,8,1.0,9,0.1111111111111111
513171608,3,7,3.0,10,0.3
513259948,3,26,3.0,29,0.10344827586206896
513260177,1,8,1.0,9,0.1111111111111111
513299973,1,17,1.0,18,0.05555555555555555
513301849,8,19,8.0,27,0.2962962962962963
513304957,1,9,1.0,10,0.1
513394430,3,7,3.0,10,0.3
513442301,2,7,2.0,9,0.2222222222222222
513443723,6,4,4.0,10,0.4
513456888,4,5,4.0,9,0.4444444444444444
513457790,4,5,4.0,9,0.4444444444444444
513711732,1,18,1.0,19,0.05263157894736842
513764915,7,2,2.0,9,0.2222222222222222
513765246,2,8,2.0,10,0.2
513767211,4,5,4.0,9,0.4444444444444444
513769554,2,7,2.0,9,0.2222222222222222
513771049,1,18,1.0,19,0.05263157894736842
513772070,6,14,6.0,20,0.3
513774253,1,9,1.0,10,0.1
513819522,1,9,1.0,10,0.1
513831601,1,8,1.0,9,0.1111111111111111
513832828,2,17,2.0,19,0.10526315789473684
513858741,25,2,2.0,27,0.07407407407407407
513859626,5,5,5.0,10,0.5
513929308,4,6,4.0,10,0.4
513978803,4,6,4.0,10,0.4
514086875,6,4,4.0,10,0.4
514093014,2,8,2.0,10,0.2
514094701,6,3,3.0,9,0.3333333333333333
514168487,1,16,1.0,17,0.058823529411764705
514232731,1,9,1.0,10,0.1
514234606,3,6,3.0,9,0.3333333333333333
514235084,2,7,2.0,9,0.2222222222222222
514243009,1,9,1.0,10,0.1
514257650,3,15,3.0,18,0.16666666666666666
514268785,3,17,3.0,20,0.15
514293141,1,8,1.0,9,0.1111111111111111
514297058,3,5,3.0,8,0.375
514297288,1,9,1.0,10,0.1
514297521,5,5,5.0,10,0.5
514297785,15,11,11.0,26,0.4230769230769231
514298023,6,20,6.0,26,0.23076923076923078
514350997,2,7,2.0,9,0.2222222222222222
514351135,2,26,2.0,28,0.07142857142857142
514420966,7,3,3.0,10,0.3
514439114,2,7,2.0,9,0.2222222222222222
514442473,1,18,1.0,19,0.05263157894736842
514475118,7,3,3.0,10,0.3
514509676,2,18,2.0,20,0.1
514640304,3,25,3.0,28,0.10714285714285714
514683606,14,15,14.0,29,0.4827586206896552
514687645,4,4,4.0,8,0.5
514690371,3,25,3.0,28,0.10714285714285714
514690493,1,19,1.0,20,0.05
514698295,2,8,2.0,10,0.2
514723479,2,8,2.0,10,0.2
514725291,7,2,2.0,9,0.2222222222222222
514743328,1,9,1.0,10,0.1
514744480,1,7,1.0,8,0.125
514785855,2,7,2.0,9,0.2222222222222222
514788293,2,7,2.0,9,0.2222222222222222
514790442,2,24,2.0,26,0.07692307692307693
514793796,2,8,2.0,10,0.2
514794040,1,9,1.0,10,0.1
514797048,1,8,1.0,9,0.1111111111111111
514817453,1,8,1.0,9,0.1111111111111111
514822545,2,7,2.0,9,0.2222222222222222
514829551,2,7,2.0,9,0.2222222222222222
514830037,4,6,4.0,10,0.4
514832388,2,8,2.0,10,0.2
514834672,5,5,5.0,10,0.5
514855882,10,19,10.0,29,0.3448275862068966
514903739,3,5,3.0,8,0.375
514906392,1,9,1.0,10,0.1
514930445,2,8,2.0,10,0.2
515000577,8,2,2.0,10,0.2
515000685,5,5,5.0,10,0.5
515000730,8,2,2.0,10,0.2
515000787,9,1,1.0,10,0.1
515022344,7,2,2.0,9,0.2222222222222222
515035544,2,8,2.0,10,0.2
515043812,7,3,3.0,10,0.3
515088890,2,8,2.0,10,0.2
515089713,8,1,1.0,9,0.1111111111111111
515191142,1,8,1.0,9,0.1111111111111111
515193093,1,28,1.0,29,0.034482758620689655
515205376,2,8,2.0,10,0.2
515216909,3,7,3.0,10,0.3
515226957,8,2,2.0,10,0.2
515227516,2,7,2.0,9,0.2222222222222222
515227912,1,9,1.0,10,0.1
515228072,2,8,2.0,10,0.2
515231370,2,8,2.0,10,0.2
515247765,7,3,3.0,10,0.3
515251872,7,2,2.0,9,0.2222222222222222
515269819,3,6,3.0,9,0.3333333333333333
515280387,2,8,2.0,10,0.2
515282683,4,5,4.0,9,0.4444444444444444
515307144,6,12,6.0,18,0.3333333333333333
515326683,9,1,1.0,10,0.1
515331169,1,8,1.0,9,0.1111111111111111
515333706,1,9,1.0,10,0.1
515338557,2,8,2.0,10,0.2
515366630,1,9,1.0,10,0.1
515378585,1,8,1.0,9,0.1111111111111111
515384915,8,2,2.0,10,0.2
515399455,1,9,1.0,10,0.1
515440569,1,9,1.0,10,0.1
515460701,1,18,1.0,19,0.05263157894736842
515467433,1,17,1.0,18,0.05555555555555555
515481911,1,19,1.0,20,0.05
515569590,1,9,1.0,10,0.1
515570539,1,8,1.0,9,0.1111111111111111
515571181,1,9,1.0,10,0.1
515573137,2,8,2.0,10,0.2
515574798,3,26,3.0,29,0.10344827586206896
515578857,3,6,3.0,9,0.3333333333333333
515579333,9,1,1.0,10,0.1
515675588,1,19,1.0,20,0.05
515679618,4,6,4.0,10,0.4
515694630,1,18,1.0,19,0.05263157894736842
515831290,3,7,3.0,10,0.3
515856606,3,17,3.0,20,0.15
515866565,5,5,5.0,10,0.5
515868846,1,8,1.0,9,0.1111111111111111
515870997,2,6,2.0,8,0.25
515875591,1,9,1.0,10,0.1
515901724,1,7,1.0,8,0.125
515908506,1,9,1.0,10,0.1
515909378,4,25,4.0,29,0.13793103448275862
515909850,1,9,1.0,10,0.1
515911016,1,9,1.0,10,0.1
515917838,1,9,1.0,10,0.1
515918587,5,5,5.0,10,0.5
515946958,3,7,3.0,10,0.3
515949799,1,9,1.0,10,0.1
515952299,1,8,1.0,9,0.1111111111111111
515978706,1,8,1.0,9,0.1111111111111111
516020213,2,7,2.0,9,0.2222222222222222
516020681,2,8,2.0,10,0.2
516027847,2,18,2.0,20,0.1
516057798,6,4,4.0,10,0.4
516064428,7,1,1.0,8,0.125
516090601,1,9,1.0,10,0.1
516117509,8,2,2.0,10,0.2
516118099,9,1,1.0,10,0.1
516119736,4,5,4.0,9,0.4444444444444444
516139783,1,9,1.0,10,0.1
516159035,1,9,1.0,10,0.1
516164181,8,2,2.0,10,0.2
516165786,9,1,1.0,10,0.1
516174164,4,24,4.0,28,0.14285714285714285
516187314,3,26,3.0,29,0.10344827586206896
516188700,2,8,2.0,10,0.2
516198597,2,8,2.0,10,0.2
516224016,1,9,1.0,10,0.1
516234625,3,7,3.0,10,0.3
516251155,1,9,1.0,10,0.1
516260464,1,9,1.0,10,0.1
516263336,6,3,3.0,9,0.3333333333333333
516271018,1,8,1.0,9,0.1111111111111111
516271776,1,8,1.0,9,0.1111111111111111
516271962,1,9,1.0,10,0.1
516350647,3,7,3.0,10,0.3
516352919,1,9,1.0,10,0.1
516364608,1,9,1.0,10,0.1
516371928,1,9,1.0,10,0.1
516372025,3,7,3.0,10,0.3
516373311,1,9,1.0,10,0.1
516385775,9,1,1.0,10,0.1
516389199,2,8,2.0,10,0.2
516390078,4,5,4.0,9,0.4444444444444444
516390608,1,8,1.0,9,0.1111111111111111
516400906,7,2,2.0,9,0.2222222222222222
516421669,1,7,1.0,8,0.125
516428117,8,2,2.0,10,0.2
516428339,9,1,1.0,10,0.1
516434336,9,1,1.0,10,0.1
516434507,9,1,1.0,10,0.1
516451558,2,7,2.0,9,0.2222222222222222
516452476,1,9,1.0,10,0.1
516466009,5,5,5.0,10,0.5
516475610,1,19,1.0,20,0.05
516481459,1,9,1.0,10,0.1
516481994,3,6,3.0,9,0.3333333333333333
516483807,3,6,3.0,9,0.3333333333333333
516486468,1,9,1.0,10,0.1
516488709,4,5,4.0,9,0.4444444444444444
516490298,2,7,2.0,9,0.2222222222222222
516493160,3,7,3.0,10,0.3
516622278,5,23,5.0,28,0.17857142857142858
516646182,1,19,1.0,20,0.05
516654498,2,7,2.0,9,0.2222222222222222
516696557,1,7,1.0,8,0.125
516698526,2,6,2.0,8,0.25
516705409,2,8,2.0,10,0.2
516708355,1,8,1.0,9,0.1111111111111111
516712344,1,9,1.0,10,0.1
516737384,4,6,4.0,10,0.4
516773553,1,7,1.0,8,0.125
516778118,2,7,2.0,9,0.2222222222222222
516820548,1,7,1.0,8,0.125
516826598,4,5,4.0,9,0.4444444444444444
516850854,1,8,1.0,9,0.1111111111111111
516853314,2,7,2.0,9,0.2222222222222222
516856223,2,7,2.0,9,0.2222222222222222
516868610,4,5,4.0,9,0.4444444444444444
516869856,15,14,14.0,29,0.4827586206896552
516871189,5,5,5.0,10,0.5
516929995,2,8,2.0,10,0.2
516983088,3,7,3.0,10,0.3
516983140,7,2,2.0,9,0.2222222222222222
516983664,8,2,2.0,10,0.2
517051388,1,18,1.0,19,0.05263157894736842
517064375,2,7,2.0,9,0.2222222222222222
517064924,3,7,3.0,10,0.3
517066274,3,7,3.0,10,0.3
517074728,1,9,1.0,10,0.1
517083089,1,9,1.0,10,0.1
517389481,1,9,1.0,10,0.1
517407472,1,9,1.0,10,0.1
517422393,9,1,1.0,10,0.1
517425977,2,8,2.0,10,0.2
517492842,2,18,2.0,20,0.1
517497450,1,19,1.0,20,0.05
517518221,1,19,1.0,20,0.05
517529316,1,16,1.0,17,0.058823529411764705
517642275,1,17,1.0,18,0.05555555555555555
517646552,2,8,2.0,10,0.2
517789897,2,7,2.0,9,0.2222222222222222
517806115,1,9,1.0,10,0.1
517812636,1,9,1.0,10,0.1
517823046,2,17,2.0,19,0.10526315789473684
517830392,1,17,1.0,18,0.05555555555555555
517848631,2,7,2.0,9,0.2222222222222222
517864766,1,8,1.0,9,0.1111111111111111
517905792,2,17,2.0,19,0.10526315789473684
517955961,1,19,1.0,20,0.05
517968151,3,7,3.0,10,0.3
517971760,1,9,1.0,10,0.1
517983052,4,6,4.0,10,0.4
518037119,1,18,1.0,19,0.05263157894736842
518060330,2,8,2.0,10,0.2
518160989,2,8,2.0,10,0.2
518163594,8,1,1.0,9,0.1111111111111111
518163854,4,4,4.0,8,0.5
518183532,1,8,1.0,9,0.1111111111111111
518332597,1,9,1.0,10,0.1
518352417,3,7,3.0,10,0.3
518355072,3,7,3.0,10,0.3
518356461,2,8,2.0,10,0.2
518414967,1,7,1.0,8,0.125
518427448,2,8,2.0,10,0.2
518437441,4,15,4.0,19,0.21052631578947367
518440784,3,11,3.0,14,0.21428571428571427
518440858,4,6,4.0,10,0.4
518489209,1,18,1.0,19,0.05263157894736842
518490084,6,2,2.0,8,0.25
518494204,9,1,1.0,10,0.1
518497144,2,28,2.0,30,0.06666666666666667
518497557,3,7,3.0,10,0.3
518498769,5,25,5.0,30,0.16666666666666666
518501051,2,7,2.0,9,0.2222222222222222
518501480,6,4,4.0,10,0.4
518507280,3,7,3.0,10,0.3
518520020,1,9,1.0,10,0.1
518557394,1,26,1.0,27,0.037037037037037035
518564505,3,7,3.0,10,0.3
518566401,1,9,1.0,10,0.1
518575511,1,9,1.0,10,0.1
518578234,3,6,3.0,9,0.3333333333333333
518579841,1,8,1.0,9,0.1111111111111111
518723391,1,9,1.0,10,0.1
518745036,6,4,4.0,10,0.4
518748559,1,9,1.0,10,0.1
518801248,8,2,2.0,10,0.2
518803782,1,7,1.0,8,0.125
518828047,2,27,2.0,29,0.06896551724137931
518836323,3,7,3.0,10,0.3
518837192,2,8,2.0,10,0.2
518879636,2,8,2.0,10,0.2
518880461,2,8,2.0,10,0.2
518881120,1,8,1.0,9,0.1111111111111111
518882142,2,8,2.0,10,0.2
518894225,6,3,3.0,9,0.3333333333333333
518897150,1,9,1.0,10,0.1
518902609,1,8,1.0,9,0.1111111111111111
518916247,5,15,5.0,20,0.25
518933551,3,7,3.0,10,0.3
518969462,1,18,1.0,19,0.05263157894736842
518998959,1,8,1.0,9,0.1111111111111111
518999012,2,7,2.0,9,0.2222222222222222
519090516,1,9,1.0,10,0.1
519090643,2,8,2.0,10,0.2
519105647,1,9,1.0,10,0.1
519168716,1,18,1.0,19,0.05263157894736842
519254370,1,7,1.0,8,0.125
519263265,2,8,2.0,10,0.2
519317814,1,9,1.0,10,0.1
519331322,1,18,1.0,19,0.05263157894736842
519406633,1,9,1.0,10,0.1
519445505,19,10,10.0,29,0.3448275862068966
519507168,2,8,2.0,10,0.2
519541706,1,7,1.0,8,0.125
519541785,2,8,2.0,10,0.2
519556118,2,8,2.0,10,0.2
519571837,2,8,2.0,10,0.2
519609758,1,9,1.0,10,0.1
519615386,6,4,4.0,10,0.4
519652493,1,8,1.0,9,0.1111111111111111
519663766,1,9,1.0,10,0.1
519678019,2,8,2.0,10,0.2
519822449,4,5,4.0,9,0.4444444444444444
519823419,4,5,4.0,9,0.4444444444444444
519829174,5,3,3.0,8,0.375
519830288,3,6,3.0,9,0.3333333333333333
519838439,1,8,1.0,9,0.1111111111111111
519868351,1,9,1.0,10,0.1
519876317,1,19,1.0,20,0.05
519930844,4,5,4.0,9,0.4444444444444444
519941417,1,9,1.0,10,0.1
519980649,1,8,1.0,9,0.1111111111111111
520054837,6,4,4.0,10,0.4
520055285,20,8,8.0,28,0.2857142857142857
520055307,5,5,5.0,10,0.5
520139626,1,9,1.0,10,0.1
520170008,2,8,2.0,10,0.2
520171374,1,9,1.0,10,0.1
520184184,2,8,2.0,10,0.2
520253522,2,24,2.0,26,0.07692307692307693
520255783,2,7,2.0,9,0.2222222222222222
520292750,2,16,2.0,18,0.1111111111111111
520307594,3,7,3.0,10,0.3
520323777,2,7,2.0,9,0.2222222222222222
520403819,4,6,4.0,10,0.4
520404053,1,8,1.0,9,0.1111111111111111
520404231,7,3,3.0,10,0.3
520404436,1,9,1.0,10,0.1
520422098,1,18,1.0,19,0.05263157894736842
520422176,2,8,2.0,10,0.2
520424258,3,7,3.0,10,0.3
520452420,1,17,1.0,18,0.05555555555555555
520483669,3,13,3.0,16,0.1875
520501527,1,7,1.0,8,0.125
520517875,7,3,3.0,10,0.3
520535984,1,7,1.0,8,0.125
520577268,1,9,1.0,10,0.1
520600331,4,5,4.0,9,0.4444444444444444
520619380,2,18,2.0,20,0.1
520768513,2,8,2.0,10,0.2
520778979,1,18,1.0,19,0.05263157894736842
520789534,3,6,3.0,9,0.3333333333333333
520803146,3,7,3.0,10,0.3
520827863,2,6,2.0,8,0.25
520843923,1,8,1.0,9,0.1111111111111111
520867321,1,8,1.0,9,0.1111111111111111
520875373,2,8,2.0,10,0.2
520889078,6,4,4.0,10,0.4
520918558,1,8,1.0,9,0.1111111111111111
520975500,1,8,1.0,9,0.1111111111111111
521006842,1,9,1.0,10,0.1
521010319,2,7,2.0,9,0.2222222222222222
521035852,2,18,2.0,20,0.1
521067816,2,8,2.0,10,0.2
521078286,4,5,4.0,9,0.4444444444444444
521116241,6,3,3.0,9,0.3333333333333333
521127263,1,7,1.0,8,0.125
521157183,1,9,1.0,10,0.1
521180447,12,7,7.0,19,0.3684210526315789
521277884,8,1,1.0,9,0.1111111111111111
521279360,7,2,2.0,9,0.2222222222222222
521279739,6,4,4.0,10,0.4
521284893,1,9,1.0,10,0.1
521285195,2,8,2.0,10,0.2
521308195,1,9,1.0,10,0.1
521332944,6,4,4.0,10,0.4
521347876,2,8,2.0,10,0.2
521348190,3,7,3.0,10,0.3
521372539,1,17,1.0,18,0.05555555555555555
521419947,1,9,1.0,10,0.1
521429546,3,7,3.0,10,0.3
521430913,8,1,1.0,9,0.1111111111111111
521434657,1,9,1.0,10,0.1
521436229,4,6,4.0,10,0.4
521445104,5,5,5.0,10,0.5
521448583,2,8,2.0,10,0.2
521449084,1,9,1.0,10,0.1
521450780,2,7,2.0,9,0.2222222222222222
521510309,1,8,1.0,9,0.1111111111111111
521510612,1,8,1.0,9,0.1111111111111111
521543818,9,1,1.0,10,0.1
521553338,4,6,4.0,10,0.4
521554140,9,1,1.0,10,0.1
521554891,5,5,5.0,10,0.5
521560919,1,18,1.0,19,0.05263157894736842
521579089,7,3,3.0,10,0.3
521618549,1,7,1.0,8,0.125
521641542,2,8,2.0,10,0.2
521716699,5,5,5.0,10,0.5
521789654,16,13,13.0,29,0.4482758620689655
521813911,1,9,1.0,10,0.1
521814072,1,9,1.0,10,0.1
521829307,1,7,1.0,8,0.125
521852041,1,8,1.0,9,0.1111111111111111
521852305,5,5,5.0,10,0.5
521852842,3,7,3.0,10,0.3
521886811,4,6,4.0,10,0.4
521887374,1,8,1.0,9,0.1111111111111111
521889324,2,7,2.0,9,0.2222222222222222
521913735,7,2,2.0,9,0.2222222222222222
521925054,1,9,1.0,10,0.1
521927033,1,8,1.0,9,0.1111111111111111
521986974,14,5,5.0,19,0.2631578947368421
521994468,4,6,4.0,10,0.4
522012994,1,19,1.0,20,0.05
522014463,2,8,2.0,10,0.2
522025088,3,6,3.0,9,0.3333333333333333
522025350,1,8,1.0,9,0.1111111111111111
522056935,7,1,1.0,8,0.125
522057206,7,1,1.0,8,0.125
522074074,2,8,2.0,10,0.2
522078430,3,7,3.0,10,0.3
522081898,1,9,1.0,10,0.1
522099972,6,4,4.0,10,0.4
522114941,6,4,4.0,10,0.4
522128070,6,4,4.0,10,0.4
522142004,5,5,5.0,10,0.5
522173595,2,8,2.0,10,0.2
522173827,3,6,3.0,9,0.3333333333333333
522174176,9,1,1.0,10,0.1
522174356,7,3,3.0,10,0.3
522174511,6,22,6.0,28,0.21428571428571427
522243212,1,8,1.0,9,0.1111111111111111
522270714,2,8,2.0,10,0.2
522307404,8,1,1.0,9,0.1111111111111111
522343597,8,11,8.0,19,0.42105263157894735
522344581,5,5,5.0,10,0.5
522353422,1,8,1.0,9,0.1111111111111111
522367261,1,18,1.0,19,0.05263157894736842
522374475,2,6,2.0,8,0.25
522387633,9,1,1.0,10,0.1
522442657,1,9,1.0,10,0.1
522467109,1,17,1.0,18,0.05555555555555555
522487098,9,9,9.0,18,0.5
522605180,2,8,2.0,10,0.2
522623573,2,8,2.0,10,0.2
522664994,5,14,5.0,19,0.2631578947368421
522665609,2,8,2.0,10,0.2
522678021,3,7,3.0,10,0.3
522680052,1,9,1.0,10,0.1
522695227,2,8,2.0,10,0.2
522700146,3,6,3.0,9,0.3333333333333333
522725029,3,6,3.0,9,0.3333333333333333
522741367,1,9,1.0,10,0.1
522793716,1,8,1.0,9,0.1111111111111111
522864363,1,8,1.0,9,0.1111111111111111
522880722,8,2,2.0,10,0.2
522931111,5,5,5.0,10,0.5
522937511,8,2,2.0,10,0.2
523036976,3,7,3.0,10,0.3
523074014,4,6,4.0,10,0.4
523089371,1,9,1.0,10,0.1
523098145,6,3,3.0,9,0.3333333333333333
523111111,1,7,1.0,8,0.125
523134635,4,6,4.0,10,0.4
523142021,3,7,3.0,10,0.3
523142861,3,7,3.0,10,0.3
523149409,1,9,1.0,10,0.1
523152087,3,15,3.0,18,0.16666666666666666
523161067,4,6,4.0,10,0.4
523274666,6,24,6.0,30,0.2
523279550,1,9,1.0,10,0.1
523288032,15,14,14.0,29,0.4827586206896552
523288255,2,8,2.0,10,0.2
523350036,3,7,3.0,10,0.3
523371336,1,9,1.0,10,0.1
523415584,1,8,1.0,9,0.1111111111111111
523416382,3,7,3.0,10,0.3
523431491,1,8,1.0,9,0.1111111111111111
523443468,1,9,1.0,10,0.1
523461226,1,9,1.0,10,0.1
523533227,9,1,1.0,10,0.1
523534403,1,9,1.0,10,0.1
523539101,1,9,1.0,10,0.1
523608097,3,5,3.0,8,0.375
523624614,5,24,5.0,29,0.1724137931034483
523637039,1,9,1.0,10,0.1
523656538,1,8,1.0,9,0.1111111111111111
523672783,3,6,3.0,9,0.3333333333333333
523673532,1,8,1.0,9,0.1111111111111111
523676914,7,3,3.0,10,0.3
523677665,1,18,1.0,19,0.05263157894736842
523686728,8,1,1.0,9,0.1111111111111111
523762143,5,5,5.0,10,0.5
523770575,2,8,2.0,10,0.2
523772897,3,7,3.0,10,0.3
523773854,5,4,4.0,9,0.4444444444444444
523775992,1,9,1.0,10,0.1
523776151,1,9,1.0,10,0.1
523781633,5,4,4.0,9,0.4444444444444444
523782236,22,5,5.0,27,0.18518518518518517
523872181,1,9,1.0,10,0.1
523882518,9,1,1.0,10,0.1
523883181,1,9,1.0,10,0.1
523892494,2,8,2.0,10,0.2
523936136,1,8,1.0,9,0.1111111111111111
523942021,4,5,4.0,9,0.4444444444444444
523942166,1,17,1.0,18,0.05555555555555555
523944359,2,26,2.0,28,0.07142857142857142
523984546,2,18,2.0,20,0.1
524015981,5,5,5.0,10,0.5
524016665,1,9,1.0,10,0.1
524017889,2,8,2.0,10,0.2
524020542,1,8,1.0,9,0.1111111111111111
524033253,1,9,1.0,10,0.1
524034267,1,8,1.0,9,0.1111111111111111
524082832,1,9,1.0,10,0.1
524109431,9,1,1.0,10,0.1
524206719,2,8,2.0,10,0.2
524207342,4,6,4.0,10,0.4
524243926,1,27,1.0,28,0.03571428571428571
524272726,7,13,7.0,20,0.35
524279936,1,9,1.0,10,0.1
524311805,26,3,3.0,29,0.10344827586206896
524404817,1,18,1.0,19,0.05263157894736842
524428570,2,8,2.0,10,0.2
524437213,2,17,2.0,19,0.10526315789473684
524451880,2,8,2.0,10,0.2
524459470,1,9,1.0,10,0.1
524469353,3,6,3.0,9,0.3333333333333333
524474136,1,9,1.0,10,0.1
524532869,1,14,1.0,15,0.06666666666666667
524536315,3,5,3.0,8,0.375
524536469,11,17,11.0,28,0.39285714285714285
524541242,2,8,2.0,10,0.2
524580841,4,6,4.0,10,0.4
524581294,3,7,3.0,10,0.3
524582006,8,1,1.0,9,0.1111111111111111
524582306,9,1,1.0,10,0.1
524584186,4,6,4.0,10,0.4
524676352,1,18,1.0,19,0.05263157894736842
524715207,1,9,1.0,10,0.1
524716800,1,9,1.0,10,0.1
524736999,1,8,1.0,9,0.1111111111111111
524741935,6,3,3.0,9,0.3333333333333333
524783137,1,9,1.0,10,0.1
524873111,9,1,1.0,10,0.1
524874237,8,1,1.0,9,0.1111111111111111
524875200,8,1,1.0,9,0.1111111111111111
524875612,25,5,5.0,30,0.16666666666666666
524875701,29,1,1.0,30,0.03333333333333333
525014595,2,8,2.0,10,0.2
525016140,1,8,1.0,9,0.1111111111111111
525020625,5,4,4.0,9,0.4444444444444444
525021089,6,4,4.0,10,0.4
525022336,6,4,4.0,10,0.4
525035285,3,6,3.0,9,0.3333333333333333
525055093,6,3,3.0,9,0.3333333333333333
525059776,8,2,2.0,10,0.2
525092235,1,8,1.0,9,0.1111111111111111
525092518,1,8,1.0,9,0.1111111111111111
525116632,5,5,5.0,10,0.5
525120944,3,7,3.0,10,0.3
525144611,4,24,4.0,28,0.14285714285714285
525178334,7,3,3.0,10,0.3
525178454,1,8,1.0,9,0.1111111111111111
525179810,3,6,3.0,9,0.3333333333333333
525203955,1,8,1.0,9,0.1111111111111111
525219213,8,2,2.0,10,0.2
525221205,4,5,4.0,9,0.4444444444444444
525226214,1,8,1.0,9,0.1111111111111111
525227152,1,9,1.0,10,0.1
525229664,5,4,4.0,9,0.4444444444444444
525230040,7,2,2.0,9,0.2222222222222222
525254481,2,8,2.0,10,0.2
525255977,4,6,4.0,10,0.4
525291498,2,8,2.0,10,0.2
525338562,10,9,9.0,19,0.47368421052631576
525356369,4,6,4.0,10,0.4
525357023,8,2,2.0,10,0.2
525358955,1,27,1.0,28,0.03571428571428571
525428692,1,9,1.0,10,0.1
525428857,1,9,1.0,10,0.1
525457407,1,9,1.0,10,0.1
525459988,1,9,1.0,10,0.1
525466268,1,9,1.0,10,0.1
525505935,15,12,12.0,27,0.4444444444444444
525506523,3,7,3.0,10,0.3
525506681,1,7,1.0,8,0.125
525522929,4,6,4.0,10,0.4
525534997,7,3,3.0,10,0.3
525538841,1,9,1.0,10,0.1
525542550,4,5,4.0,9,0.4444444444444444
525546431,1,9,1.0,10,0.1
525629541,1,18,1.0,19,0.05263157894736842
525722686,1,9,1.0,10,0.1
525775864,25,4,4.0,29,0.13793103448275862
525813787,1,8,1.0,9,0.1111111111111111
525818138,3,6,3.0,9,0.3333333333333333
525820859,4,5,4.0,9,0.4444444444444444
525852441,1,9,1.0,10,0.1
525895224,1,16,1.0,17,0.058823529411764705
525902052,4,6,4.0,10,0.4
525902465,5,5,5.0,10,0.5
525919777,2,18,2.0,20,0.1
525965383,1,9,1.0,10,0.1
525983968,2,8,2.0,10,0.2
525997157,1,8,1.0,9,0.1111111111111111
525997784,1,19,1.0,20,0.05
525998135,1,9,1.0,10,0.1
526049616,3,6,3.0,9,0.3333333333333333
526051981,6,21,6.0,27,0.2222222222222222
526054057,2,26,2.0,28,0.07142857142857142
526077259,2,28,2.0,30,0.06666666666666667
526082267,3,24,3.0,27,0.1111111111111111
526082846,1,9,1.0,10,0.1
526083433,1,9,1.0,10,0.1
526086593,1,27,1.0,28,0.03571428571428571
526086862,2,8,2.0,10,0.2
526088087,6,23,6.0,29,0.20689655172413793
526093617,2,7,2.0,9,0.2222222222222222
526096037,1,9,1.0,10,0.1
526102098,9,1,1.0,10,0.1
526103159,6,3,3.0,9,0.3333333333333333
526108534,5,4,4.0,9,0.4444444444444444
526128682,3,6,3.0,9,0.3333333333333333
526129695,3,7,3.0,10,0.3
526136359,3,7,3.0,10,0.3
526141457,15,10,10.0,25,0.4
526178325,22,7,7.0,29,0.2413793103448276
526182367,1,8,1.0,9,0.1111111111111111
526264549,1,9,1.0,10,0.1
526281733,3,7,3.0,10,0.3
526285954,2,16,2.0,18,0.1111111111111111
526338017,3,26,3.0,29,0.10344827586206896
526356204,1,9,1.0,10,0.1
526410785,5,22,5.0,27,0.18518518518518517
526428957,3,7,3.0,10,0.3
526439684,4,6,4.0,10,0.4
526439928,1,8,1.0,9,0.1111111111111111
526441261,2,27,2.0,29,0.06896551724137931
526456455,6,4,4.0,10,0.4
526456809,4,5,4.0,9,0.4444444444444444
526474954,7,2,2.0,9,0.2222222222222222
526478117,2,7,2.0,9,0.2222222222222222
526478959,3,17,3.0,20,0.15
526487364,3,6,3.0,9,0.3333333333333333
526494276,1,9,1.0,10,0.1
526514033,5,15,5.0,20,0.25
526523729,6,4,4.0,10,0.4
526606803,8,2,2.0,10,0.2
526607334,5,5,5.0,10,0.5
526607659,6,3,3.0,9,0.3333333333333333
526607875,6,23,6.0,29,0.20689655172413793
526613023,2,8,2.0,10,0.2
526642890,1,8,1.0,9,0.1111111111111111
526747260,1,16,1.0,17,0.058823529411764705
526752177,4,6,4.0,10,0.4
526758763,1,19,1.0,20,0.05
526765376,1,9,1.0,10,0.1
526807434,4,6,4.0,10,0.4
526808131,2,8,2.0,10,0.2
526810234,21,6,6.0,27,0.2222222222222222
526811265,5,5,5.0,10,0.5
526812289,1,8,1.0,9,0.1111111111111111
526826923,1,9,1.0,10,0.1
526869882,3,6,3.0,9,0.3333333333333333
526932681,1,9,1.0,10,0.1
526934699,2,8,2.0,10,0.2
526980419,2,7,2.0,9,0.2222222222222222
527040545,3,7,3.0,10,0.3
527043323,4,6,4.0,10,0.4
527069154,1,9,1.0,10,0.1
527084819,1,9,1.0,10,0.1
527087747,8,1,1.0,9,0.1111111111111111
527088367,7,2,2.0,9,0.2222222222222222
527169960,9,1,1.0,10,0.1
527182804,5,3,3.0,8,0.375
527211434,4,6,4.0,10,0.4
527213683,3,7,3.0,10,0.3
527215696,4,6,4.0,10,0.4
527216675,7,2,2.0,9,0.2222222222222222
527227775,5,4,4.0,9,0.4444444444444444
527229226,2,8,2.0,10,0.2
527238347,1,7,1.0,8,0.125
527241171,2,8,2.0,10,0.2
527242830,7,1,1.0,8,0.125
527260803,4,6,4.0,10,0.4
527269815,1,8,1.0,9,0.1111111111111111
527272736,3,6,3.0,9,0.3333333333333333
527319773,1,9,1.0,10,0.1
527321940,3,6,3.0,9,0.3333333333333333
527337857,2,8,2.0,10,0.2
527375266,1,18,1.0,19,0.05263157894736842
527471505,2,7,2.0,9,0.2222222222222222
527477755,1,9,1.0,10,0.1
527482383,3,6,3.0,9,0.3333333333333333
527496223,2,8,2.0,10,0.2
527506587,1,8,1.0,9,0.1111111111111111
527506971,2,26,2.0,28,0.07142857142857142
527572302,1,9,1.0,10,0.1
527584035,1,9,1.0,10,0.1
527591955,1,8,1.0,9,0.1111111111111111
527595083,1,9,1.0,10,0.1
527602882,5,4,4.0,9,0.4444444444444444
527607085,1,9,1.0,10,0.1
527608414,2,7,2.0,9,0.2222222222222222
527609329,2,8,2.0,10,0.2
527612270,1,9,1.0,10,0.1
527614972,1,7,1.0,8,0.125
527615330,1,8,1.0,9,0.1111111111111111
527622148,2,7,2.0,9,0.2222222222222222
527680145,2,7,2.0,9,0.2222222222222222
527682249,1,19,1.0,20,0.05
527703710,3,6,3.0,9,0.3333333333333333
527703946,1,9,1.0,10,0.1
527708015,2,7,2.0,9,0.2222222222222222
527713844,8,2,2.0,10,0.2
527751539,9,1,1.0,10,0.1
527754062,1,8,1.0,9,0.1111111111111111
527757841,1,18,1.0,19,0.05263157894736842
527778902,4,5,4.0,9,0.4444444444444444
527826157,2,8,2.0,10,0.2
527827620,1,9,1.0,10,0.1
527828622,1,9,1.0,10,0.1
527829012,1,9,1.0,10,0.1
527837639,2,15,2.0,17,0.11764705882352941
527840001,2,7,2.0,9,0.2222222222222222
528052677,8,2,2.0,10,0.2
528122749,2,8,2.0,10,0.2
528123067,4,20,4.0,24,0.16666666666666666
528154409,1,17,1.0,18,0.05555555555555555
528159987,9,1,1.0,10,0.1
528172904,6,4,4.0,10,0.4
528186809,6,4,4.0,10,0.4
528187898,5,5,5.0,10,0.5
528192961,1,9,1.0,10,0.1
528194499,2,7,2.0,9,0.2222222222222222
528221043,4,15,4.0,19,0.21052631578947367
528255364,1,8,1.0,9,0.1111111111111111
528263088,2,17,2.0,19,0.10526315789473684
528287245,6,4,4.0,10,0.4
528310942,1,19,1.0,20,0.05
528324469,7,2,2.0,9,0.2222222222222222
528325284,1,8,1.0,9,0.1111111111111111
528331174,1,18,1.0,19,0.05263157894736842
528386390,3,7,3.0,10,0.3
528402516,3,24,3.0,27,0.1111111111111111
528402668,2,6,2.0,8,0.25
528406730,1,8,1.0,9,0.1111111111111111
528426149,9,10,9.0,19,0.47368421052631576
528426362,1,9,1.0,10,0.1
528427137,4,5,4.0,9,0.4444444444444444
528427271,7,3,3.0,10,0.3
528427363,5,5,5.0,10,0.5
528427926,7,2,2.0,9,0.2222222222222222
528455784,2,8,2.0,10,0.2
528482383,7,13,7.0,20,0.35
528488222,1,9,1.0,10,0.1
528496253,3,6,3.0,9,0.3333333333333333
528497317,4,15,4.0,19,0.21052631578947367
528498504,5,4,4.0,9,0.4444444444444444
528506527,1,9,1.0,10,0.1
528527247,6,3,3.0,9,0.3333333333333333
528529346,22,5,5.0,27,0.18518518518518517
528610818,6,3,3.0,9,0.3333333333333333
528611341,5,23,5.0,28,0.17857142857142858
528616947,1,9,1.0,10,0.1
528644105,1,16,1.0,17,0.058823529411764705
528663281,2,7,2.0,9,0.2222222222222222
528663474,1,9,1.0,10,0.1
528671166,4,6,4.0,10,0.4
528671969,2,7,2.0,9,0.2222222222222222
528673226,1,9,1.0,10,0.1
528674083,1,7,1.0,8,0.125
528680250,4,6,4.0,10,0.4
528704848,5,14,5.0,19,0.2631578947368421
528711918,2,17,2.0,19,0.10526315789473684
528727118,9,1,1.0,10,0.1
528729397,2,7,2.0,9,0.2222222222222222
528761049,1,19,1.0,20,0.05
528766452,1,9,1.0,10,0.1
528766579,1,19,1.0,20,0.05
528772341,1,9,1.0,10,0.1
528803133,8,2,2.0,10,0.2
528819535,1,9,1.0,10,0.1
528819739,11,19,11.0,30,0.36666666666666664
528823475,5,25,5.0,30,0.16666666666666666
528849419,8,2,2.0,10,0.2
528882999,9,1,1.0,10,0.1
528892448,3,6,3.0,9,0.3333333333333333
528893226,4,5,4.0,9,0.4444444444444444
528937096,10,9,9.0,19,0.47368421052631576
528991768,1,9,1.0,10,0.1
528991864,7,3,3.0,10,0.3
529023255,1,8,1.0,9,0.1111111111111111
529038270,2,7,2.0,9,0.2222222222222222
529049526,4,6,4.0,10,0.4
529058094,1,8,1.0,9,0.1111111111111111
529108153,1,9,1.0,10,0.1
529149476,2,8,2.0,10,0.2
529167801,4,6,4.0,10,0.4
529185684,4,6,4.0,10,0.4
529186350,1,9,1.0,10,0.1
529187796,16,13,13.0,29,0.4482758620689655
529210115,1,9,1.0,10,0.1
529212328,1,8,1.0,9,0.1111111111111111
529213145,3,6,3.0,9,0.3333333333333333
529213842,1,8,1.0,9,0.1111111111111111
529265793,1,9,1.0,10,0.1
529303967,2,8,2.0,10,0.2
529309133,1,8,1.0,9,0.1111111111111111
529320846,1,19,1.0,20,0.05
529364070,8,10,8.0,18,0.4444444444444444
529373377,9,1,1.0,10,0.1
529376397,3,5,3.0,8,0.375
529377886,4,5,4.0,9,0.4444444444444444
529378355,7,3,3.0,10,0.3
529384444,1,8,1.0,9,0.1111111111111111
529443929,1,9,1.0,10,0.1
529445420,3,6,3.0,9,0.3333333333333333
529452623,2,27,2.0,29,0.06896551724137931
529463476,3,7,3.0,10,0.3
529489180,2,8,2.0,10,0.2
529501767,2,8,2.0,10,0.2
529518344,1,19,1.0,20,0.05
529519720,1,8,1.0,9,0.1111111111111111
529532708,1,9,1.0,10,0.1
529597084,3,24,3.0,27,0.1111111111111111
529607577,1,9,1.0,10,0.1
529609196,1,9,1.0,10,0.1
529612978,3,7,3.0,10,0.3
529613547,2,8,2.0,10,0.2
529642365,1,18,1.0,19,0.05263157894736842
529645675,2,7,2.0,9,0.2222222222222222
529664337,3,7,3.0,10,0.3
529750441,3,7,3.0,10,0.3
529790879,1,17,1.0,18,0.05555555555555555
529811986,1,9,1.0,10,0.1
529849601,1,9,1.0,10,0.1
529855730,2,7,2.0,9,0.2222222222222222
529855798,1,19,1.0,20,0.05
529858707,17,13,13.0,30,0.43333333333333335
529860177,2,6,2.0,8,0.25
529860903,5,3,3.0,8,0.375
529861267,1,9,1.0,10,0.1
529874714,1,9,1.0,10,0.1
529891527,1,9,1.0,10,0.1
529893234,4,6,4.0,10,0.4
529902470,15,11,11.0,26,0.4230769230769231
529906597,2,7,2.0,9,0.2222222222222222
529937264,12,15,12.0,27,0.4444444444444444
529948613,6,4,4.0,10,0.4
529971258,3,5,3.0,8,0.375
529978893,1,9,1.0,10,0.1
529984620,8,1,1.0,9,0.1111111111111111
529985824,8,1,1.0,9,0.1111111111111111
529987324,1,17,1.0,18,0.05555555555555555
529993768,1,9,1.0,10,0.1
530001274,1,8,1.0,9,0.1111111111111111
530013597,5,5,5.0,10,0.5
530027593,3,16,3.0,19,0.15789473684210525
530036730,4,6,4.0,10,0.4
530058895,1,8,1.0,9,0.1111111111111111
530073925,1,17,1.0,18,0.05555555555555555
530086115,11,7,7.0,18,0.3888888888888889
530109953,3,6,3.0,9,0.3333333333333333
530117078,4,6,4.0,10,0.4
530121302,8,19,8.0,27,0.2962962962962963
530138736,5,5,5.0,10,0.5
530142818,6,4,4.0,10,0.4
530143468,9,1,1.0,10,0.1
530144033,8,1,1.0,9,0.1111111111111111
530168500,2,8,2.0,10,0.2
530177044,4,6,4.0,10,0.4
530178665,4,16,4.0,20,0.2
530183758,1,9,1.0,10,0.1
530186512,3,7,3.0,10,0.3
530187610,6,12,6.0,18,0.3333333333333333
530192105,1,8,1.0,9,0.1111111111111111
530223120,1,9,1.0,10,0.1
530223747,2,8,2.0,10,0.2
530227447,2,8,2.0,10,0.2
530242923,7,2,2.0,9,0.2222222222222222
530247503,3,6,3.0,9,0.3333333333333333
530263604,1,9,1.0,10,0.1
530263696,1,9,1.0,10,0.1
530267300,5,5,5.0,10,0.5
530267952,6,3,3.0,9,0.3333333333333333
530305370,1,8,1.0,9,0.1111111111111111
530330919,3,7,3.0,10,0.3
530332564,2,7,2.0,9,0.2222222222222222
530334214,6,13,6.0,19,0.3157894736842105
530350362,1,8,1.0,9,0.1111111111111111
530353605,5,5,5.0,10,0.5
530362875,4,6,4.0,10,0.4
530367426,1,9,1.0,10,0.1
530369770,2,7,2.0,9,0.2222222222222222
530370060,4,5,4.0,9,0.4444444444444444
530371923,1,18,1.0,19,0.05263157894736842
530374161,4,6,4.0,10,0.4
530376435,3,7,3.0,10,0.3
530376616,1,8,1.0,9,0.1111111111111111
530416221,2,8,2.0,10,0.2
530428393,2,26,2.0,28,0.07142857142857142
530471776,7,3,3.0,10,0.3
530471813,1,9,1.0,10,0.1
530577889,5,4,4.0,9,0.4444444444444444
530579286,3,7,3.0,10,0.3
530596126,1,9,1.0,10,0.1
530599414,2,8,2.0,10,0.2
530600203,1,8,1.0,9,0.1111111111111111
530607419,1,7,1.0,8,0.125
530608162,4,6,4.0,10,0.4
530608279,1,7,1.0,8,0.125
530642326,1,8,1.0,9,0.1111111111111111
530646231,1,18,1.0,19,0.05263157894736842
530647833,1,8,1.0,9,0.1111111111111111
530667516,1,9,1.0,10,0.1
530668344,3,7,3.0,10,0.3
530669128,1,8,1.0,9,0.1111111111111111
530698356,8,2,2.0,10,0.2
530699175,4,6,4.0,10,0.4
530732500,6,4,4.0,10,0.4
530740949,21,7,7.0,28,0.25
530753705,2,7,2.0,9,0.2222222222222222
530756942,7,3,3.0,10,0.3
530762118,1,9,1.0,10,0.1
530768586,5,14,5.0,19,0.2631578947368421
530774967,11,19,11.0,30,0.36666666666666664
530813716,4,5,4.0,9,0.4444444444444444
530830461,1,9,1.0,10,0.1
530856557,1,16,1.0,17,0.058823529411764705
530857272,2,8,2.0,10,0.2
530857406,5,5,5.0,10,0.5
530860054,3,7,3.0,10,0.3
530860238,1,8,1.0,9,0.1111111111111111
530877083,2,8,2.0,10,0.2
530880722,1,7,1.0,8,0.125
530880875,1,17,1.0,18,0.05555555555555555
530888632,1,9,1.0,10,0.1
530891579,1,9,1.0,10,0.1
530895385,2,8,2.0,10,0.2
530895952,2,8,2.0,10,0.2
530898022,2,18,2.0,20,0.1
530905577,1,8,1.0,9,0.1111111111111111
530905760,7,3,3.0,10,0.3
530927911,1,9,1.0,10,0.1
530938622,5,5,5.0,10,0.5
531005256,11,9,9.0,20,0.45
531010330,2,8,2.0,10,0.2
531060521,2,24,2.0,26,0.07692307692307693
531117694,1,8,1.0,9,0.1111111111111111
531124652,2,7,2.0,9,0.2222222222222222
531140276,6,4,4.0,10,0.4
531159984,3,7,3.0,10,0.3
531165905,9,15,9.0,24,0.375
531177443,1,8,1.0,9,0.1111111111111111
531188965,1,9,1.0,10,0.1
531227645,1,9,1.0,10,0.1
531234481,1,9,1.0,10,0.1
531312214,2,8,2.0,10,0.2
531319439,2,8,2.0,10,0.2
531321926,1,16,1.0,17,0.058823529411764705
531339883,24,5,5.0,29,0.1724137931034483
531437042,1,16,1.0,17,0.058823529411764705
531451611,2,26,2.0,28,0.07142857142857142
531454620,1,9,1.0,10,0.1
531466079,1,9,1.0,10,0.1
531466349,5,5,5.0,10,0.5
531544860,27,1,1.0,28,0.03571428571428571
531545292,8,1,1.0,9,0.1111111111111111
531599233,7,3,3.0,10,0.3
531607514,1,7,1.0,8,0.125
531643059,1,7,1.0,8,0.125
531644482,2,7,2.0,9,0.2222222222222222
531651665,2,7,2.0,9,0.2222222222222222
531662697,4,6,4.0,10,0.4
531685364,1,9,1.0,10,0.1
531782567,1,9,1.0,10,0.1
531829534,5,25,5.0,30,0.16666666666666666
531843946,3,24,3.0,27,0.1111111111111111
531932310,1,7,1.0,8,0.125
531933386,1,8,1.0,9,0.1111111111111111
531933853,3,7,3.0,10,0.3
531978738,2,8,2.0,10,0.2
532019246,3,16,3.0,19,0.15789473684210525
532030752,1,17,1.0,18,0.05555555555555555
532032735,2,8,2.0,10,0.2
532035771,1,8,1.0,9,0.1111111111111111
532094087,1,7,1.0,8,0.125
532137195,1,8,1.0,9,0.1111111111111111
532198673,2,8,2.0,10,0.2
532201841,5,5,5.0,10,0.5
532206716,1,9,1.0,10,0.1
532223532,2,8,2.0,10,0.2
532246121,3,7,3.0,10,0.3
532246544,25,3,3.0,28,0.10714285714285714
532250328,2,7,2.0,9,0.2222222222222222
532273502,1,9,1.0,10,0.1
532277189,2,8,2.0,10,0.2
532325968,5,5,5.0,10,0.5
532326463,5,5,5.0,10,0.5
532327038,4,6,4.0,10,0.4
532327161,4,5,4.0,9,0.4444444444444444
532327291,5,3,3.0,8,0.375
532339274,2,7,2.0,9,0.2222222222222222
532389221,1,18,1.0,19,0.05263157894736842
532395195,7,3,3.0,10,0.3
532443025,2,17,2.0,19,0.10526315789473684
532453294,1,17,1.0,18,0.05555555555555555
532457545,4,5,4.0,9,0.4444444444444444
532491815,1,9,1.0,10,0.1
532567947,1,9,1.0,10,0.1
532576296,4,15,4.0,19,0.21052631578947367
532617145,1,9,1.0,10,0.1
532623211,8,1,1.0,9,0.1111111111111111
532623562,8,2,2.0,10,0.2
532628239,1,8,1.0,9,0.1111111111111111
532661527,1,8,1.0,9,0.1111111111111111
532692907,1,9,1.0,10,0.1
532721400,1,7,1.0,8,0.125
532722129,3,6,3.0,9,0.3333333333333333
532722899,6,23,6.0,29,0.20689655172413793
532745286,1,8,1.0,9,0.1111111111111111
532761359,1,9,1.0,10,0.1
532761518,3,7,3.0,10,0.3
532767756,1,9,1.0,10,0.1
532795437,1,8,1.0,9,0.1111111111111111
532845577,3,7,3.0,10,0.3
532859397,5,15,5.0,20,0.25
532919714,8,2,2.0,10,0.2
532951884,3,13,3.0,16,0.1875
532983076,7,2,2.0,9,0.2222222222222222
532983580,7,1,1.0,8,0.125
532988004,2,8,2.0,10,0.2
533082175,2,17,2.0,19,0.10526315789473684
533090507,8,1,1.0,9,0.1111111111111111
533091136,3,5,3.0,8,0.375
533096490,6,4,4.0,10,0.4
533097563,4,6,4.0,10,0.4
533111473,16,10,10.0,26,0.38461538461538464
533128843,1,8,1.0,9,0.1111111111111111
533152469,3,7,3.0,10,0.3
533190786,1,8,1.0,9,0.1111111111111111
533191317,9,1,1.0,10,0.1
533191719,3,7,3.0,10,0.3
533191854,9,1,1.0,10,0.1
533192395,8,1,1.0,9,0.1111111111111111
533221341,1,8,1.0,9,0.1111111111111111
533254342,1,9,1.0,10,0.1
533254578,1,9,1.0,10,0.1
533255775,9,1,1.0,10,0.1
533256185,5,4,4.0,9,0.4444444444444444
533258428,1,18,1.0,19,0.05263157894736842
533261808,1,17,1.0,18,0.05555555555555555
533281242,1,8,1.0,9,0.1111111111111111
533316505,9,1,1.0,10,0.1
533349362,1,9,1.0,10,0.1
533374523,1,9,1.0,10,0.1
533375617,3,6,3.0,9,0.3333333333333333
533377301,2,7,2.0,9,0.2222222222222222
533414296,2,17,2.0,19,0.10526315789473684
533416900,1,9,1.0,10,0.1
533443206,1,8,1.0,9,0.1111111111111111
533482343,1,8,1.0,9,0.1111111111111111
533568499,2,8,2.0,10,0.2
533632950,6,3,3.0,9,0.3333333333333333
533650491,1,19,1.0,20,0.05
533714414,2,8,2.0,10,0.2
533714599,1,9,1.0,10,0.1
533726402,5,3,3.0,8,0.375
533739365,7,2,2.0,9,0.2222222222222222
533742918,1,9,1.0,10,0.1
533747669,1,7,1.0,8,0.125
533775878,13,15,13.0,28,0.4642857142857143
533776744,1,9,1.0,10,0.1
533810603,3,6,3.0,9,0.3333333333333333
533843209,2,8,2.0,10,0.2
533844300,1,9,1.0,10,0.1
533907540,2,8,2.0,10,0.2
533911077,2,8,2.0,10,0.2
533913273,2,8,2.0,10,0.2
533925748,6,3,3.0,9,0.3333333333333333
533925990,8,2,2.0,10,0.2
533926616,7,3,3.0,10,0.3
533945556,2,8,2.0,10,0.2
533962428,2,25,2.0,27,0.07407407407407407
533963122,4,6,4.0,10,0.4
534006460,1,9,1.0,10,0.1
534012578,2,8,2.0,10,0.2
534033433,1,18,1.0,19,0.05263157894736842
534037581,1,9,1.0,10,0.1
534067120,3,6,3.0,9,0.3333333333333333
534070245,2,8,2.0,10,0.2
534070302,5,4,4.0,9,0.4444444444444444
534078166,1,9,1.0,10,0.1
534129169,3,7,3.0,10,0.3
534130829,5,4,4.0,9,0.4444444444444444
534149423,3,7,3.0,10,0.3
534194977,2,8,2.0,10,0.2
534195186,2,7,2.0,9,0.2222222222222222
534202275,5,4,4.0,9,0.4444444444444444
534202859,1,8,1.0,9,0.1111111111111111
534236796,5,13,5.0,18,0.2777777777777778
534239666,4,5,4.0,9,0.4444444444444444
534243084,6,22,6.0,28,0.21428571428571427
534257610,1,27,1.0,28,0.03571428571428571
534267972,5,5,5.0,10,0.5
534268484,5,3,3.0,8,0.375
534271311,1,8,1.0,9,0.1111111111111111
534271652,4,6,4.0,10,0.4
534272268,1,8,1.0,9,0.1111111111111111
534273124,2,8,2.0,10,0.2
534283178,9,1,1.0,10,0.1
534289959,1,8,1.0,9,0.1111111111111111
534303355,2,17,2.0,19,0.10526315789473684
534342997,3,7,3.0,10,0.3
534353251,8,10,8.0,18,0.4444444444444444
534377097,11,17,11.0,28,0.39285714285714285
534377463,3,7,3.0,10,0.3
534406146,1,9,1.0,10,0.1
534422483,1,9,1.0,10,0.1
534450464,8,2,2.0,10,0.2
534478246,3,6,3.0,9,0.3333333333333333
534478794,4,6,4.0,10,0.4
534532381,5,5,5.0,10,0.5
534540511,2,8,2.0,10,0.2
534543529,1,7,1.0,8,0.125
534547095,3,16,3.0,19,0.15789473684210525
534589312,5,4,4.0,9,0.4444444444444444
534612003,3,6,3.0,9,0.3333333333333333
534612327,3,7,3.0,10,0.3
534614536,1,9,1.0,10,0.1
534614758,1,9,1.0,10,0.1
534647688,1,9,1.0,10,0.1
534652588,5,5,5.0,10,0.5
534656848,1,9,1.0,10,0.1
534665517,3,7,3.0,10,0.3
534681397,1,19,1.0,20,0.05
534684375,2,18,2.0,20,0.1
534716232,1,9,1.0,10,0.1
534733253,9,18,9.0,27,0.3333333333333333
534790468,1,8,1.0,9,0.1111111111111111
534849340,2,8,2.0,10,0.2
534855124,3,6,3.0,9,0.3333333333333333
534866701,3,7,3.0,10,0.3
534869160,9,11,9.0,20,0.45
534871790,2,6,2.0,8,0.25
534872464,2,8,2.0,10,0.2
534873066,3,7,3.0,10,0.3
534889269,2,8,2.0,10,0.2
534889679,5,5,5.0,10,0.5
534891399,2,8,2.0,10,0.2
534893809,1,7,1.0,8,0.125
534905405,5,22,5.0,27,0.18518518518518517
534912128,1,18,1.0,19,0.05263157894736842
534917339,1,8,1.0,9,0.1111111111111111
534937833,5,5,5.0,10,0.5
534937987,4,6,4.0,10,0.4
534942060,1,8,1.0,9,0.1111111111111111
535062259,2,8,2.0,10,0.2
535087271,2,7,2.0,9,0.2222222222222222
535094434,2,8,2.0,10,0.2
535110541,3,7,3.0,10,0.3
535110876,4,5,4.0,9,0.4444444444444444
535111548,4,6,4.0,10,0.4
535113254,17,1,1.0,18,0.05555555555555555
535179437,1,8,1.0,9,0.1111111111111111
535190290,2,8,2.0,10,0.2
535192617,3,7,3.0,10,0.3
535202575,2,8,2.0,10,0.2
535205028,1,9,1.0,10,0.1
535205360,2,8,2.0,10,0.2
535208313,3,7,3.0,10,0.3
535212446,4,6,4.0,10,0.4
535220605,2,7,2.0,9,0.2222222222222222
535227563,1,9,1.0,10,0.1
535228213,1,9,1.0,10,0.1
535283383,1,16,1.0,17,0.058823529411764705
535332650,1,9,1.0,10,0.1
535419512,8,2,2.0,10,0.2
535420544,6,4,4.0,10,0.4
535421530,9,1,1.0,10,0.1
535470310,1,8,1.0,9,0.1111111111111111
535517222,3,7,3.0,10,0.3
535531849,3,7,3.0,10,0.3
535532101,2,7,2.0,9,0.2222222222222222
535537031,1,9,1.0,10,0.1
535603276,2,7,2.0,9,0.2222222222222222
535639100,2,8,2.0,10,0.2
535695484,1,9,1.0,10,0.1
535699394,2,8,2.0,10,0.2
535844474,1,9,1.0,10,0.1
535877311,1,9,1.0,10,0.1
535899774,2,8,2.0,10,0.2
535900099,2,7,2.0,9,0.2222222222222222
535900611,1,9,1.0,10,0.1
535900955,1,9,1.0,10,0.1
535901234,4,6,4.0,10,0.4
535916009,1,9,1.0,10,0.1
535921699,1,9,1.0,10,0.1
535921829,1,9,1.0,10,0.1
535922969,1,18,1.0,19,0.05263157894736842
535924072,2,7,2.0,9,0.2222222222222222
535925310,3,6,3.0,9,0.3333333333333333
535932699,9,1,1.0,10,0.1
535935987,2,6,2.0,8,0.25
535945065,4,5,4.0,9,0.4444444444444444
535990001,1,9,1.0,10,0.1
535996506,7,13,7.0,20,0.35
535997321,5,5,5.0,10,0.5
536012087,2,8,2.0,10,0.2
536039246,24,4,4.0,28,0.14285714285714285
536058785,1,8,1.0,9,0.1111111111111111
536069292,3,7,3.0,10,0.3
536072502,1,9,1.0,10,0.1
536072550,4,4,4.0,8,0.5
536073626,7,2,2.0,9,0.2222222222222222
536081582,1,9,1.0,10,0.1
536082663,1,18,1.0,19,0.05263157894736842
536159704,5,5,5.0,10,0.5
536189496,4,4,4.0,8,0.5
536190640,2,8,2.0,10,0.2
536195858,3,7,3.0,10,0.3
536197900,7,3,3.0,10,0.3
536200107,5,5,5.0,10,0.5
536206624,2,7,2.0,9,0.2222222222222222
536208368,3,24,3.0,27,0.1111111111111111
536208619,3,7,3.0,10,0.3
536219056,6,4,4.0,10,0.4
536247412,4,5,4.0,9,0.4444444444444444
536318457,2,16,2.0,18,0.1111111111111111
536350497,1,9,1.0,10,0.1
536416516,1,9,1.0,10,0.1
536453420,1,9,1.0,10,0.1
536471554,3,7,3.0,10,0.3
536472719,2,7,2.0,9,0.2222222222222222
536473773,2,6,2.0,8,0.25
536571980,2,8,2.0,10,0.2
536586938,2,7,2.0,9,0.2222222222222222
536594560,2,8,2.0,10,0.2
536595654,6,3,3.0,9,0.3333333333333333
536597262,1,9,1.0,10,0.1
536623050,1,8,1.0,9,0.1111111111111111
536623239,1,7,1.0,8,0.125
536686850,1,8,1.0,9,0.1111111111111111
536694461,1,7,1.0,8,0.125
536698617,1,7,1.0,8,0.125
536731803,3,16,3.0,19,0.15789473684210525
536839680,2,7,2.0,9,0.2222222222222222
536858435,4,5,4.0,9,0.4444444444444444
536871035,4,6,4.0,10,0.4
536892188,2,8,2.0,10,0.2
536907801,1,9,1.0,10,0.1
536919808,1,9,1.0,10,0.1
536943251,2,8,2.0,10,0.2
536995231,15,15,15.0,30,0.5
536998267,2,8,2.0,10,0.2
537019424,1,8,1.0,9,0.1111111111111111
537041052,6,4,4.0,10,0.4
537041212,7,3,3.0,10,0.3
537056495,1,8,1.0,9,0.1111111111111111
537080442,1,17,1.0,18,0.05555555555555555
537080982,1,9,1.0,10,0.1
537122923,5,4,4.0,9,0.4444444444444444
537132136,3,6,3.0,9,0.3333333333333333
537133707,4,6,4.0,10,0.4
537134194,5,4,4.0,9,0.4444444444444444
537136346,1,8,1.0,9,0.1111111111111111
537137500,4,6,4.0,10,0.4
537137580,1,9,1.0,10,0.1
537138182,5,5,5.0,10,0.5
537190205,2,8,2.0,10,0.2
537192830,3,5,3.0,8,0.375
537227598,2,7,2.0,9,0.2222222222222222
537231078,2,8,2.0,10,0.2
537258103,1,8,1.0,9,0.1111111111111111
537285033,1,9,1.0,10,0.1
537292059,10,18,10.0,28,0.35714285714285715
537337133,4,6,4.0,10,0.4
537342357,1,19,1.0,20,0.05
537345519,6,3,3.0,9,0.3333333333333333
537376403,19,7,7.0,26,0.2692307692307692
537376775,8,2,2.0,10,0.2
537379456,1,8,1.0,9,0.1111111111111111
537379774,1,9,1.0,10,0.1
537393833,1,8,1.0,9,0.1111111111111111
537419546,3,17,3.0,20,0.15
537420896,1,8,1.0,9,0.1111111111111111
537428373,2,8,2.0,10,0.2
537440580,1,9,1.0,10,0.1
537537801,7,2,2.0,9,0.2222222222222222
537571600,2,8,2.0,10,0.2
537573674,1,9,1.0,10,0.1
537623211,1,27,1.0,28,0.03571428571428571
537626010,2,8,2.0,10,0.2
537659953,2,17,2.0,19,0.10526315789473684
537706061,8,2,2.0,10,0.2
537719135,1,9,1.0,10,0.1
537750817,2,7,2.0,9,0.2222222222222222
537751812,1,9,1.0,10,0.1
537764978,1,19,1.0,20,0.05
537800563,6,4,4.0,10,0.4
537867191,4,5,4.0,9,0.4444444444444444
537869574,1,18,1.0,19,0.05263157894736842
537886939,8,2,2.0,10,0.2
537901054,3,6,3.0,9,0.3333333333333333
537902416,1,19,1.0,20,0.05
537923109,4,16,4.0,20,0.2
537923936,1,8,1.0,9,0.1111111111111111
537925367,1,8,1.0,9,0.1111111111111111
537930206,3,7,3.0,10,0.3
537931742,1,9,1.0,10,0.1
537948305,1,8,1.0,9,0.1111111111111111
538004232,5,4,4.0,9,0.4444444444444444
538008448,3,15,3.0,18,0.16666666666666666
538086966,1,7,1.0,8,0.125
538090622,6,3,3.0,9,0.3333333333333333
538134682,7,2,2.0,9,0.2222222222222222
538134934,1,17,1.0,18,0.05555555555555555
538135634,1,8,1.0,9,0.1111111111111111
538141867,1,9,1.0,10,0.1
538141958,1,9,1.0,10,0.1
538142392,2,25,2.0,27,0.07407407407407407
538155748,1,7,1.0,8,0.125
538200021,1,7,1.0,8,0.125
538202351,3,25,3.0,28,0.10714285714285714
538204629,7,2,2.0,9,0.2222222222222222
538208872,2,8,2.0,10,0.2
538221528,2,8,2.0,10,0.2
538221761,2,7,2.0,9,0.2222222222222222
538251262,8,1,1.0,9,0.1111111111111111
538254036,3,7,3.0,10,0.3
538267081,2,8,2.0,10,0.2
538278952,9,1,1.0,10,0.1
538283381,2,7,2.0,9,0.2222222222222222
538291196,5,24,5.0,29,0.1724137931034483
538293526,3,7,3.0,10,0.3
538336071,1,9,1.0,10,0.1
538349399,1,7,1.0,8,0.125
538433005,2,8,2.0,10,0.2
538617088,2,24,2.0,26,0.07692307692307693
538629978,1,18,1.0,19,0.05263157894736842
538648402,1,9,1.0,10,0.1
538677645,1,9,1.0,10,0.1
538735250,1,8,1.0,9,0.1111111111111111
538757391,1,18,1.0,19,0.05263157894736842
538833081,1,17,1.0,18,0.05555555555555555
538917793,1,7,1.0,8,0.125
538955531,2,7,2.0,9,0.2222222222222222
538958071,1,9,1.0,10,0.1
538971180,6,23,6.0,29,0.20689655172413793
538971742,4,6,4.0,10,0.4
538976486,2,7,2.0,9,0.2222222222222222
538979004,1,9,1.0,10,0.1
538981989,1,16,1.0,17,0.058823529411764705
538983106,8,1,1.0,9,0.1111111111111111
538987735,3,7,3.0,10,0.3
539053641,7,3,3.0,10,0.3
539065751,6,13,6.0,19,0.3157894736842105
539127682,8,2,2.0,10,0.2
539129139,8,2,2.0,10,0.2
539131777,8,19,8.0,27,0.2962962962962963
539134023,13,15,13.0,28,0.4642857142857143
539134650,3,6,3.0,9,0.3333333333333333
539134971,5,5,5.0,10,0.5
539168346,1,18,1.0,19,0.05263157894736842
539265681,1,19,1.0,20,0.05
539267018,1,9,1.0,10,0.1
539287053,9,1,1.0,10,0.1
539345215,1,19,1.0,20,0.05
539356372,6,4,4.0,10,0.4
539356453,8,1,1.0,9,0.1111111111111111
539357656,21,8,8.0,29,0.27586206896551724
539358182,4,6,4.0,10,0.4
539358302,1,9,1.0,10,0.1
539358537,2,7,2.0,9,0.2222222222222222
539383135,5,5,5.0,10,0.5
539383759,2,8,2.0,10,0.2
539384073,5,22,5.0,27,0.18518518518518517
539393920,4,5,4.0,9,0.4444444444444444
539394235,4,6,4.0,10,0.4
539580332,6,4,4.0,10,0.4
539580652,7,22,7.0,29,0.2413793103448276
539580855,2,8,2.0,10,0.2
539581329,7,2,2.0,9,0.2222222222222222
539581620,6,4,4.0,10,0.4
539585129,5,5,5.0,10,0.5
539594508,1,19,1.0,20,0.05
539622349,2,8,2.0,10,0.2
539624256,4,6,4.0,10,0.4
539647161,1,19,1.0,20,0.05
539725000,1,9,1.0,10,0.1
539725093,1,18,1.0,19,0.05263157894736842
539927989,1,8,1.0,9,0.1111111111111111
539957444,2,8,2.0,10,0.2
539978368,2,28,2.0,30,0.06666666666666667
540032050,1,18,1.0,19,0.05263157894736842
540063668,1,19,1.0,20,0.05
540108333,3,17,3.0,20,0.15
540138398,2,17,2.0,19,0.10526315789473684
540151660,7,3,3.0,10,0.3
540172808,1,9,1.0,10,0.1
540176797,5,24,5.0,29,0.1724137931034483
540195575,5,5,5.0,10,0.5
540264850,1,18,1.0,19,0.05263157894736842
540422833,2,18,2.0,20,0.1
540655419,3,6,3.0,9,0.3333333333333333
540676138,8,1,1.0,9,0.1111111111111111
540679254,8,2,2.0,10,0.2
540680948,1,9,1.0,10,0.1
540773297,1,9,1.0,10,0.1
540774167,1,9,1.0,10,0.1
540794292,1,9,1.0,10,0.1
540891267,3,7,3.0,10,0.3
540934754,1,16,1.0,17,0.058823529411764705
541060304,1,9,1.0,10,0.1
541133404,1,7,1.0,8,0.125
541135876,1,7,1.0,8,0.125
541136479,2,8,2.0,10,0.2
541139707,1,9,1.0,10,0.1
541151155,1,9,1.0,10,0.1
541163666,1,9,1.0,10,0.1
541170126,1,9,1.0,10,0.1
541226901,2,8,2.0,10,0.2
541231271,3,17,3.0,20,0.15
541282953,1,9,1.0,10,0.1
541307882,1,9,1.0,10,0.1
541378087,2,8,2.0,10,0.2
541378458,5,24,5.0,29,0.1724137931034483
541398975,1,9,1.0,10,0.1
541407529,2,8,2.0,10,0.2
541438748,1,9,1.0,10,0.1
541442110,2,7,2.0,9,0.2222222222222222
541498472,1,19,1.0,20,0.05
541578293,3,7,3.0,10,0.3
541634349,1,9,1.0,10,0.1
541743859,4,6,4.0,10,0.4
541745081,1,9,1.0,10,0.1
541772323,1,9,1.0,10,0.1
541778023,2,7,2.0,9,0.2222222222222222
541782264,4,5,4.0,9,0.4444444444444444
541792321,7,3,3.0,10,0.3
541821678,1,9,1.0,10,0.1
541849530,3,6,3.0,9,0.3333333333333333
541899966,1,8,1.0,9,0.1111111111111111
542075381,7,3,3.0,10,0.3
542099366,2,8,2.0,10,0.2
542159272,1,9,1.0,10,0.1
542207416,1,18,1.0,19,0.05263157894736842
542243892,1,9,1.0,10,0.1
542296753,3,5,3.0,8,0.375
542311373,1,7,1.0,8,0.125
542374225,1,9,1.0,10,0.1
542421634,2,6,2.0,8,0.25
542430056,3,7,3.0,10,0.3
542545928,13,4,4.0,17,0.23529411764705882
542560831,1,8,1.0,9,0.1111111111111111
542578860,6,22,6.0,28,0.21428571428571427
542597934,7,3,3.0,10,0.3
542701240,1,8,1.0,9,0.1111111111111111
542718408,3,6,3.0,9,0.3333333333333333
542730691,5,5,5.0,10,0.5
542742179,1,19,1.0,20,0.05
542772932,1,8,1.0,9,0.1111111111111111
542773060,4,5,4.0,9,0.4444444444444444
542787574,3,6,3.0,9,0.3333333333333333
542791802,5,5,5.0,10,0.5
542964065,1,8,1.0,9,0.1111111111111111
542965883,9,1,1.0,10,0.1
543045689,1,9,1.0,10,0.1
543096292,4,5,4.0,9,0.4444444444444444
543168967,1,7,1.0,8,0.125
543181781,1,9,1.0,10,0.1
543196042,3,7,3.0,10,0.3
543196690,2,7,2.0,9,0.2222222222222222
543247701,1,9,1.0,10,0.1
543297116,14,6,6.0,20,0.3
543394071,2,8,2.0,10,0.2
543425847,9,1,1.0,10,0.1
543426415,2,8,2.0,10,0.2
543427471,7,2,2.0,9,0.2222222222222222
543427677,8,1,1.0,9,0.1111111111111111
543429194,3,7,3.0,10,0.3
543431329,5,5,5.0,10,0.5
543470434,2,16,2.0,18,0.1111111111111111
543664970,5,15,5.0,20,0.25
543682342,2,8,2.0,10,0.2
543682557,2,8,2.0,10,0.2
543683569,1,9,1.0,10,0.1
543685541,3,5,3.0,8,0.375
543690060,1,8,1.0,9,0.1111111111111111
543690289,7,21,7.0,28,0.25
543691077,2,8,2.0,10,0.2
543692490,7,2,2.0,9,0.2222222222222222
543758544,1,9,1.0,10,0.1
543765127,1,8,1.0,9,0.1111111111111111
543765714,3,7,3.0,10,0.3
543772376,2,7,2.0,9,0.2222222222222222
543785281,1,27,1.0,28,0.03571428571428571
543826770,6,13,6.0,19,0.3157894736842105
543849978,6,3,3.0,9,0.3333333333333333
543884286,7,21,7.0,28,0.25
543911717,1,18,1.0,19,0.05263157894736842
544054175,1,17,1.0,18,0.05555555555555555
544151551,2,18,2.0,20,0.1
544252630,3,6,3.0,9,0.3333333333333333
544287209,1,9,1.0,10,0.1
544301239,2,16,2.0,18,0.1111111111111111
544395405,3,15,3.0,18,0.16666666666666666
544405884,1,9,1.0,10,0.1
544426999,2,17,2.0,19,0.10526315789473684
544470770,1,7,1.0,8,0.125
544498401,1,9,1.0,10,0.1
544498680,8,2,2.0,10,0.2
544666818,1,9,1.0,10,0.1
544673215,2,18,2.0,20,0.1
544698420,9,1,1.0,10,0.1
544707080,1,7,1.0,8,0.125
544716756,6,4,4.0,10,0.4
544721209,1,8,1.0,9,0.1111111111111111
544725388,6,3,3.0,9,0.3333333333333333
544775851,1,9,1.0,10,0.1
544781659,1,9,1.0,10,0.1
544785054,2,8,2.0,10,0.2
544795112,16,11,11.0,27,0.4074074074074074
544800941,2,8,2.0,10,0.2
544805431,5,5,5.0,10,0.5
544960185,1,29,1.0,30,0.03333333333333333
544982083,1,7,1.0,8,0.125
544983238,2,18,2.0,20,0.1
544984277,3,26,3.0,29,0.10344827586206896
544988290,1,9,1.0,10,0.1
544990141,4,6,4.0,10,0.4
545018192,2,6,2.0,8,0.25
545047988,8,2,2.0,10,0.2
545048366,1,8,1.0,9,0.1111111111111111
545048566,1,8,1.0,9,0.1111111111111111
545048986,1,7,1.0,8,0.125
545056298,1,19,1.0,20,0.05
545108617,1,9,1.0,10,0.1
545123798,2,7,2.0,9,0.2222222222222222
545183500,3,7,3.0,10,0.3
545185209,1,9,1.0,10,0.1
545214680,9,1,1.0,10,0.1
545215988,1,28,1.0,29,0.034482758620689655
545219011,7,2,2.0,9,0.2222222222222222
545230280,3,17,3.0,20,0.15
545233856,1,9,1.0,10,0.1
545244912,7,3,3.0,10,0.3
545245521,3,6,3.0,9,0.3333333333333333
545246268,3,7,3.0,10,0.3
545246730,4,6,4.0,10,0.4
545247118,1,8,1.0,9,0.1111111111111111
545247949,3,7,3.0,10,0.3
545277800,2,7,2.0,9,0.2222222222222222
545279674,14,14,14.0,28,0.5
545311880,2,28,2.0,30,0.06666666666666667
545331146,7,3,3.0,10,0.3
545332150,7,2,2.0,9,0.2222222222222222
545340763,5,4,4.0,9,0.4444444444444444
545341665,5,3,3.0,8,0.375
545342101,5,4,4.0,9,0.4444444444444444
545342183,20,8,8.0,28,0.2857142857142857
545343557,4,5,4.0,9,0.4444444444444444
545460989,2,25,2.0,27,0.07407407407407407
545462481,2,7,2.0,9,0.2222222222222222
545463696,3,6,3.0,9,0.3333333333333333
545516265,5,5,5.0,10,0.5
545554612,3,14,3.0,17,0.17647058823529413
545725886,8,2,2.0,10,0.2
545826905,2,17,2.0,19,0.10526315789473684
545851500,1,17,1.0,18,0.05555555555555555
545863933,4,6,4.0,10,0.4
545868776,7,12,7.0,19,0.3684210526315789
545892192,14,6,6.0,20,0.3
545911260,2,17,2.0,19,0.10526315789473684
546027461,1,9,1.0,10,0.1
546064275,5,5,5.0,10,0.5
546096788,2,18,2.0,20,0.1
546100521,7,3,3.0,10,0.3
546114507,2,6,2.0,8,0.25
546132581,1,9,1.0,10,0.1
546199291,1,8,1.0,9,0.1111111111111111
546271563,1,8,1.0,9,0.1111111111111111
546294434,3,6,3.0,9,0.3333333333333333
546337684,4,25,4.0,29,0.13793103448275862
546359777,3,7,3.0,10,0.3
546386339,8,2,2.0,10,0.2
546629175,2,8,2.0,10,0.2
546629731,2,8,2.0,10,0.2
546630525,1,9,1.0,10,0.1
546635298,1,9,1.0,10,0.1
546635411,10,20,10.0,30,0.3333333333333333
546635443,2,8,2.0,10,0.2
546635770,1,8,1.0,9,0.1111111111111111
546707839,2,18,2.0,20,0.1
546708244,3,7,3.0,10,0.3
546731850,2,7,2.0,9,0.2222222222222222
546736626,1,9,1.0,10,0.1
546746450,2,8,2.0,10,0.2
546760677,10,10,10.0,20,0.5
546785922,1,9,1.0,10,0.1
546786673,1,8,1.0,9,0.1111111111111111
546813708,1,8,1.0,9,0.1111111111111111
546863143,2,27,2.0,29,0.06896551724137931
546870579,22,7,7.0,29,0.2413793103448276
546871034,6,3,3.0,9,0.3333333333333333
546875291,9,1,1.0,10,0.1
546913331,1,9,1.0,10,0.1
546930219,2,7,2.0,9,0.2222222222222222
546959838,3,7,3.0,10,0.3
546973672,3,6,3.0,9,0.3333333333333333
546974405,2,8,2.0,10,0.2
546979383,2,8,2.0,10,0.2
546980155,4,6,4.0,10,0.4
546982605,1,9,1.0,10,0.1
546990886,1,9,1.0,10,0.1
546991714,1,9,1.0,10,0.1
546994534,1,9,1.0,10,0.1
546996082,1,9,1.0,10,0.1
547004818,8,1,1.0,9,0.1111111111111111
547048437,2,8,2.0,10,0.2
547074082,1,9,1.0,10,0.1
547100372,1,9,1.0,10,0.1
547102543,2,7,2.0,9,0.2222222222222222
547104207,2,15,2.0,17,0.11764705882352941
547110568,1,15,1.0,16,0.0625
547137487,1,19,1.0,20,0.05
547181479,1,18,1.0,19,0.05263157894736842
547191561,8,2,2.0,10,0.2
547300358,1,8,1.0,9,0.1111111111111111
547300964,3,7,3.0,10,0.3
547306808,2,8,2.0,10,0.2
547309202,1,7,1.0,8,0.125
547317814,1,9,1.0,10,0.1
547322888,2,8,2.0,10,0.2
547327909,2,7,2.0,9,0.2222222222222222
547335363,9,1,1.0,10,0.1
547337174,5,5,5.0,10,0.5
547338079,1,8,1.0,9,0.1111111111111111
547407454,7,2,2.0,9,0.2222222222222222
547413176,1,8,1.0,9,0.1111111111111111
547413695,1,9,1.0,10,0.1
547415200,2,8,2.0,10,0.2
547469285,1,19,1.0,20,0.05
547469417,1,17,1.0,18,0.05555555555555555
547512333,1,8,1.0,9,0.1111111111111111
547523189,3,5,3.0,8,0.375
547588544,7,3,3.0,10,0.3
547628592,1,9,1.0,10,0.1
547655253,8,2,2.0,10,0.2
547698715,4,6,4.0,10,0.4
547715939,7,3,3.0,10,0.3
547716668,8,2,2.0,10,0.2
547717106,7,2,2.0,9,0.2222222222222222
547719852,2,17,2.0,19,0.10526315789473684
547731764,15,12,12.0,27,0.4444444444444444
547733089,1,8,1.0,9,0.1111111111111111
547735101,2,7,2.0,9,0.2222222222222222
547735745,2,7,2.0,9,0.2222222222222222
547736002,2,8,2.0,10,0.2
547736506,4,6,4.0,10,0.4
547737049,14,14,14.0,28,0.5
547773603,2,8,2.0,10,0.2
547786781,1,19,1.0,20,0.05
547809098,1,9,1.0,10,0.1
547828535,2,7,2.0,9,0.2222222222222222
547869719,2,7,2.0,9,0.2222222222222222
547870283,1,9,1.0,10,0.1
547871428,1,9,1.0,10,0.1
547872123,6,3,3.0,9,0.3333333333333333
547873144,1,8,1.0,9,0.1111111111111111
547874993,4,6,4.0,10,0.4
547876154,1,8,1.0,9,0.1111111111111111
547888343,4,5,4.0,9,0.4444444444444444
547888909,2,7,2.0,9,0.2222222222222222
547941255,1,9,1.0,10,0.1
547962902,2,6,2.0,8,0.25
547978424,1,9,1.0,10,0.1
547994594,3,7,3.0,10,0.3
547995234,2,8,2.0,10,0.2
547997191,4,6,4.0,10,0.4
547998138,5,4,4.0,9,0.4444444444444444
548000713,2,18,2.0,20,0.1
548005014,1,8,1.0,9,0.1111111111111111
548064510,1,18,1.0,19,0.05263157894736842
548113416,1,8,1.0,9,0.1111111111111111
548113637,1,8,1.0,9,0.1111111111111111
548114454,2,8,2.0,10,0.2
548161651,1,8,1.0,9,0.1111111111111111
548215417,6,3,3.0,9,0.3333333333333333
548247396,1,9,1.0,10,0.1
548251719,2,18,2.0,20,0.1
548303823,1,9,1.0,10,0.1
548304630,1,8,1.0,9,0.1111111111111111
548304898,4,6,4.0,10,0.4
548305812,3,7,3.0,10,0.3
548322888,4,6,4.0,10,0.4
548333073,1,9,1.0,10,0.1
548351997,4,5,4.0,9,0.4444444444444444
548353439,6,4,4.0,10,0.4
548428667,4,5,4.0,9,0.4444444444444444
548449288,1,8,1.0,9,0.1111111111111111
548473654,2,8,2.0,10,0.2
548490436,3,6,3.0,9,0.3333333333333333
548491061,12,14,12.0,26,0.46153846153846156
548491829,4,6,4.0,10,0.4
548493083,3,7,3.0,10,0.3
548495481,1,8,1.0,9,0.1111111111111111
548501158,9,1,1.0,10,0.1
548501852,17,11,11.0,28,0.39285714285714285
548531126,2,7,2.0,9,0.2222222222222222
548558856,5,4,4.0,9,0.4444444444444444
548628228,5,5,5.0,10,0.5
548628307,4,6,4.0,10,0.4
548660473,1,9,1.0,10,0.1
548676581,5,5,5.0,10,0.5
548746461,1,9,1.0,10,0.1
548826306,1,9,1.0,10,0.1
548829315,1,18,1.0,19,0.05263157894736842
548832322,1,18,1.0,19,0.05263157894736842
548871455,1,9,1.0,10,0.1
548874000,2,8,2.0,10,0.2
548912947,1,9,1.0,10,0.1
548953059,1,16,1.0,17,0.058823529411764705
548955659,1,8,1.0,9,0.1111111111111111
549034803,2,18,2.0,20,0.1
549094227,2,8,2.0,10,0.2
549094782,1,9,1.0,10,0.1
549117936,5,24,5.0,29,0.1724137931034483
549125693,1,16,1.0,17,0.058823529411764705
549164813,3,5,3.0,8,0.375
549165364,1,9,1.0,10,0.1
549198873,1,9,1.0,10,0.1
549225256,2,8,2.0,10,0.2
549232603,9,1,1.0,10,0.1
549243879,1,9,1.0,10,0.1
549284130,2,6,2.0,8,0.25
549296765,1,8,1.0,9,0.1111111111111111
549361431,2,17,2.0,19,0.10526315789473684
549391809,1,19,1.0,20,0.05
549406331,1,8,1.0,9,0.1111111111111111
549460249,1,17,1.0,18,0.05555555555555555
549554242,3,27,3.0,30,0.1
549609110,1,9,1.0,10,0.1
549738758,1,8,1.0,9,0.1111111111111111
549819033,1,8,1.0,9,0.1111111111111111
549884315,2,17,2.0,19,0.10526315789473684
549907783,9,1,1.0,10,0.1
549923589,2,6,2.0,8,0.25
549941913,3,7,3.0,10,0.3
549975815,2,8,2.0,10,0.2
550040837,3,7,3.0,10,0.3
550058223,1,9,1.0,10,0.1
550072052,1,9,1.0,10,0.1
550076500,1,16,1.0,17,0.058823529411764705
550133655,1,9,1.0,10,0.1
550155841,8,1,1.0,9,0.1111111111111111
550185481,1,9,1.0,10,0.1
550212734,3,7,3.0,10,0.3
550219198,1,9,1.0,10,0.1
550235428,1,8,1.0,9,0.1111111111111111
550240233,1,8,1.0,9,0.1111111111111111
550240748,1,26,1.0,27,0.037037037037037035
550242792,3,5,3.0,8,0.375
550243345,4,5,4.0,9,0.4444444444444444
550243621,1,9,1.0,10,0.1
550253587,2,8,2.0,10,0.2
550254186,1,8,1.0,9,0.1111111111111111
550268702,4,5,4.0,9,0.4444444444444444
550271970,1,9,1.0,10,0.1
550272182,2,7,2.0,9,0.2222222222222222
550274474,3,6,3.0,9,0.3333333333333333
550274636,2,8,2.0,10,0.2
550307359,3,6,3.0,9,0.3333333333333333
550312431,2,17,2.0,19,0.10526315789473684
550314013,5,3,3.0,8,0.375
550328985,8,1,1.0,9,0.1111111111111111
550355895,9,1,1.0,10,0.1
550372411,2,7,2.0,9,0.2222222222222222
550374546,1,8,1.0,9,0.1111111111111111
550376317,1,18,1.0,19,0.05263157894736842
550390286,2,7,2.0,9,0.2222222222222222
550392839,1,8,1.0,9,0.1111111111111111
550410646,2,8,2.0,10,0.2
550412423,1,17,1.0,18,0.05555555555555555
550415149,1,9,1.0,10,0.1
550422752,3,7,3.0,10,0.3
550465358,1,9,1.0,10,0.1
550487584,7,2,2.0,9,0.2222222222222222
550542664,1,8,1.0,9,0.1111111111111111
550555546,7,3,3.0,10,0.3
550580136,6,14,6.0,20,0.3
550582210,4,5,4.0,9,0.4444444444444444
550603089,17,10,10.0,27,0.37037037037037035
550605260,1,18,1.0,19,0.05263157894736842
550607268,7,3,3.0,10,0.3
550625644,9,1,1.0,10,0.1
550703059,1,8,1.0,9,0.1111111111111111
550703205,4,5,4.0,9,0.4444444444444444
550712816,1,19,1.0,20,0.05
550715721,8,1,1.0,9,0.1111111111111111
550718558,1,9,1.0,10,0.1
550733916,3,5,3.0,8,0.375
550739809,4,6,4.0,10,0.4
550865734,2,8,2.0,10,0.2
550871917,6,4,4.0,10,0.4
550891967,1,9,1.0,10,0.1
550900108,1,8,1.0,9,0.1111111111111111
550922040,2,8,2.0,10,0.2
550985167,1,9,1.0,10,0.1
551002468,1,9,1.0,10,0.1
551003758,1,9,1.0,10,0.1
551059838,1,8,1.0,9,0.1111111111111111
551080422,1,19,1.0,20,0.05
551141761,1,9,1.0,10,0.1
551175439,2,8,2.0,10,0.2
551196183,3,6,3.0,9,0.3333333333333333
551221272,2,25,2.0,27,0.07407407407407407
551221809,5,4,4.0,9,0.4444444444444444
551239356,3,25,3.0,28,0.10714285714285714
551278314,1,9,1.0,10,0.1
551297370,2,8,2.0,10,0.2
551300666,1,9,1.0,10,0.1
551382598,1,9,1.0,10,0.1
551388716,7,2,2.0,9,0.2222222222222222
551402734,4,16,4.0,20,0.2
551427942,2,8,2.0,10,0.2
551434165,7,3,3.0,10,0.3
551434361,4,5,4.0,9,0.4444444444444444
551434506,1,9,1.0,10,0.1
551441606,9,11,9.0,20,0.45
551496801,1,17,1.0,18,0.05555555555555555
551507677,2,8,2.0,10,0.2
551522262,2,8,2.0,10,0.2
551522471,2,8,2.0,10,0.2
551642396,2,7,2.0,9,0.2222222222222222
551646774,1,9,1.0,10,0.1
551660595,1,16,1.0,17,0.058823529411764705
551661672,3,6,3.0,9,0.3333333333333333
551662055,2,6,2.0,8,0.25
551702153,1,9,1.0,10,0.1
551706472,2,8,2.0,10,0.2
551724379,1,8,1.0,9,0.1111111111111111
551732746,1,9,1.0,10,0.1
551772443,1,8,1.0,9,0.1111111111111111
551805592,2,7,2.0,9,0.2222222222222222
551808363,2,17,2.0,19,0.10526315789473684
551821114,1,8,1.0,9,0.1111111111111111
551856006,1,9,1.0,10,0.1
551856645,3,6,3.0,9,0.3333333333333333
551858263,2,8,2.0,10,0.2
551858496,3,25,3.0,28,0.10714285714285714
551860269,4,6,4.0,10,0.4
551870727,3,6,3.0,9,0.3333333333333333
551871101,1,9,1.0,10,0.1
551904474,27,2,2.0,29,0.06896551724137931
551937000,2,6,2.0,8,0.25
551968579,1,9,1.0,10,0.1
551969276,1,16,1.0,17,0.058823529411764705
551973132,2,25,2.0,27,0.07407407407407407
551987672,1,8,1.0,9,0.1111111111111111
551991064,2,8,2.0,10,0.2
552077591,4,6,4.0,10,0.4
552077854,1,9,1.0,10,0.1
552118974,1,9,1.0,10,0.1
552123300,1,19,1.0,20,0.05
552137127,3,26,3.0,29,0.10344827586206896
552149688,1,9,1.0,10,0.1
552159221,4,5,4.0,9,0.4444444444444444
552171969,3,16,3.0,19,0.15789473684210525
552210630,4,5,4.0,9,0.4444444444444444
552211615,4,6,4.0,10,0.4
552217133,1,9,1.0,10,0.1
552217199,1,9,1.0,10,0.1
552267504,1,9,1.0,10,0.1
552274211,1,19,1.0,20,0.05
552275099,3,7,3.0,10,0.3
552279026,3,7,3.0,10,0.3
552313053,1,8,1.0,9,0.1111111111111111
552361017,9,1,1.0,10,0.1
552368837,1,7,1.0,8,0.125
552428548,2,16,2.0,18,0.1111111111111111
552435949,1,9,1.0,10,0.1
552436508,1,27,1.0,28,0.03571428571428571
552437581,3,6,3.0,9,0.3333333333333333
552564945,1,7,1.0,8,0.125
552565615,1,7,1.0,8,0.125
552566675,1,8,1.0,9,0.1111111111111111
552567174,1,9,1.0,10,0.1
552572878,1,9,1.0,10,0.1
552592092,1,9,1.0,10,0.1
552592571,1,9,1.0,10,0.1
552598895,25,4,4.0,29,0.13793103448275862
552610602,2,8,2.0,10,0.2
552630342,1,7,1.0,8,0.125
552662664,1,19,1.0,20,0.05
552666390,1,9,1.0,10,0.1
552677606,9,1,1.0,10,0.1
552701623,9,1,1.0,10,0.1
552716567,2,8,2.0,10,0.2
552748892,2,8,2.0,10,0.2
552821898,2,8,2.0,10,0.2
552822166,2,18,2.0,20,0.1
552831483,2,7,2.0,9,0.2222222222222222
552833339,4,6,4.0,10,0.4
552836859,2,8,2.0,10,0.2
552837571,1,9,1.0,10,0.1
552838465,2,8,2.0,10,0.2
552841565,9,1,1.0,10,0.1
552851176,6,14,6.0,20,0.3
552852682,2,8,2.0,10,0.2
552859243,4,5,4.0,9,0.4444444444444444
552859551,2,8,2.0,10,0.2
552866585,1,9,1.0,10,0.1
552867165,2,8,2.0,10,0.2
552906786,7,2,2.0,9,0.2222222222222222
552943380,8,2,2.0,10,0.2
552955198,1,9,1.0,10,0.1
552959532,1,9,1.0,10,0.1
552977045,2,7,2.0,9,0.2222222222222222
552977310,3,7,3.0,10,0.3
552978579,6,4,4.0,10,0.4
553021352,4,6,4.0,10,0.4
553075794,2,17,2.0,19,0.10526315789473684
553083800,1,19,1.0,20,0.05
553088146,1,27,1.0,28,0.03571428571428571
553089224,1,7,1.0,8,0.125
553121665,1,9,1.0,10,0.1
553122427,2,16,2.0,18,0.1111111111111111
553144552,2,8,2.0,10,0.2
553145031,1,9,1.0,10,0.1
553190918,3,7,3.0,10,0.3
553191575,3,6,3.0,9,0.3333333333333333
553192005,15,15,15.0,30,0.5
553192043,3,6,3.0,9,0.3333333333333333
553244728,1,19,1.0,20,0.05
553249672,5,4,4.0,9,0.4444444444444444
553277407,8,2,2.0,10,0.2
553288038,1,8,1.0,9,0.1111111111111111
553403402,1,19,1.0,20,0.05
553406541,1,9,1.0,10,0.1
553447631,2,7,2.0,9,0.2222222222222222
553539873,3,7,3.0,10,0.3
553573219,1,17,1.0,18,0.05555555555555555
553606326,2,7,2.0,9,0.2222222222222222
553614005,2,7,2.0,9,0.2222222222222222
553623637,13,16,13.0,29,0.4482758620689655
553625857,1,9,1.0,10,0.1
553631729,15,14,14.0,29,0.4827586206896552
553685559,1,8,1.0,9,0.1111111111111111
553707128,6,3,3.0,9,0.3333333333333333
553723635,6,4,4.0,10,0.4
553752662,1,9,1.0,10,0.1
553753256,5,4,4.0,9,0.4444444444444444
553764745,3,6,3.0,9,0.3333333333333333
553769087,4,6,4.0,10,0.4
553769984,5,5,5.0,10,0.5
553771062,1,9,1.0,10,0.1
553873513,3,5,3.0,8,0.375
553897455,21,7,7.0,28,0.25
553942161,3,6,3.0,9,0.3333333333333333
553996756,3,5,3.0,8,0.375
554011565,2,27,2.0,29,0.06896551724137931
554106513,4,16,4.0,20,0.2
554107350,6,4,4.0,10,0.4
554109946,3,7,3.0,10,0.3
554117974,5,12,5.0,17,0.29411764705882354
554127529,3,7,3.0,10,0.3
554127725,3,7,3.0,10,0.3
554147941,4,6,4.0,10,0.4
554159651,1,9,1.0,10,0.1
554177587,6,4,4.0,10,0.4
554178722,9,1,1.0,10,0.1
554183409,1,8,1.0,9,0.1111111111111111
554198303,1,17,1.0,18,0.05555555555555555
554206528,1,8,1.0,9,0.1111111111111111
554229452,1,9,1.0,10,0.1
554280180,1,8,1.0,9,0.1111111111111111
554293916,14,14,14.0,28,0.5
554294849,4,6,4.0,10,0.4
554296557,8,18,8.0,26,0.3076923076923077
554311129,7,2,2.0,9,0.2222222222222222
554311480,9,1,1.0,10,0.1
554330578,8,2,2.0,10,0.2
554332379,24,3,3.0,27,0.1111111111111111
554370319,1,9,1.0,10,0.1
554382458,5,15,5.0,20,0.25
554382510,12,6,6.0,18,0.3333333333333333
554387907,7,3,3.0,10,0.3
554400730,7,3,3.0,10,0.3
554401082,2,8,2.0,10,0.2
554416133,1,19,1.0,20,0.05
554434480,2,6,2.0,8,0.25
554485799,1,7,1.0,8,0.125
554502498,9,1,1.0,10,0.1
554507558,4,4,4.0,8,0.5
554531244,2,8,2.0,10,0.2
554552309,2,8,2.0,10,0.2
554572448,1,9,1.0,10,0.1
554584322,1,18,1.0,19,0.05263157894736842
554589649,1,9,1.0,10,0.1
554589927,3,7,3.0,10,0.3
554590250,1,8,1.0,9,0.1111111111111111
554590573,8,1,1.0,9,0.1111111111111111
554591051,7,3,3.0,10,0.3
554591436,1,8,1.0,9,0.1111111111111111
554610740,2,8,2.0,10,0.2
554688692,1,8,1.0,9,0.1111111111111111
554750667,1,9,1.0,10,0.1
554763754,9,1,1.0,10,0.1
554812661,2,8,2.0,10,0.2
554820590,1,7,1.0,8,0.125
554829347,1,9,1.0,10,0.1
554831132,7,3,3.0,10,0.3
554831452,4,6,4.0,10,0.4
554833209,7,3,3.0,10,0.3
554833763,1,8,1.0,9,0.1111111111111111
554840811,11,9,9.0,20,0.45
554844495,3,5,3.0,8,0.375
554886837,1,18,1.0,19,0.05263157894736842
554916423,4,6,4.0,10,0.4
554919158,8,21,8.0,29,0.27586206896551724
554920280,1,9,1.0,10,0.1
554920770,3,6,3.0,9,0.3333333333333333
554935301,1,9,1.0,10,0.1
555006252,4,16,4.0,20,0.2
555024396,26,2,2.0,28,0.07142857142857142
555096012,5,24,5.0,29,0.1724137931034483
555110489,1,8,1.0,9,0.1111111111111111
555111323,1,18,1.0,19,0.05263157894736842
555113804,2,8,2.0,10,0.2
555162518,1,8,1.0,9,0.1111111111111111
555183876,1,9,1.0,10,0.1
555186134,6,23,6.0,29,0.20689655172413793
555228677,1,19,1.0,20,0.05
555243988,6,4,4.0,10,0.4
555245024,6,3,3.0,9,0.3333333333333333
555255648,18,1,1.0,19,0.05263157894736842
555257011,3,6,3.0,9,0.3333333333333333
555291757,4,5,4.0,9,0.4444444444444444
555303599,2,8,2.0,10,0.2
555342089,1,9,1.0,10,0.1
555359327,7,2,2.0,9,0.2222222222222222
555371609,2,7,2.0,9,0.2222222222222222
555375232,1,19,1.0,20,0.05
555380807,7,3,3.0,10,0.3
555382394,1,8,1.0,9,0.1111111111111111
555385778,1,28,1.0,29,0.034482758620689655
555393980,1,7,1.0,8,0.125
555400785,2,8,2.0,10,0.2
555406438,8,2,2.0,10,0.2
555406899,1,8,1.0,9,0.1111111111111111
555407655,1,8,1.0,9,0.1111111111111111
555411733,1,18,1.0,19,0.05263157894736842
555416074,6,3,3.0,9,0.3333333333333333
555437672,3,6,3.0,9,0.3333333333333333
555469171,2,7,2.0,9,0.2222222222222222
555484436,1,8,1.0,9,0.1111111111111111
555501209,1,9,1.0,10,0.1
555524516,1,8,1.0,9,0.1111111111111111
555650589,1,8,1.0,9,0.1111111111111111
555661557,3,7,3.0,10,0.3
555661807,8,2,2.0,10,0.2
555668607,1,9,1.0,10,0.1
555683243,1,9,1.0,10,0.1
555693118,4,6,4.0,10,0.4
555707535,1,19,1.0,20,0.05
555717971,1,8,1.0,9,0.1111111111111111
555722595,1,9,1.0,10,0.1
555751670,1,8,1.0,9,0.1111111111111111
555770063,1,8,1.0,9,0.1111111111111111
555771174,2,8,2.0,10,0.2
555783681,1,16,1.0,17,0.058823529411764705
555799823,1,18,1.0,19,0.05263157894736842
555806907,1,18,1.0,19,0.05263157894736842
555816057,2,7,2.0,9,0.2222222222222222
555840425,1,9,1.0,10,0.1
555853687,4,6,4.0,10,0.4
555854547,2,17,2.0,19,0.10526315789473684
555854684,1,9,1.0,10,0.1
555855193,1,17,1.0,18,0.05555555555555555
555864783,1,18,1.0,19,0.05263157894736842
555903181,3,6,3.0,9,0.3333333333333333
555908741,1,19,1.0,20,0.05
556047001,1,17,1.0,18,0.05555555555555555
556053929,2,6,2.0,8,0.25
556100336,7,2,2.0,9,0.2222222222222222
556156080,1,7,1.0,8,0.125
556158260,13,14,13.0,27,0.48148148148148145
556199651,3,17,3.0,20,0.15
556220507,1,8,1.0,9,0.1111111111111111
556244653,1,7,1.0,8,0.125
556247001,1,9,1.0,10,0.1
556281153,3,7,3.0,10,0.3
556281325,1,9,1.0,10,0.1
556343571,8,2,2.0,10,0.2
556350486,1,19,1.0,20,0.05
556351863,2,8,2.0,10,0.2
556415307,1,9,1.0,10,0.1
556416870,3,7,3.0,10,0.3
556432794,1,9,1.0,10,0.1
556448737,1,19,1.0,20,0.05
556478038,3,7,3.0,10,0.3
556478434,2,7,2.0,9,0.2222222222222222
556478592,5,5,5.0,10,0.5
556481268,4,5,4.0,9,0.4444444444444444
556484779,2,26,2.0,28,0.07142857142857142
556485161,2,8,2.0,10,0.2
556491553,3,7,3.0,10,0.3
556494085,5,5,5.0,10,0.5
556495747,2,8,2.0,10,0.2
556496540,3,6,3.0,9,0.3333333333333333
556506156,3,7,3.0,10,0.3
556575351,2,7,2.0,9,0.2222222222222222
556579467,6,4,4.0,10,0.4
556599097,2,8,2.0,10,0.2
556622127,1,8,1.0,9,0.1111111111111111
556643399,5,5,5.0,10,0.5
556648966,1,8,1.0,9,0.1111111111111111
556660291,1,9,1.0,10,0.1
556670255,1,9,1.0,10,0.1
556673912,3,6,3.0,9,0.3333333333333333
556674126,5,4,4.0,9,0.4444444444444444
556737931,1,8,1.0,9,0.1111111111111111
556818727,5,5,5.0,10,0.5
556819577,5,4,4.0,9,0.4444444444444444
556820642,2,8,2.0,10,0.2
556869771,1,19,1.0,20,0.05
556892976,1,29,1.0,30,0.03333333333333333
556893220,2,26,2.0,28,0.07142857142857142
556903220,5,5,5.0,10,0.5
556957463,1,7,1.0,8,0.125
556968160,9,1,1.0,10,0.1
556973069,1,28,1.0,29,0.034482758620689655
556973336,1,8,1.0,9,0.1111111111111111
556990040,3,7,3.0,10,0.3
556991183,8,2,2.0,10,0.2
556992448,6,4,4.0,10,0.4
556993704,2,8,2.0,10,0.2
557003813,7,3,3.0,10,0.3
557007633,1,9,1.0,10,0.1
557014703,6,23,6.0,29,0.20689655172413793
557015201,1,9,1.0,10,0.1
557024934,1,18,1.0,19,0.05263157894736842
557028069,1,9,1.0,10,0.1
557048532,6,2,2.0,8,0.25
557051453,8,2,2.0,10,0.2
557093968,3,7,3.0,10,0.3
557096736,1,8,1.0,9,0.1111111111111111
557124804,3,7,3.0,10,0.3
557127638,3,6,3.0,9,0.3333333333333333
557128378,1,9,1.0,10,0.1
557128888,5,4,4.0,9,0.4444444444444444
557129833,1,9,1.0,10,0.1
557145338,1,9,1.0,10,0.1
557170633,1,9,1.0,10,0.1
557174662,3,17,3.0,20,0.15
557211224,2,8,2.0,10,0.2
557211392,1,29,1.0,30,0.03333333333333333
557225185,2,7,2.0,9,0.2222222222222222
557231304,5,5,5.0,10,0.5
557257497,1,18,1.0,19,0.05263157894736842
557352510,1,7,1.0,8,0.125
557353404,1,8,1.0,9,0.1111111111111111
557356603,6,4,4.0,10,0.4
557358488,1,9,1.0,10,0.1
557377548,3,7,3.0,10,0.3
557441314,2,8,2.0,10,0.2
557446725,1,7,1.0,8,0.125
557448877,1,9,1.0,10,0.1
557449869,4,6,4.0,10,0.4
557475453,2,26,2.0,28,0.07142857142857142
557532313,3,7,3.0,10,0.3
557532938,2,8,2.0,10,0.2
557533636,3,6,3.0,9,0.3333333333333333
557534232,5,5,5.0,10,0.5
557534832,3,7,3.0,10,0.3
557551786,6,3,3.0,9,0.3333333333333333
557564334,2,18,2.0,20,0.1
557596120,1,9,1.0,10,0.1
557596222,2,8,2.0,10,0.2
557679908,24,5,5.0,29,0.1724137931034483
557704353,5,13,5.0,18,0.2777777777777778
557724698,6,4,4.0,10,0.4
557738994,1,8,1.0,9,0.1111111111111111
557752751,2,26,2.0,28,0.07142857142857142
557752817,2,8,2.0,10,0.2
557752898,1,9,1.0,10,0.1
557778370,1,8,1.0,9,0.1111111111111111
557780405,1,18,1.0,19,0.05263157894736842
557798092,1,9,1.0,10,0.1
557805143,2,8,2.0,10,0.2
557824378,1,9,1.0,10,0.1
557873957,1,9,1.0,10,0.1
558042268,1,9,1.0,10,0.1
558056251,3,5,3.0,8,0.375
558080721,2,7,2.0,9,0.2222222222222222
558098113,3,16,3.0,19,0.15789473684210525
558106204,5,5,5.0,10,0.5
558108170,7,3,3.0,10,0.3
558109325,8,1,1.0,9,0.1111111111111111
558110692,5,4,4.0,9,0.4444444444444444
558112555,1,9,1.0,10,0.1
558113425,1,8,1.0,9,0.1111111111111111
558128766,2,18,2.0,20,0.1
558160021,1,9,1.0,10,0.1
558166694,17,1,1.0,18,0.05555555555555555
558167733,1,9,1.0,10,0.1
558216577,6,2,2.0,8,0.25
558218732,1,9,1.0,10,0.1
558219034,1,9,1.0,10,0.1
558229647,1,9,1.0,10,0.1
558284211,3,7,3.0,10,0.3
558305857,7,3,3.0,10,0.3
558346438,8,1,1.0,9,0.1111111111111111
558347091,1,9,1.0,10,0.1
558363068,1,8,1.0,9,0.1111111111111111
558377345,4,6,4.0,10,0.4
558491316,4,5,4.0,9,0.4444444444444444
558491909,5,5,5.0,10,0.5
558546605,1,8,1.0,9,0.1111111111111111
558546902,1,8,1.0,9,0.1111111111111111
558558678,1,18,1.0,19,0.05263157894736842
558619355,6,14,6.0,20,0.3
558622554,7,3,3.0,10,0.3
558625092,1,9,1.0,10,0.1
558666940,2,8,2.0,10,0.2
558667756,1,9,1.0,10,0.1
558668936,2,7,2.0,9,0.2222222222222222
558670073,28,1,1.0,29,0.034482758620689655
558676861,12,16,12.0,28,0.42857142857142855
558694453,7,3,3.0,10,0.3
558695413,7,2,2.0,9,0.2222222222222222
558726642,3,7,3.0,10,0.3
558726967,1,8,1.0,9,0.1111111111111111
558727950,1,9,1.0,10,0.1
558729709,1,7,1.0,8,0.125
558738032,1,9,1.0,10,0.1
558742381,3,5,3.0,8,0.375
558747667,1,7,1.0,8,0.125
558748648,1,9,1.0,10,0.1
558749520,5,5,5.0,10,0.5
558751422,3,13,3.0,16,0.1875
558760199,2,8,2.0,10,0.2
558760830,7,3,3.0,10,0.3
558760947,4,6,4.0,10,0.4
558761368,1,8,1.0,9,0.1111111111111111
558761529,2,8,2.0,10,0.2
558764661,1,8,1.0,9,0.1111111111111111
558778883,2,8,2.0,10,0.2
558780142,1,8,1.0,9,0.1111111111111111
558828585,7,1,1.0,8,0.125
558831676,2,8,2.0,10,0.2
558896166,1,9,1.0,10,0.1
558896925,3,6,3.0,9,0.3333333333333333
558910550,1,9,1.0,10,0.1
558916637,2,8,2.0,10,0.2
558952415,1,9,1.0,10,0.1
558995916,1,19,1.0,20,0.05
558997746,3,6,3.0,9,0.3333333333333333
559077327,2,6,2.0,8,0.25
559085403,2,17,2.0,19,0.10526315789473684
559095435,2,7,2.0,9,0.2222222222222222
559099791,2,8,2.0,10,0.2
559115648,2,8,2.0,10,0.2
559120061,2,6,2.0,8,0.25
559128758,1,8,1.0,9,0.1111111111111111
559130884,1,9,1.0,10,0.1
559132853,3,7,3.0,10,0.3
559140704,1,8,1.0,9,0.1111111111111111
559143676,4,4,4.0,8,0.5
559146630,1,9,1.0,10,0.1
559156588,2,8,2.0,10,0.2
559170901,5,4,4.0,9,0.4444444444444444
559171070,1,8,1.0,9,0.1111111111111111
559172506,1,17,1.0,18,0.05555555555555555
559192404,3,16,3.0,19,0.15789473684210525
559236237,1,9,1.0,10,0.1
559236783,2,8,2.0,10,0.2
559261810,28,1,1.0,29,0.034482758620689655
559298843,5,4,4.0,9,0.4444444444444444
559367474,1,19,1.0,20,0.05
559384348,8,20,8.0,28,0.2857142857142857
559400456,4,6,4.0,10,0.4
559411304,1,18,1.0,19,0.05263157894736842
559413209,4,6,4.0,10,0.4
559524273,5,5,5.0,10,0.5
559530795,8,2,2.0,10,0.2
559579034,1,7,1.0,8,0.125
559607069,9,1,1.0,10,0.1
559713952,9,1,1.0,10,0.1
559719143,1,8,1.0,9,0.1111111111111111
559777083,1,7,1.0,8,0.125
559800571,2,7,2.0,9,0.2222222222222222
559805033,6,3,3.0,9,0.3333333333333333
559894363,8,2,2.0,10,0.2
559894481,3,7,3.0,10,0.3
559947042,1,9,1.0,10,0.1
560002392,1,7,1.0,8,0.125
560029810,1,19,1.0,20,0.05
560088671,7,3,3.0,10,0.3
560100234,1,17,1.0,18,0.05555555555555555
560103767,3,7,3.0,10,0.3
560111471,5,5,5.0,10,0.5
560142008,3,7,3.0,10,0.3
560158191,2,8,2.0,10,0.2
560159900,1,9,1.0,10,0.1
560160228,10,19,10.0,29,0.3448275862068966
560169702,2,8,2.0,10,0.2
560172300,3,6,3.0,9,0.3333333333333333
560180372,2,8,2.0,10,0.2
560181799,2,8,2.0,10,0.2
560183307,3,7,3.0,10,0.3
560189183,6,4,4.0,10,0.4
560198832,6,13,6.0,19,0.3157894736842105
560199185,2,8,2.0,10,0.2
560199563,9,11,9.0,20,0.45
560205438,1,8,1.0,9,0.1111111111111111
560270762,6,4,4.0,10,0.4
560271145,1,8,1.0,9,0.1111111111111111
560271314,3,6,3.0,9,0.3333333333333333
560271993,1,8,1.0,9,0.1111111111111111
560272174,1,8,1.0,9,0.1111111111111111
560272325,3,7,3.0,10,0.3
560272642,6,4,4.0,10,0.4
560273302,4,6,4.0,10,0.4
560274166,4,6,4.0,10,0.4
560274360,1,8,1.0,9,0.1111111111111111
560329104,4,4,4.0,8,0.5
560329640,4,6,4.0,10,0.4
560382350,9,1,1.0,10,0.1
560421220,1,9,1.0,10,0.1
560440399,1,18,1.0,19,0.05263157894736842
560453875,8,1,1.0,9,0.1111111111111111
560462579,4,5,4.0,9,0.4444444444444444
560474010,1,9,1.0,10,0.1
560633328,2,8,2.0,10,0.2
560643780,1,9,1.0,10,0.1
560663576,1,9,1.0,10,0.1
560670621,1,18,1.0,19,0.05263157894736842
560689088,4,5,4.0,9,0.4444444444444444
560734607,1,8,1.0,9,0.1111111111111111
560762911,2,8,2.0,10,0.2
560763061,1,8,1.0,9,0.1111111111111111
560763454,1,7,1.0,8,0.125
560778256,4,6,4.0,10,0.4
560778444,5,5,5.0,10,0.5
560791904,5,5,5.0,10,0.5
560800015,2,7,2.0,9,0.2222222222222222
560800382,5,5,5.0,10,0.5
560800738,1,9,1.0,10,0.1
560820687,1,8,1.0,9,0.1111111111111111
560830416,7,3,3.0,10,0.3
560830978,5,5,5.0,10,0.5
560832803,7,3,3.0,10,0.3
560854004,10,19,10.0,29,0.3448275862068966
560858618,1,9,1.0,10,0.1
560951628,1,9,1.0,10,0.1
560952851,6,4,4.0,10,0.4
560957089,1,7,1.0,8,0.125
560957691,3,7,3.0,10,0.3
560958033,3,26,3.0,29,0.10344827586206896
561011544,1,9,1.0,10,0.1
561029297,1,8,1.0,9,0.1111111111111111
561043766,3,7,3.0,10,0.3
561047016,4,5,4.0,9,0.4444444444444444
561074753,1,9,1.0,10,0.1
561103407,3,7,3.0,10,0.3
561103610,2,8,2.0,10,0.2
561105222,10,14,10.0,24,0.4166666666666667
561171669,6,4,4.0,10,0.4
561206362,1,9,1.0,10,0.1
561261155,2,8,2.0,10,0.2
561295242,1,18,1.0,19,0.05263157894736842
561317280,6,4,4.0,10,0.4
561326786,2,7,2.0,9,0.2222222222222222
561331625,2,6,2.0,8,0.25
561337253,3,7,3.0,10,0.3
561351316,3,7,3.0,10,0.3
561353788,4,6,4.0,10,0.4
561388853,1,9,1.0,10,0.1
561413780,1,8,1.0,9,0.1111111111111111
561415902,1,9,1.0,10,0.1
561416617,3,6,3.0,9,0.3333333333333333
561416745,1,9,1.0,10,0.1
561419710,2,8,2.0,10,0.2
561422625,8,1,1.0,9,0.1111111111111111
561422901,5,3,3.0,8,0.375
561442090,1,9,1.0,10,0.1
561444169,8,2,2.0,10,0.2
561451104,17,12,12.0,29,0.41379310344827586
561455840,3,7,3.0,10,0.3
561457841,2,7,2.0,9,0.2222222222222222
561459645,4,6,4.0,10,0.4
561514072,2,7,2.0,9,0.2222222222222222
561523806,2,8,2.0,10,0.2
561526508,1,8,1.0,9,0.1111111111111111
561531516,6,4,4.0,10,0.4
561539694,1,7,1.0,8,0.125
561548972,4,6,4.0,10,0.4
561549250,5,5,5.0,10,0.5
561549488,6,3,3.0,9,0.3333333333333333
561574677,1,9,1.0,10,0.1
561577558,1,9,1.0,10,0.1
561579109,1,8,1.0,9,0.1111111111111111
561579254,2,8,2.0,10,0.2
561579345,1,9,1.0,10,0.1
561581899,1,17,1.0,18,0.05555555555555555
561582473,4,25,4.0,29,0.13793103448275862
561591279,1,18,1.0,19,0.05263157894736842
561603997,4,6,4.0,10,0.4
561606822,1,18,1.0,19,0.05263157894736842
561611970,2,17,2.0,19,0.10526315789473684
561612367,3,7,3.0,10,0.3
561612759,3,6,3.0,9,0.3333333333333333
561645894,3,17,3.0,20,0.15
561666760,1,9,1.0,10,0.1
561669892,26,4,4.0,30,0.13333333333333333
561670482,2,7,2.0,9,0.2222222222222222
561671843,1,18,1.0,19,0.05263157894736842
561677365,7,2,2.0,9,0.2222222222222222
561677590,9,1,1.0,10,0.1
561685766,2,7,2.0,9,0.2222222222222222
561685879,4,6,4.0,10,0.4
561729426,5,5,5.0,10,0.5
561730193,7,3,3.0,10,0.3
561732409,1,8,1.0,9,0.1111111111111111
561770613,5,5,5.0,10,0.5
561799997,1,9,1.0,10,0.1
561800144,6,4,4.0,10,0.4
561811606,9,1,1.0,10,0.1
561821200,3,7,3.0,10,0.3
561834118,42,3,3.0,45,0.06666666666666667
561846799,1,9,1.0,10,0.1
561849937,2,8,2.0,10,0.2
561850457,2,7,2.0,9,0.2222222222222222
561851120,3,7,3.0,10,0.3
561853671,1,9,1.0,10,0.1
561855691,3,7,3.0,10,0.3
561856160,2,8,2.0,10,0.2
561856437,1,8,1.0,9,0.1111111111111111
561856505,11,18,11.0,29,0.3793103448275862
561870840,9,11,9.0,20,0.45
561886510,1,9,1.0,10,0.1
561913535,2,8,2.0,10,0.2
561933952,2,8,2.0,10,0.2
561941656,1,9,1.0,10,0.1
561944258,1,8,1.0,9,0.1111111111111111
561964298,2,8,2.0,10,0.2
561966045,26,3,3.0,29,0.10344827586206896
561966661,8,2,2.0,10,0.2
562069713,2,7,2.0,9,0.2222222222222222
562070956,1,9,1.0,10,0.1
562088312,2,22,2.0,24,0.08333333333333333
562088783,1,9,1.0,10,0.1
562121825,4,6,4.0,10,0.4
562122412,3,6,3.0,9,0.3333333333333333
562168960,1,9,1.0,10,0.1
562199536,1,9,1.0,10,0.1
562199642,1,9,1.0,10,0.1
562201545,2,8,2.0,10,0.2
562206205,1,9,1.0,10,0.1
562206513,6,4,4.0,10,0.4
562214636,4,16,4.0,20,0.2
562284806,5,4,4.0,9,0.4444444444444444
562293726,4,6,4.0,10,0.4
562294868,2,8,2.0,10,0.2
562308343,1,19,1.0,20,0.05
562315334,2,17,2.0,19,0.10526315789473684
562317369,1,9,1.0,10,0.1
562323789,1,9,1.0,10,0.1
562334139,8,2,2.0,10,0.2
562334484,3,7,3.0,10,0.3
562382417,1,19,1.0,20,0.05
562406358,1,9,1.0,10,0.1
562457937,2,7,2.0,9,0.2222222222222222
562488387,1,9,1.0,10,0.1
562524213,22,6,6.0,28,0.21428571428571427
562524267,3,7,3.0,10,0.3
562524418,23,2,2.0,25,0.08
562524949,3,7,3.0,10,0.3
562526068,9,1,1.0,10,0.1
562526772,6,4,4.0,10,0.4
562527277,9,1,1.0,10,0.1
562531672,1,18,1.0,19,0.05263157894736842
562569112,1,8,1.0,9,0.1111111111111111
562585610,3,5,3.0,8,0.375
562599100,1,9,1.0,10,0.1
562599715,2,18,2.0,20,0.1
562600900,4,6,4.0,10,0.4
562602897,2,8,2.0,10,0.2
562605014,3,6,3.0,9,0.3333333333333333
562617350,2,18,2.0,20,0.1
562638558,9,1,1.0,10,0.1
562667750,2,6,2.0,8,0.25
562702506,1,16,1.0,17,0.058823529411764705
562703374,2,8,2.0,10,0.2
562703568,1,9,1.0,10,0.1
562704914,2,7,2.0,9,0.2222222222222222
562705224,5,5,5.0,10,0.5
562719948,1,7,1.0,8,0.125
562721235,1,9,1.0,10,0.1
562772669,3,6,3.0,9,0.3333333333333333
562774109,1,9,1.0,10,0.1
562784485,5,14,5.0,19,0.2631578947368421
562787590,4,6,4.0,10,0.4
562787955,1,9,1.0,10,0.1
562788938,5,4,4.0,9,0.4444444444444444
562791472,1,9,1.0,10,0.1
562791676,7,1,1.0,8,0.125
562807369,24,5,5.0,29,0.1724137931034483
562825571,1,9,1.0,10,0.1
562880702,1,7,1.0,8,0.125
562883516,3,27,3.0,30,0.1
562885106,1,7,1.0,8,0.125
562887697,3,6,3.0,9,0.3333333333333333
562888036,1,9,1.0,10,0.1
562889386,24,3,3.0,27,0.1111111111111111
562915344,7,1,1.0,8,0.125
562938932,3,7,3.0,10,0.3
562939063,2,8,2.0,10,0.2
562940606,1,8,1.0,9,0.1111111111111111
562940715,2,7,2.0,9,0.2222222222222222
562941015,4,5,4.0,9,0.4444444444444444
562941139,4,5,4.0,9,0.4444444444444444
562941252,2,7,2.0,9,0.2222222222222222
562944422,4,5,4.0,9,0.4444444444444444
562972492,2,8,2.0,10,0.2
562981894,5,25,5.0,30,0.16666666666666666
562987594,5,5,5.0,10,0.5
562987712,2,8,2.0,10,0.2
563003869,2,17,2.0,19,0.10526315789473684
563036236,2,8,2.0,10,0.2
563063782,1,8,1.0,9,0.1111111111111111
563065240,3,7,3.0,10,0.3
563176853,9,1,1.0,10,0.1
563226276,9,1,1.0,10,0.1
563239183,1,8,1.0,9,0.1111111111111111
563243970,2,8,2.0,10,0.2
563247929,2,8,2.0,10,0.2
563248351,1,9,1.0,10,0.1
563270399,4,5,4.0,9,0.4444444444444444
563403564,2,8,2.0,10,0.2
563418299,4,6,4.0,10,0.4
563490818,7,2,2.0,9,0.2222222222222222
563491661,1,9,1.0,10,0.1
563491769,1,9,1.0,10,0.1
563524721,1,8,1.0,9,0.1111111111111111
563540167,1,8,1.0,9,0.1111111111111111
563590756,1,18,1.0,19,0.05263157894736842
563620554,1,9,1.0,10,0.1
563684544,1,8,1.0,9,0.1111111111111111
563695445,1,7,1.0,8,0.125
563744814,1,17,1.0,18,0.05555555555555555
563746338,1,9,1.0,10,0.1
563786139,1,16,1.0,17,0.058823529411764705
563817615,2,8,2.0,10,0.2
563858843,1,16,1.0,17,0.058823529411764705
563873850,6,13,6.0,19,0.3157894736842105
563877612,1,9,1.0,10,0.1
563893268,2,7,2.0,9,0.2222222222222222
563893684,3,7,3.0,10,0.3
563927914,2,25,2.0,27,0.07407407407407407
563940694,2,8,2.0,10,0.2
563945908,6,4,4.0,10,0.4
563947102,4,6,4.0,10,0.4
563948142,5,5,5.0,10,0.5
563995228,8,1,1.0,9,0.1111111111111111
564028433,1,8,1.0,9,0.1111111111111111
564029003,2,8,2.0,10,0.2
564029779,3,7,3.0,10,0.3
564030329,7,3,3.0,10,0.3
564030804,1,18,1.0,19,0.05263157894736842
564035377,2,7,2.0,9,0.2222222222222222
564037655,3,7,3.0,10,0.3
564090348,1,9,1.0,10,0.1
564092502,1,9,1.0,10,0.1
564093860,4,6,4.0,10,0.4
564095467,1,9,1.0,10,0.1
564160885,1,7,1.0,8,0.125
564217775,1,17,1.0,18,0.05555555555555555
564222932,2,16,2.0,18,0.1111111111111111
564240667,2,15,2.0,17,0.11764705882352941
564266068,2,6,2.0,8,0.25
564266486,2,8,2.0,10,0.2
564268695,1,8,1.0,9,0.1111111111111111
564309682,2,17,2.0,19,0.10526315789473684
564386339,1,9,1.0,10,0.1
564408410,2,6,2.0,8,0.25
564468352,3,16,3.0,19,0.15789473684210525
564503835,1,9,1.0,10,0.1
564506845,2,7,2.0,9,0.2222222222222222
564508956,1,18,1.0,19,0.05263157894736842
564562455,1,9,1.0,10,0.1
564586520,1,9,1.0,10,0.1
564588404,6,4,4.0,10,0.4
564596412,4,5,4.0,9,0.4444444444444444
564606764,24,5,5.0,29,0.1724137931034483
564606914,8,2,2.0,10,0.2
564607292,29,1,1.0,30,0.03333333333333333
564607422,7,1,1.0,8,0.125
564607549,8,2,2.0,10,0.2
564629214,3,16,3.0,19,0.15789473684210525
564643521,2,8,2.0,10,0.2
564643729,1,9,1.0,10,0.1
564713223,2,8,2.0,10,0.2
564718074,3,17,3.0,20,0.15
564741813,2,8,2.0,10,0.2
564742865,1,8,1.0,9,0.1111111111111111
564743242,3,7,3.0,10,0.3
564743785,3,7,3.0,10,0.3
564751749,9,1,1.0,10,0.1
564784708,4,5,4.0,9,0.4444444444444444
564785369,4,6,4.0,10,0.4
564785720,5,4,4.0,9,0.4444444444444444
564786471,5,5,5.0,10,0.5
564787018,8,2,2.0,10,0.2
564787651,7,2,2.0,9,0.2222222222222222
564791195,7,3,3.0,10,0.3
564797655,2,8,2.0,10,0.2
564819092,3,17,3.0,20,0.15
564838794,1,9,1.0,10,0.1
564909393,3,7,3.0,10,0.3
564940072,2,8,2.0,10,0.2
564968529,1,9,1.0,10,0.1
564969570,5,4,4.0,9,0.4444444444444444
564971595,13,15,13.0,28,0.4642857142857143
564971942,3,7,3.0,10,0.3
564972387,3,7,3.0,10,0.3
564977119,1,9,1.0,10,0.1
564983510,8,2,2.0,10,0.2
564997506,9,1,1.0,10,0.1
565005759,2,8,2.0,10,0.2
565026949,1,9,1.0,10,0.1
565037218,2,8,2.0,10,0.2
565037911,2,7,2.0,9,0.2222222222222222
565039500,1,9,1.0,10,0.1
565040575,2,8,2.0,10,0.2
565041494,2,8,2.0,10,0.2
565044969,2,28,2.0,30,0.06666666666666667
565045527,1,7,1.0,8,0.125
565058607,7,2,2.0,9,0.2222222222222222
565059676,3,7,3.0,10,0.3
565060914,3,5,3.0,8,0.375
565068533,2,7,2.0,9,0.2222222222222222
565113266,1,9,1.0,10,0.1
565120931,2,8,2.0,10,0.2
565121207,2,8,2.0,10,0.2
565121411,3,25,3.0,28,0.10714285714285714
565122505,1,8,1.0,9,0.1111111111111111
565122738,1,9,1.0,10,0.1
565123010,4,5,4.0,9,0.4444444444444444
565123290,1,7,1.0,8,0.125
565124602,2,6,2.0,8,0.25
565126074,25,5,5.0,30,0.16666666666666666
565156515,1,9,1.0,10,0.1
565178239,1,7,1.0,8,0.125
565179888,1,7,1.0,8,0.125
565180715,5,5,5.0,10,0.5
565183108,2,6,2.0,8,0.25
565183449,1,19,1.0,20,0.05
565183746,1,8,1.0,9,0.1111111111111111
565229459,3,17,3.0,20,0.15
565299169,1,9,1.0,10,0.1
565306429,2,8,2.0,10,0.2
565335806,16,4,4.0,20,0.2
565347793,2,7,2.0,9,0.2222222222222222
565375675,1,9,1.0,10,0.1
565390686,8,2,2.0,10,0.2
565409378,1,8,1.0,9,0.1111111111111111
565480324,4,6,4.0,10,0.4
565480514,5,5,5.0,10,0.5
565493394,1,18,1.0,19,0.05263157894736842
565565971,2,8,2.0,10,0.2
565573931,1,8,1.0,9,0.1111111111111111
565574356,2,8,2.0,10,0.2
565578975,1,8,1.0,9,0.1111111111111111
565591548,3,7,3.0,10,0.3
565613375,2,6,2.0,8,0.25
565627716,4,5,4.0,9,0.4444444444444444
565628116,3,7,3.0,10,0.3
565642026,1,9,1.0,10,0.1
565665321,2,16,2.0,18,0.1111111111111111
565694253,1,9,1.0,10,0.1
565696835,2,8,2.0,10,0.2
565723050,2,18,2.0,20,0.1
565744870,3,6,3.0,9,0.3333333333333333
565757187,1,9,1.0,10,0.1
565767219,1,9,1.0,10,0.1
565768282,6,4,4.0,10,0.4
565769276,1,18,1.0,19,0.05263157894736842
565771642,2,8,2.0,10,0.2
565772047,7,3,3.0,10,0.3
565776101,1,18,1.0,19,0.05263157894736842
565776694,1,27,1.0,28,0.03571428571428571
565800008,3,7,3.0,10,0.3
565803282,1,8,1.0,9,0.1111111111111111
565827043,3,6,3.0,9,0.3333333333333333
565850603,2,16,2.0,18,0.1111111111111111
565906281,7,2,2.0,9,0.2222222222222222
565907529,8,2,2.0,10,0.2
565937600,2,8,2.0,10,0.2
565943745,1,16,1.0,17,0.058823529411764705
565979577,2,7,2.0,9,0.2222222222222222
565995674,3,7,3.0,10,0.3
565995821,2,7,2.0,9,0.2222222222222222
565995997,2,8,2.0,10,0.2
566015442,1,18,1.0,19,0.05263157894736842
566120336,4,6,4.0,10,0.4
566162866,2,7,2.0,9,0.2222222222222222
566196300,8,11,8.0,19,0.42105263157894735
566225799,1,17,1.0,18,0.05555555555555555
566331982,2,8,2.0,10,0.2
566387831,1,9,1.0,10,0.1
566419230,24,4,4.0,28,0.14285714285714285
566419895,4,6,4.0,10,0.4
566434745,1,28,1.0,29,0.034482758620689655
566439867,4,23,4.0,27,0.14814814814814814
566444369,6,23,6.0,29,0.20689655172413793
566475679,5,23,5.0,28,0.17857142857142858
566477319,1,9,1.0,10,0.1
566495245,2,8,2.0,10,0.2
566526439,9,1,1.0,10,0.1
566554999,1,17,1.0,18,0.05555555555555555
566587909,8,2,2.0,10,0.2
566602910,1,8,1.0,9,0.1111111111111111
566633595,5,4,4.0,9,0.4444444444444444
566706503,2,7,2.0,9,0.2222222222222222
566728074,1,9,1.0,10,0.1
566732245,1,8,1.0,9,0.1111111111111111
566741630,1,18,1.0,19,0.05263157894736842
566755542,2,8,2.0,10,0.2
566806836,2,7,2.0,9,0.2222222222222222
566807881,2,8,2.0,10,0.2
566808695,3,7,3.0,10,0.3
566809511,2,8,2.0,10,0.2
566811258,3,6,3.0,9,0.3333333333333333
566889671,1,18,1.0,19,0.05263157894736842
566915919,2,8,2.0,10,0.2
566938657,1,9,1.0,10,0.1
566953948,6,4,4.0,10,0.4
566991188,8,1,1.0,9,0.1111111111111111
567009936,10,17,10.0,27,0.37037037037037035
567009956,9,1,1.0,10,0.1
567009994,9,1,1.0,10,0.1
567010583,7,1,1.0,8,0.125
567011407,13,7,7.0,20,0.35
567018805,2,6,2.0,8,0.25
567025245,7,3,3.0,10,0.3
567036346,1,7,1.0,8,0.125
567056975,2,7,2.0,9,0.2222222222222222
567057023,7,3,3.0,10,0.3
567058389,1,29,1.0,30,0.03333333333333333
567058683,8,1,1.0,9,0.1111111111111111
567058719,1,8,1.0,9,0.1111111111111111
567064541,6,4,4.0,10,0.4
567064671,1,8,1.0,9,0.1111111111111111
567065106,6,4,4.0,10,0.4
567079463,3,6,3.0,9,0.3333333333333333
567080111,3,7,3.0,10,0.3
567081151,2,8,2.0,10,0.2
567081462,4,5,4.0,9,0.4444444444444444
567091587,3,5,3.0,8,0.375
567094302,2,17,2.0,19,0.10526315789473684
567094691,1,9,1.0,10,0.1
567095492,4,6,4.0,10,0.4
567097348,2,7,2.0,9,0.2222222222222222
567139085,4,6,4.0,10,0.4
567139300,6,4,4.0,10,0.4
567159046,1,9,1.0,10,0.1
567159737,1,9,1.0,10,0.1
567160841,3,17,3.0,20,0.15
567168968,1,9,1.0,10,0.1
567179635,2,7,2.0,9,0.2222222222222222
567195125,3,7,3.0,10,0.3
567195129,1,8,1.0,9,0.1111111111111111
567195136,4,6,4.0,10,0.4
567195139,2,8,2.0,10,0.2
567195158,2,7,2.0,9,0.2222222222222222
567279385,3,15,3.0,18,0.16666666666666666
567286212,2,7,2.0,9,0.2222222222222222
567352112,3,7,3.0,10,0.3
567394364,5,21,5.0,26,0.19230769230769232
567396133,2,8,2.0,10,0.2
567467620,3,6,3.0,9,0.3333333333333333
567468085,1,8,1.0,9,0.1111111111111111
567468860,2,6,2.0,8,0.25
567519655,1,9,1.0,10,0.1
567520886,3,25,3.0,28,0.10714285714285714
567558946,1,9,1.0,10,0.1
567573288,3,7,3.0,10,0.3
567681997,1,8,1.0,9,0.1111111111111111
567684851,2,8,2.0,10,0.2
567720018,1,7,1.0,8,0.125
567742033,2,7,2.0,9,0.2222222222222222
567748974,5,5,5.0,10,0.5
567781518,2,8,2.0,10,0.2
567782413,1,8,1.0,9,0.1111111111111111
567783407,1,9,1.0,10,0.1
567783516,5,5,5.0,10,0.5
567790314,1,7,1.0,8,0.125
567818047,3,7,3.0,10,0.3
567818299,3,7,3.0,10,0.3
567933726,5,5,5.0,10,0.5
567961878,1,8,1.0,9,0.1111111111111111
567964795,27,1,1.0,28,0.03571428571428571
568039124,5,15,5.0,20,0.25
568044285,1,17,1.0,18,0.05555555555555555
568044538,5,14,5.0,19,0.2631578947368421
568093986,6,3,3.0,9,0.3333333333333333
568136924,1,8,1.0,9,0.1111111111111111
568137203,3,7,3.0,10,0.3
568139831,6,4,4.0,10,0.4
568149144,2,7,2.0,9,0.2222222222222222
568209139,1,18,1.0,19,0.05263157894736842
568277227,2,17,2.0,19,0.10526315789473684
568284867,11,17,11.0,28,0.39285714285714285
568292660,6,3,3.0,9,0.3333333333333333
568295749,4,5,4.0,9,0.4444444444444444
568328746,2,6,2.0,8,0.25
568343364,10,15,10.0,25,0.4
568343392,7,22,7.0,29,0.2413793103448276
568352379,1,9,1.0,10,0.1
568369061,9,1,1.0,10,0.1
568380182,6,4,4.0,10,0.4
568388551,1,27,1.0,28,0.03571428571428571
568388765,2,8,2.0,10,0.2
568389193,1,9,1.0,10,0.1
568389811,1,8,1.0,9,0.1111111111111111
568419393,4,5,4.0,9,0.4444444444444444
568431241,7,2,2.0,9,0.2222222222222222
568439666,12,17,12.0,29,0.41379310344827586
568439894,3,7,3.0,10,0.3
568481582,1,7,1.0,8,0.125
568483045,1,9,1.0,10,0.1
568518410,4,6,4.0,10,0.4
568550213,10,19,10.0,29,0.3448275862068966
568566684,1,9,1.0,10,0.1
568575607,8,2,2.0,10,0.2
568580678,1,17,1.0,18,0.05555555555555555
568583669,5,5,5.0,10,0.5
568588244,3,7,3.0,10,0.3
568653964,3,7,3.0,10,0.3
568657676,5,5,5.0,10,0.5
568659409,2,7,2.0,9,0.2222222222222222
568665746,1,8,1.0,9,0.1111111111111111
568695460,1,19,1.0,20,0.05
568699595,3,6,3.0,9,0.3333333333333333
568712192,1,8,1.0,9,0.1111111111111111
568726355,1,9,1.0,10,0.1
568727142,2,8,2.0,10,0.2
568730454,12,18,12.0,30,0.4
568732409,1,18,1.0,19,0.05263157894736842
568732676,1,9,1.0,10,0.1
568732987,2,7,2.0,9,0.2222222222222222
568733749,4,6,4.0,10,0.4
568734240,3,6,3.0,9,0.3333333333333333
568734407,4,6,4.0,10,0.4
568734966,2,8,2.0,10,0.2
568735868,2,7,2.0,9,0.2222222222222222
568745320,1,18,1.0,19,0.05263157894736842
568763646,8,2,2.0,10,0.2
568763997,1,9,1.0,10,0.1
568847375,1,17,1.0,18,0.05555555555555555
568849012,2,8,2.0,10,0.2
568866400,4,6,4.0,10,0.4
568869375,4,6,4.0,10,0.4
568884797,1,9,1.0,10,0.1
568887533,3,7,3.0,10,0.3
568900846,1,19,1.0,20,0.05
569083876,21,7,7.0,28,0.25
569138324,2,8,2.0,10,0.2
569161651,4,6,4.0,10,0.4
569161866,2,8,2.0,10,0.2
569199217,2,8,2.0,10,0.2
569233592,1,8,1.0,9,0.1111111111111111
569274628,1,9,1.0,10,0.1
569294746,3,7,3.0,10,0.3
569297488,6,3,3.0,9,0.3333333333333333
569300509,1,9,1.0,10,0.1
569352183,1,16,1.0,17,0.058823529411764705
569390576,7,13,7.0,20,0.35
569431449,9,1,1.0,10,0.1
569431835,8,1,1.0,9,0.1111111111111111
569432045,7,3,3.0,10,0.3
569480284,5,4,4.0,9,0.4444444444444444
569598384,5,4,4.0,9,0.4444444444444444
569620260,5,4,4.0,9,0.4444444444444444
569634964,1,9,1.0,10,0.1
569635226,1,26,1.0,27,0.037037037037037035
569636878,6,3,3.0,9,0.3333333333333333
569637374,5,4,4.0,9,0.4444444444444444
569639272,1,18,1.0,19,0.05263157894736842
569696138,6,4,4.0,10,0.4
569696501,9,1,1.0,10,0.1
569696946,9,1,1.0,10,0.1
569698105,1,9,1.0,10,0.1
569717177,1,7,1.0,8,0.125
569779512,1,7,1.0,8,0.125
569788097,5,4,4.0,9,0.4444444444444444
569801442,1,9,1.0,10,0.1
569808645,1,8,1.0,9,0.1111111111111111
569830699,1,9,1.0,10,0.1
569831608,2,17,2.0,19,0.10526315789473684
569832154,2,7,2.0,9,0.2222222222222222
569859301,6,4,4.0,10,0.4
569867982,3,7,3.0,10,0.3
569879019,23,5,5.0,28,0.17857142857142858
569896500,4,5,4.0,9,0.4444444444444444
569899093,1,8,1.0,9,0.1111111111111111
569902619,1,9,1.0,10,0.1
569956173,2,17,2.0,19,0.10526315789473684
569995997,1,17,1.0,18,0.05555555555555555
570003092,1,8,1.0,9,0.1111111111111111
570004317,1,8,1.0,9,0.1111111111111111
570006427,5,5,5.0,10,0.5
570024624,3,7,3.0,10,0.3
570027654,7,12,7.0,19,0.3684210526315789
570053507,1,9,1.0,10,0.1
570060290,2,8,2.0,10,0.2
570063335,9,1,1.0,10,0.1
570130349,1,9,1.0,10,0.1
570167192,1,9,1.0,10,0.1
570168158,5,5,5.0,10,0.5
570168674,2,7,2.0,9,0.2222222222222222
570169522,6,4,4.0,10,0.4
570187742,3,7,3.0,10,0.3
570188640,9,1,1.0,10,0.1
570189452,1,9,1.0,10,0.1
570190701,4,21,4.0,25,0.16
570196239,1,9,1.0,10,0.1
570198126,1,9,1.0,10,0.1
570209968,18,7,7.0,25,0.28
570216502,1,26,1.0,27,0.037037037037037035
570217503,2,8,2.0,10,0.2
570218001,4,6,4.0,10,0.4
570218643,3,7,3.0,10,0.3
570218944,1,9,1.0,10,0.1
570222492,2,8,2.0,10,0.2
570312971,2,7,2.0,9,0.2222222222222222
570318312,2,17,2.0,19,0.10526315789473684
570322475,3,6,3.0,9,0.3333333333333333
570323820,2,27,2.0,29,0.06896551724137931
570332512,2,7,2.0,9,0.2222222222222222
570332657,3,7,3.0,10,0.3
570338864,1,9,1.0,10,0.1
570345817,8,2,2.0,10,0.2
570348095,12,16,12.0,28,0.42857142857142855
570348297,5,4,4.0,9,0.4444444444444444
570348343,1,7,1.0,8,0.125
570366977,9,1,1.0,10,0.1
570367530,5,3,3.0,8,0.375
570373081,1,18,1.0,19,0.05263157894736842
570400719,1,9,1.0,10,0.1
570423008,4,15,4.0,19,0.21052631578947367
570515820,2,8,2.0,10,0.2
570522558,1,19,1.0,20,0.05
570554433,1,8,1.0,9,0.1111111111111111
570562386,22,5,5.0,27,0.18518518518518517
570562462,3,7,3.0,10,0.3
570562613,4,26,4.0,30,0.13333333333333333
570567567,2,8,2.0,10,0.2
570567658,1,9,1.0,10,0.1
570597853,7,2,2.0,9,0.2222222222222222
570619554,9,1,1.0,10,0.1
570620409,3,6,3.0,9,0.3333333333333333
570620485,1,8,1.0,9,0.1111111111111111
570688160,4,6,4.0,10,0.4
570732964,1,8,1.0,9,0.1111111111111111
570737528,1,9,1.0,10,0.1
570739319,2,16,2.0,18,0.1111111111111111
570742750,2,7,2.0,9,0.2222222222222222
570757532,2,16,2.0,18,0.1111111111111111
570777347,1,8,1.0,9,0.1111111111111111
570794496,3,7,3.0,10,0.3
570811292,2,7,2.0,9,0.2222222222222222
570818083,8,2,2.0,10,0.2
570818130,6,4,4.0,10,0.4
570827658,1,7,1.0,8,0.125
570847293,1,9,1.0,10,0.1
570858590,1,18,1.0,19,0.05263157894736842
570870723,1,8,1.0,9,0.1111111111111111
570908676,3,5,3.0,8,0.375
570910210,1,8,1.0,9,0.1111111111111111
570913524,2,7,2.0,9,0.2222222222222222
570937296,2,17,2.0,19,0.10526315789473684
570974620,4,15,4.0,19,0.21052631578947367
570982145,2,8,2.0,10,0.2
570982421,3,7,3.0,10,0.3
570983268,1,9,1.0,10,0.1
570984550,1,8,1.0,9,0.1111111111111111
570987719,15,14,14.0,29,0.4827586206896552
570990543,4,5,4.0,9,0.4444444444444444
570997046,11,14,11.0,25,0.44
571000898,1,9,1.0,10,0.1
571004066,1,9,1.0,10,0.1
571006598,3,7,3.0,10,0.3
571016397,2,26,2.0,28,0.07142857142857142
571019699,3,7,3.0,10,0.3
571043686,26,1,1.0,27,0.037037037037037035
571043728,8,2,2.0,10,0.2
571049125,1,9,1.0,10,0.1
571058186,1,16,1.0,17,0.058823529411764705
571085065,3,17,3.0,20,0.15
571086365,1,8,1.0,9,0.1111111111111111
571104075,2,8,2.0,10,0.2
571117255,5,4,4.0,9,0.4444444444444444
571126160,1,7,1.0,8,0.125
571167252,1,8,1.0,9,0.1111111111111111
571172085,4,6,4.0,10,0.4
571217073,5,14,5.0,19,0.2631578947368421
571230371,3,7,3.0,10,0.3
571267467,1,8,1.0,9,0.1111111111111111
571280385,3,7,3.0,10,0.3
571287083,1,9,1.0,10,0.1
571288570,2,8,2.0,10,0.2
571291449,2,7,2.0,9,0.2222222222222222
571301481,4,6,4.0,10,0.4
571302605,1,8,1.0,9,0.1111111111111111
571303593,1,8,1.0,9,0.1111111111111111
571389536,1,8,1.0,9,0.1111111111111111
571451676,9,1,1.0,10,0.1
571451970,24,5,5.0,29,0.1724137931034483
571470537,1,8,1.0,9,0.1111111111111111
571470683,2,7,2.0,9,0.2222222222222222
571484150,1,9,1.0,10,0.1
571510030,1,9,1.0,10,0.1
571561191,3,6,3.0,9,0.3333333333333333
571563554,1,16,1.0,17,0.058823529411764705
571598177,2,25,2.0,27,0.07407407407407407
571662026,1,9,1.0,10,0.1
571662789,4,6,4.0,10,0.4
571682528,3,6,3.0,9,0.3333333333333333
571683715,1,9,1.0,10,0.1
571690597,1,17,1.0,18,0.05555555555555555
571691577,1,9,1.0,10,0.1
571700890,2,8,2.0,10,0.2
571712692,2,8,2.0,10,0.2
571712719,7,3,3.0,10,0.3
571712816,2,8,2.0,10,0.2
571715080,4,5,4.0,9,0.4444444444444444
571752769,1,9,1.0,10,0.1
571789799,8,20,8.0,28,0.2857142857142857
571790162,5,5,5.0,10,0.5
571791553,1,7,1.0,8,0.125
571791669,3,6,3.0,9,0.3333333333333333
571795201,2,8,2.0,10,0.2
571798447,8,1,1.0,9,0.1111111111111111
571806023,2,15,2.0,17,0.11764705882352941
571823260,2,8,2.0,10,0.2
571825772,1,18,1.0,19,0.05263157894736842
571836144,2,8,2.0,10,0.2
571837063,13,17,13.0,30,0.43333333333333335
571845179,1,9,1.0,10,0.1
571846697,2,8,2.0,10,0.2
571897963,4,6,4.0,10,0.4
571912632,3,7,3.0,10,0.3
571920779,1,19,1.0,20,0.05
571921499,1,9,1.0,10,0.1
571927527,6,3,3.0,9,0.3333333333333333
571930040,1,7,1.0,8,0.125
571944034,5,4,4.0,9,0.4444444444444444
571944504,4,6,4.0,10,0.4
571945366,5,5,5.0,10,0.5
571985683,2,8,2.0,10,0.2
571988061,3,6,3.0,9,0.3333333333333333
571995211,1,9,1.0,10,0.1
571996435,1,9,1.0,10,0.1
572001219,23,4,4.0,27,0.14814814814814814
572001276,21,8,8.0,29,0.27586206896551724
572021297,9,1,1.0,10,0.1
572061024,1,18,1.0,19,0.05263157894736842
572114235,3,7,3.0,10,0.3
572116126,1,9,1.0,10,0.1
572124689,2,8,2.0,10,0.2
572130791,3,17,3.0,20,0.15
572184140,1,9,1.0,10,0.1
572207572,2,18,2.0,20,0.1
572240800,3,7,3.0,10,0.3
572297366,3,7,3.0,10,0.3
572297717,1,9,1.0,10,0.1
572328380,4,6,4.0,10,0.4
572333228,1,9,1.0,10,0.1
572363843,2,7,2.0,9,0.2222222222222222
572445590,2,18,2.0,20,0.1
572465959,2,7,2.0,9,0.2222222222222222
572482569,1,18,1.0,19,0.05263157894736842
572483861,1,9,1.0,10,0.1
572526621,2,18,2.0,20,0.1
572532222,1,19,1.0,20,0.05
572541874,1,9,1.0,10,0.1
572546236,1,17,1.0,18,0.05555555555555555
572573909,1,18,1.0,19,0.05263157894736842
572580459,1,8,1.0,9,0.1111111111111111
572589231,2,7,2.0,9,0.2222222222222222
572591542,1,7,1.0,8,0.125
572664369,4,6,4.0,10,0.4
572672751,7,2,2.0,9,0.2222222222222222
572675131,5,4,4.0,9,0.4444444444444444
572675516,5,14,5.0,19,0.2631578947368421
572695793,1,9,1.0,10,0.1
572712335,1,9,1.0,10,0.1
572715075,1,9,1.0,10,0.1
572744726,1,9,1.0,10,0.1
572778130,2,6,2.0,8,0.25
572783458,9,1,1.0,10,0.1
572880523,1,9,1.0,10,0.1
572895863,1,9,1.0,10,0.1
572945513,3,7,3.0,10,0.3
572968319,1,9,1.0,10,0.1
572987325,1,9,1.0,10,0.1
572987557,1,9,1.0,10,0.1
572988150,7,3,3.0,10,0.3
573005620,4,6,4.0,10,0.4
573006126,2,17,2.0,19,0.10526315789473684
573008726,4,16,4.0,20,0.2
573009334,2,8,2.0,10,0.2
573011025,2,8,2.0,10,0.2
573025346,3,24,3.0,27,0.1111111111111111
573065135,3,6,3.0,9,0.3333333333333333
573065771,7,2,2.0,9,0.2222222222222222
573066619,20,8,8.0,28,0.2857142857142857
573067208,8,2,2.0,10,0.2
573076078,1,19,1.0,20,0.05
573077166,2,27,2.0,29,0.06896551724137931
573160153,9,1,1.0,10,0.1
573173899,3,6,3.0,9,0.3333333333333333
573175057,4,6,4.0,10,0.4
573176903,5,4,4.0,9,0.4444444444444444
573185898,1,9,1.0,10,0.1
573194885,1,9,1.0,10,0.1
573387025,1,9,1.0,10,0.1
573434099,1,9,1.0,10,0.1
573507706,1,19,1.0,20,0.05
573528331,1,9,1.0,10,0.1
573540887,1,9,1.0,10,0.1
573590190,8,2,2.0,10,0.2
573591644,1,9,1.0,10,0.1
573597815,1,9,1.0,10,0.1
573615476,2,7,2.0,9,0.2222222222222222
573670882,2,7,2.0,9,0.2222222222222222
573672802,2,8,2.0,10,0.2
573676132,1,19,1.0,20,0.05
573676258,1,9,1.0,10,0.1
573692858,7,1,1.0,8,0.125
573725158,5,5,5.0,10,0.5
573725444,1,9,1.0,10,0.1
573742434,2,8,2.0,10,0.2
573745688,3,7,3.0,10,0.3
573784836,1,9,1.0,10,0.1
573802187,1,7,1.0,8,0.125
573803559,8,2,2.0,10,0.2
573806680,9,1,1.0,10,0.1
573919147,20,8,8.0,28,0.2857142857142857
573929779,2,8,2.0,10,0.2
573938150,1,9,1.0,10,0.1
573977059,5,4,4.0,9,0.4444444444444444
574023624,6,4,4.0,10,0.4
574037635,5,5,5.0,10,0.5
574063983,2,7,2.0,9,0.2222222222222222
574064937,1,8,1.0,9,0.1111111111111111
574065993,1,17,1.0,18,0.05555555555555555
574075337,1,9,1.0,10,0.1
574090689,1,8,1.0,9,0.1111111111111111
574093283,1,9,1.0,10,0.1
574106263,1,9,1.0,10,0.1
574143946,2,18,2.0,20,0.1
574149519,2,8,2.0,10,0.2
574181846,2,7,2.0,9,0.2222222222222222
574186082,1,8,1.0,9,0.1111111111111111
574217639,2,8,2.0,10,0.2
574221731,4,6,4.0,10,0.4
574278856,1,8,1.0,9,0.1111111111111111
574336664,1,7,1.0,8,0.125
574421291,1,9,1.0,10,0.1
574447184,5,4,4.0,9,0.4444444444444444
574460538,6,4,4.0,10,0.4
574462527,1,9,1.0,10,0.1
574463076,4,6,4.0,10,0.4
574516766,1,7,1.0,8,0.125
574526821,1,9,1.0,10,0.1
574549639,22,4,4.0,26,0.15384615384615385
574551523,2,8,2.0,10,0.2
574627600,1,16,1.0,17,0.058823529411764705
574627981,1,8,1.0,9,0.1111111111111111
574656497,1,8,1.0,9,0.1111111111111111
574757615,13,14,13.0,27,0.48148148148148145
574759104,3,6,3.0,9,0.3333333333333333
574778174,2,15,2.0,17,0.11764705882352941
574790279,1,18,1.0,19,0.05263157894736842
574824415,2,7,2.0,9,0.2222222222222222
574853658,1,18,1.0,19,0.05263157894736842
574896691,1,8,1.0,9,0.1111111111111111
574940818,6,3,3.0,9,0.3333333333333333
574948297,3,15,3.0,18,0.16666666666666666
574949073,1,9,1.0,10,0.1
574951514,7,2,2.0,9,0.2222222222222222
574951897,2,8,2.0,10,0.2
574963380,2,8,2.0,10,0.2
574966130,2,8,2.0,10,0.2
574977790,9,1,1.0,10,0.1
574982316,4,6,4.0,10,0.4
574989968,5,5,5.0,10,0.5
574990279,3,7,3.0,10,0.3
574990312,2,8,2.0,10,0.2
574994048,5,5,5.0,10,0.5
575000234,5,5,5.0,10,0.5
575000694,2,8,2.0,10,0.2
575024293,2,8,2.0,10,0.2
575123407,1,8,1.0,9,0.1111111111111111
575212650,1,9,1.0,10,0.1
575250887,1,9,1.0,10,0.1
575254295,1,18,1.0,19,0.05263157894736842
575255167,4,5,4.0,9,0.4444444444444444
575256877,7,2,2.0,9,0.2222222222222222
575258200,3,5,3.0,8,0.375
575315551,15,14,14.0,29,0.4827586206896552
575324658,2,8,2.0,10,0.2
575352509,2,17,2.0,19,0.10526315789473684
575374588,5,5,5.0,10,0.5
575379300,4,5,4.0,9,0.4444444444444444
575382402,4,15,4.0,19,0.21052631578947367
575382613,1,9,1.0,10,0.1
575382787,1,9,1.0,10,0.1
575456350,1,9,1.0,10,0.1
575515054,2,7,2.0,9,0.2222222222222222
575529784,7,3,3.0,10,0.3
575545701,1,15,1.0,16,0.0625
575592196,2,17,2.0,19,0.10526315789473684
575613967,9,17,9.0,26,0.34615384615384615
575676889,1,7,1.0,8,0.125
575677344,2,27,2.0,29,0.06896551724137931
575697061,1,9,1.0,10,0.1
575700976,3,7,3.0,10,0.3
575707074,3,7,3.0,10,0.3
575732728,1,8,1.0,9,0.1111111111111111
575740914,3,7,3.0,10,0.3
575741356,6,4,4.0,10,0.4
575743542,1,7,1.0,8,0.125
575758442,1,9,1.0,10,0.1
575759065,2,26,2.0,28,0.07142857142857142
575787500,2,8,2.0,10,0.2
575804007,4,6,4.0,10,0.4
575804638,1,9,1.0,10,0.1
575804827,1,9,1.0,10,0.1
575805754,2,7,2.0,9,0.2222222222222222
575820295,6,4,4.0,10,0.4
575827597,7,3,3.0,10,0.3
575828037,3,7,3.0,10,0.3
575831158,5,23,5.0,28,0.17857142857142858
575865881,3,6,3.0,9,0.3333333333333333
575866801,2,7,2.0,9,0.2222222222222222
575870094,1,8,1.0,9,0.1111111111111111
575873796,1,9,1.0,10,0.1
575881013,4,6,4.0,10,0.4
575881885,2,7,2.0,9,0.2222222222222222
575882223,4,6,4.0,10,0.4
575882961,3,7,3.0,10,0.3
575909103,5,14,5.0,19,0.2631578947368421
575917795,1,9,1.0,10,0.1
575943057,12,15,12.0,27,0.4444444444444444
575967955,1,8,1.0,9,0.1111111111111111
575968463,1,29,1.0,30,0.03333333333333333
576000972,3,7,3.0,10,0.3
576015713,7,1,1.0,8,0.125
576052852,7,2,2.0,9,0.2222222222222222
576053294,1,9,1.0,10,0.1
576055452,2,8,2.0,10,0.2
576086292,1,18,1.0,19,0.05263157894736842
576086359,4,6,4.0,10,0.4
576214285,2,26,2.0,28,0.07142857142857142
576214862,2,7,2.0,9,0.2222222222222222
576216506,1,7,1.0,8,0.125
576223669,6,24,6.0,30,0.2
576226963,8,2,2.0,10,0.2
576227764,1,9,1.0,10,0.1
576228476,2,8,2.0,10,0.2
576279191,2,8,2.0,10,0.2
576288316,2,7,2.0,9,0.2222222222222222
576322979,3,14,3.0,17,0.17647058823529413
576332438,1,27,1.0,28,0.03571428571428571
576340193,1,8,1.0,9,0.1111111111111111
576413465,9,1,1.0,10,0.1
576425397,6,4,4.0,10,0.4
576425831,3,6,3.0,9,0.3333333333333333
576426723,4,5,4.0,9,0.4444444444444444
576427906,2,8,2.0,10,0.2
576429011,1,7,1.0,8,0.125
576451328,5,23,5.0,28,0.17857142857142858
576486820,9,1,1.0,10,0.1
576560660,3,5,3.0,8,0.375
576560726,1,7,1.0,8,0.125
576570824,1,9,1.0,10,0.1
576578388,3,7,3.0,10,0.3
576595002,7,2,2.0,9,0.2222222222222222
576596417,6,3,3.0,9,0.3333333333333333
576596932,2,18,2.0,20,0.1
576597317,7,2,2.0,9,0.2222222222222222
576607203,1,8,1.0,9,0.1111111111111111
576661145,1,15,1.0,16,0.0625
576696823,4,5,4.0,9,0.4444444444444444
576701811,2,7,2.0,9,0.2222222222222222
576724437,2,8,2.0,10,0.2
576725131,2,8,2.0,10,0.2
576742314,5,5,5.0,10,0.5
576742721,4,5,4.0,9,0.4444444444444444
576767650,1,9,1.0,10,0.1
576768773,2,7,2.0,9,0.2222222222222222
576769016,1,9,1.0,10,0.1
576770191,3,7,3.0,10,0.3
576771118,8,1,1.0,9,0.1111111111111111
576771606,1,8,1.0,9,0.1111111111111111
576771858,6,4,4.0,10,0.4
576772021,6,4,4.0,10,0.4
576773909,4,6,4.0,10,0.4
576774833,1,19,1.0,20,0.05
576796106,2,7,2.0,9,0.2222222222222222
576850969,7,3,3.0,10,0.3
576856144,5,14,5.0,19,0.2631578947368421
576875792,1,8,1.0,9,0.1111111111111111
576876291,1,9,1.0,10,0.1
576899391,2,7,2.0,9,0.2222222222222222
576914510,7,3,3.0,10,0.3
576925393,4,25,4.0,29,0.13793103448275862
576926492,8,20,8.0,28,0.2857142857142857
576932073,3,7,3.0,10,0.3
576932166,2,18,2.0,20,0.1
576932405,5,5,5.0,10,0.5
576949567,9,1,1.0,10,0.1
576951343,1,9,1.0,10,0.1
576951516,6,4,4.0,10,0.4
576962874,8,2,2.0,10,0.2
576964354,8,1,1.0,9,0.1111111111111111
576971413,1,8,1.0,9,0.1111111111111111
576974914,3,7,3.0,10,0.3
576975886,6,4,4.0,10,0.4
576976967,6,3,3.0,9,0.3333333333333333
576980023,2,7,2.0,9,0.2222222222222222
576986689,2,8,2.0,10,0.2
577002283,26,1,1.0,27,0.037037037037037035
577003179,1,8,1.0,9,0.1111111111111111
577029208,5,5,5.0,10,0.5
577035464,1,8,1.0,9,0.1111111111111111
577039207,8,2,2.0,10,0.2
577071610,24,5,5.0,29,0.1724137931034483
577073554,4,6,4.0,10,0.4
577074254,1,9,1.0,10,0.1
577130068,1,9,1.0,10,0.1
577158008,1,18,1.0,19,0.05263157894736842
577179351,5,5,5.0,10,0.5
577184329,5,5,5.0,10,0.5
577190880,9,1,1.0,10,0.1
577225448,5,5,5.0,10,0.5
577295461,1,18,1.0,19,0.05263157894736842
577319031,8,2,2.0,10,0.2
577336048,1,8,1.0,9,0.1111111111111111
577348879,1,9,1.0,10,0.1
577387348,2,8,2.0,10,0.2
577409216,2,8,2.0,10,0.2
577478223,1,17,1.0,18,0.05555555555555555
577500062,1,9,1.0,10,0.1
577500391,4,6,4.0,10,0.4
577556551,1,7,1.0,8,0.125
577561631,2,8,2.0,10,0.2
577596095,1,9,1.0,10,0.1
577618771,1,9,1.0,10,0.1
577624367,1,9,1.0,10,0.1
577630068,1,8,1.0,9,0.1111111111111111
577630260,1,8,1.0,9,0.1111111111111111
577631025,6,3,3.0,9,0.3333333333333333
577632867,1,9,1.0,10,0.1
577633431,1,9,1.0,10,0.1
577649143,1,18,1.0,19,0.05263157894736842
577650765,6,4,4.0,10,0.4
577681256,2,8,2.0,10,0.2
577686704,2,8,2.0,10,0.2
577711003,1,9,1.0,10,0.1
577715726,14,16,14.0,30,0.4666666666666667
577717734,3,5,3.0,8,0.375
577732962,2,25,2.0,27,0.07407407407407407
577736437,2,8,2.0,10,0.2
577743385,1,9,1.0,10,0.1
577750690,1,9,1.0,10,0.1
577789717,9,18,9.0,27,0.3333333333333333
577808689,6,3,3.0,9,0.3333333333333333
577835294,1,8,1.0,9,0.1111111111111111
577840520,1,8,1.0,9,0.1111111111111111
577849587,2,18,2.0,20,0.1
577859352,1,19,1.0,20,0.05
577889340,4,25,4.0,29,0.13793103448275862
577910713,2,8,2.0,10,0.2
577911909,1,7,1.0,8,0.125
577941988,1,7,1.0,8,0.125
577961387,1,9,1.0,10,0.1
578026878,1,19,1.0,20,0.05
578042543,2,16,2.0,18,0.1111111111111111
578047925,1,9,1.0,10,0.1
578099028,2,8,2.0,10,0.2
578106349,11,16,11.0,27,0.4074074074074074
578161149,1,8,1.0,9,0.1111111111111111
578186311,1,27,1.0,28,0.03571428571428571
578313039,3,5,3.0,8,0.375
578327817,2,14,2.0,16,0.125
578356586,1,24,1.0,25,0.04
578372790,4,4,4.0,8,0.5
578400982,1,7,1.0,8,0.125
578513358,1,18,1.0,19,0.05263157894736842
578515880,8,2,2.0,10,0.2
578524497,5,5,5.0,10,0.5
578555800,1,9,1.0,10,0.1
578589806,1,9,1.0,10,0.1
578648266,1,8,1.0,9,0.1111111111111111
578700308,1,8,1.0,9,0.1111111111111111
578791751,1,9,1.0,10,0.1
578793167,1,19,1.0,20,0.05
578806477,3,6,3.0,9,0.3333333333333333
578820627,2,17,2.0,19,0.10526315789473684
578821581,1,8,1.0,9,0.1111111111111111
578831536,3,26,3.0,29,0.10344827586206896
578858211,1,9,1.0,10,0.1
578872612,1,7,1.0,8,0.125
578894094,1,16,1.0,17,0.058823529411764705
578969120,4,22,4.0,26,0.15384615384615385
578980901,2,8,2.0,10,0.2
579057828,1,9,1.0,10,0.1
579068451,1,8,1.0,9,0.1111111111111111
579071330,1,8,1.0,9,0.1111111111111111
579085456,7,3,3.0,10,0.3
579104888,2,8,2.0,10,0.2
579104967,1,8,1.0,9,0.1111111111111111
579157760,1,17,1.0,18,0.05555555555555555
579158466,2,8,2.0,10,0.2
579261640,2,18,2.0,20,0.1
579277951,1,8,1.0,9,0.1111111111111111
579359383,1,18,1.0,19,0.05263157894736842
579369842,5,4,4.0,9,0.4444444444444444
579371676,2,8,2.0,10,0.2
579372126,1,8,1.0,9,0.1111111111111111
579396535,1,19,1.0,20,0.05
579450821,1,19,1.0,20,0.05
579488759,1,16,1.0,17,0.058823529411764705
579512844,3,7,3.0,10,0.3
579521777,3,6,3.0,9,0.3333333333333333
579544192,1,9,1.0,10,0.1
579544671,1,19,1.0,20,0.05
579547146,5,15,5.0,20,0.25
579549413,1,9,1.0,10,0.1
579552965,3,7,3.0,10,0.3
579556999,1,9,1.0,10,0.1
579619396,1,7,1.0,8,0.125
579619539,1,8,1.0,9,0.1111111111111111
579622496,3,6,3.0,9,0.3333333333333333
579626113,4,6,4.0,10,0.4
579626310,1,9,1.0,10,0.1
579628408,2,8,2.0,10,0.2
579633206,1,18,1.0,19,0.05263157894736842
579637717,2,8,2.0,10,0.2
579637801,3,6,3.0,9,0.3333333333333333
579641213,1,26,1.0,27,0.037037037037037035
579646750,1,9,1.0,10,0.1
579674983,1,9,1.0,10,0.1
579680674,1,18,1.0,19,0.05263157894736842
579693123,2,8,2.0,10,0.2
579709486,1,9,1.0,10,0.1
579725512,9,18,9.0,27,0.3333333333333333
579767138,2,28,2.0,30,0.06666666666666667
579767589,7,19,7.0,26,0.2692307692307692
579776044,9,9,9.0,18,0.5
579792890,2,8,2.0,10,0.2
579794092,1,9,1.0,10,0.1
579800728,3,6,3.0,9,0.3333333333333333
579801033,1,9,1.0,10,0.1
579807616,1,9,1.0,10,0.1
579815380,4,6,4.0,10,0.4
579836659,1,9,1.0,10,0.1
579863062,1,19,1.0,20,0.05
579868296,26,3,3.0,29,0.10344827586206896
579883521,2,8,2.0,10,0.2
579897114,2,7,2.0,9,0.2222222222222222
579899848,8,1,1.0,9,0.1111111111111111
579900171,7,2,2.0,9,0.2222222222222222
579900647,7,1,1.0,8,0.125
579907052,3,7,3.0,10,0.3
579920051,6,23,6.0,29,0.20689655172413793
579921362,1,7,1.0,8,0.125
579921394,3,7,3.0,10,0.3
579975143,1,8,1.0,9,0.1111111111111111
579986655,10,17,10.0,27,0.37037037037037035
580001336,1,7,1.0,8,0.125
580050187,3,7,3.0,10,0.3
580051157,3,7,3.0,10,0.3
580070888,2,8,2.0,10,0.2
580071153,3,7,3.0,10,0.3
580082379,1,19,1.0,20,0.05
580089963,1,9,1.0,10,0.1
580090200,2,27,2.0,29,0.06896551724137931
580092326,3,7,3.0,10,0.3
580123822,3,17,3.0,20,0.15
580128336,1,9,1.0,10,0.1
580134026,1,8,1.0,9,0.1111111111111111
580154399,9,1,1.0,10,0.1
580157051,5,5,5.0,10,0.5
580164250,3,7,3.0,10,0.3
580204288,3,6,3.0,9,0.3333333333333333
580206250,2,17,2.0,19,0.10526315789473684
580222650,2,8,2.0,10,0.2
580255377,1,8,1.0,9,0.1111111111111111
580263084,2,8,2.0,10,0.2
580282201,2,8,2.0,10,0.2
580388339,1,7,1.0,8,0.125
580469584,1,8,1.0,9,0.1111111111111111
580476888,2,8,2.0,10,0.2
580477369,1,7,1.0,8,0.125
580477389,1,8,1.0,9,0.1111111111111111
580484722,2,8,2.0,10,0.2
580509986,2,7,2.0,9,0.2222222222222222
580515263,1,9,1.0,10,0.1
580518484,1,9,1.0,10,0.1
580520114,1,8,1.0,9,0.1111111111111111
580520746,2,8,2.0,10,0.2
580525820,10,16,10.0,26,0.38461538461538464
580526102,1,9,1.0,10,0.1
580537524,4,13,4.0,17,0.23529411764705882
580559598,5,22,5.0,27,0.18518518518518517
580559845,3,6,3.0,9,0.3333333333333333
580560156,2,8,2.0,10,0.2
580563835,1,9,1.0,10,0.1
580564980,3,6,3.0,9,0.3333333333333333
580617125,3,16,3.0,19,0.15789473684210525
580617667,1,7,1.0,8,0.125
580638720,1,9,1.0,10,0.1
580681102,7,3,3.0,10,0.3
580690510,1,9,1.0,10,0.1
580692241,1,9,1.0,10,0.1
580699070,5,5,5.0,10,0.5
580700108,5,23,5.0,28,0.17857142857142858
580704410,2,25,2.0,27,0.07407407407407407
580722399,4,5,4.0,9,0.4444444444444444
580723511,8,2,2.0,10,0.2
580724876,9,19,9.0,28,0.32142857142857145
580726703,5,23,5.0,28,0.17857142857142858
580749366,4,5,4.0,9,0.4444444444444444
580815972,2,8,2.0,10,0.2
580828581,2,7,2.0,9,0.2222222222222222
580840947,2,7,2.0,9,0.2222222222222222
580846862,14,4,4.0,18,0.2222222222222222
580855036,2,8,2.0,10,0.2
580858792,5,5,5.0,10,0.5
580860026,15,14,14.0,29,0.4827586206896552
580860840,28,2,2.0,30,0.06666666666666667
580865389,24,4,4.0,28,0.14285714285714285
580879757,1,8,1.0,9,0.1111111111111111
580886380,1,17,1.0,18,0.05555555555555555
580905695,5,5,5.0,10,0.5
580936229,1,19,1.0,20,0.05
580962267,2,16,2.0,18,0.1111111111111111
580979285,2,8,2.0,10,0.2
580987742,2,17,2.0,19,0.10526315789473684
580998766,2,8,2.0,10,0.2
581001823,2,8,2.0,10,0.2
581001975,2,7,2.0,9,0.2222222222222222
581021955,1,7,1.0,8,0.125
581050399,4,6,4.0,10,0.4
581062354,1,9,1.0,10,0.1
581094136,10,17,10.0,27,0.37037037037037035
581112549,3,26,3.0,29,0.10344827586206896
581115921,8,2,2.0,10,0.2
581116143,4,6,4.0,10,0.4
581131105,3,7,3.0,10,0.3
581147028,1,9,1.0,10,0.1
581169128,20,8,8.0,28,0.2857142857142857
581178094,3,5,3.0,8,0.375
581178845,2,18,2.0,20,0.1
581179450,1,9,1.0,10,0.1
581181547,1,9,1.0,10,0.1
581184263,5,5,5.0,10,0.5
581185919,6,3,3.0,9,0.3333333333333333
581190609,1,8,1.0,9,0.1111111111111111
581195670,1,19,1.0,20,0.05
581212769,4,5,4.0,9,0.4444444444444444
581213120,4,6,4.0,10,0.4
581225492,3,25,3.0,28,0.10714285714285714
581227358,2,6,2.0,8,0.25
581229632,2,8,2.0,10,0.2
581236331,1,7,1.0,8,0.125
581247126,6,4,4.0,10,0.4
581292720,1,8,1.0,9,0.1111111111111111
581305978,4,5,4.0,9,0.4444444444444444
581335624,5,15,5.0,20,0.25
581371000,1,9,1.0,10,0.1
581372734,2,16,2.0,18,0.1111111111111111
581373194,1,19,1.0,20,0.05
581375877,2,8,2.0,10,0.2
581432308,1,9,1.0,10,0.1
581441949,1,9,1.0,10,0.1
581486176,1,8,1.0,9,0.1111111111111111
581490418,1,18,1.0,19,0.05263157894736842
581492269,2,7,2.0,9,0.2222222222222222
581543096,1,8,1.0,9,0.1111111111111111
581592024,1,29,1.0,30,0.03333333333333333
581593174,2,24,2.0,26,0.07692307692307693
581658166,1,18,1.0,19,0.05263157894736842
581672323,6,3,3.0,9,0.3333333333333333
581677653,1,9,1.0,10,0.1
581731724,1,9,1.0,10,0.1
581744149,1,18,1.0,19,0.05263157894736842
581825154,1,9,1.0,10,0.1
581826294,1,8,1.0,9,0.1111111111111111
581843487,8,11,8.0,19,0.42105263157894735
581890869,6,4,4.0,10,0.4
581891994,4,6,4.0,10,0.4
581897455,1,9,1.0,10,0.1
581926835,2,18,2.0,20,0.1
581948730,1,18,1.0,19,0.05263157894736842
581957732,2,8,2.0,10,0.2
581957939,8,1,1.0,9,0.1111111111111111
581960140,3,7,3.0,10,0.3
581964604,1,8,1.0,9,0.1111111111111111
581985222,5,4,4.0,9,0.4444444444444444
581986227,8,2,2.0,10,0.2
582001759,1,9,1.0,10,0.1
582006796,1,8,1.0,9,0.1111111111111111
582031219,1,18,1.0,19,0.05263157894736842
582057860,6,3,3.0,9,0.3333333333333333
582073698,1,8,1.0,9,0.1111111111111111
582087223,1,19,1.0,20,0.05
582105837,2,6,2.0,8,0.25
582112699,2,17,2.0,19,0.10526315789473684
582152931,1,9,1.0,10,0.1
582177589,1,7,1.0,8,0.125
582231953,6,14,6.0,20,0.3
582241987,2,8,2.0,10,0.2
582252698,7,23,7.0,30,0.23333333333333334
582296173,6,4,4.0,10,0.4
582296501,9,1,1.0,10,0.1
582296670,7,3,3.0,10,0.3
582296984,7,13,7.0,20,0.35
582297376,2,8,2.0,10,0.2
582299266,1,9,1.0,10,0.1
582299378,1,8,1.0,9,0.1111111111111111
582300203,2,6,2.0,8,0.25
582300479,3,7,3.0,10,0.3
582301505,4,6,4.0,10,0.4
582304504,4,21,4.0,25,0.16
582320168,1,9,1.0,10,0.1
582370843,2,8,2.0,10,0.2
582401286,2,8,2.0,10,0.2
582416156,1,9,1.0,10,0.1
582457016,2,7,2.0,9,0.2222222222222222
582527392,1,18,1.0,19,0.05263157894736842
582573354,2,17,2.0,19,0.10526315789473684
582577385,4,4,4.0,8,0.5
582604319,7,3,3.0,10,0.3
582604663,2,8,2.0,10,0.2
582615400,1,9,1.0,10,0.1
582625876,3,25,3.0,28,0.10714285714285714
582630042,1,19,1.0,20,0.05
582696123,7,2,2.0,9,0.2222222222222222
582696632,3,6,3.0,9,0.3333333333333333
582718880,6,4,4.0,10,0.4
582763474,1,19,1.0,20,0.05
582773467,1,9,1.0,10,0.1
582864610,2,8,2.0,10,0.2
582913876,2,8,2.0,10,0.2
582915534,3,7,3.0,10,0.3
582916257,1,9,1.0,10,0.1
582917552,1,9,1.0,10,0.1
582918542,1,9,1.0,10,0.1
582939127,1,18,1.0,19,0.05263157894736842
582940563,1,9,1.0,10,0.1
582946115,1,9,1.0,10,0.1
582992032,2,18,2.0,20,0.1
583009324,1,17,1.0,18,0.05555555555555555
583032999,1,9,1.0,10,0.1
583054026,1,28,1.0,29,0.034482758620689655
583074851,8,1,1.0,9,0.1111111111111111
583079910,28,1,1.0,29,0.034482758620689655
583087467,1,19,1.0,20,0.05
583127139,12,18,12.0,30,0.4
583132234,1,9,1.0,10,0.1
583282124,6,4,4.0,10,0.4
583347299,1,8,1.0,9,0.1111111111111111
583348175,6,2,2.0,8,0.25
583387831,2,8,2.0,10,0.2
583430466,2,17,2.0,19,0.10526315789473684
583450207,9,1,1.0,10,0.1
583483339,1,8,1.0,9,0.1111111111111111
583486287,1,8,1.0,9,0.1111111111111111
583551689,1,9,1.0,10,0.1
583619051,1,15,1.0,16,0.0625
583650668,4,6,4.0,10,0.4
583669546,1,9,1.0,10,0.1
583686721,12,7,7.0,19,0.3684210526315789
583707792,1,9,1.0,10,0.1
583733748,1,9,1.0,10,0.1
583797628,3,6,3.0,9,0.3333333333333333
583801464,2,8,2.0,10,0.2
583815640,9,1,1.0,10,0.1
583815841,8,1,1.0,9,0.1111111111111111
583815986,13,7,7.0,20,0.35
583816231,10,9,9.0,19,0.47368421052631576
583820910,5,4,4.0,9,0.4444444444444444
583926806,7,3,3.0,10,0.3
583926949,1,9,1.0,10,0.1
583927307,1,9,1.0,10,0.1
583936976,1,9,1.0,10,0.1
583967001,1,9,1.0,10,0.1
584019034,2,7,2.0,9,0.2222222222222222
584019187,5,4,4.0,9,0.4444444444444444
584080358,1,9,1.0,10,0.1
584221778,3,7,3.0,10,0.3
584223296,1,7,1.0,8,0.125
584226824,1,8,1.0,9,0.1111111111111111
584280550,3,6,3.0,9,0.3333333333333333
584281154,3,6,3.0,9,0.3333333333333333
584318072,4,6,4.0,10,0.4
584352848,1,7,1.0,8,0.125
584428159,2,7,2.0,9,0.2222222222222222
584429338,2,7,2.0,9,0.2222222222222222
584452057,14,6,6.0,20,0.3
584485475,1,9,1.0,10,0.1
584488103,2,8,2.0,10,0.2
584520290,2,7,2.0,9,0.2222222222222222
584649291,2,8,2.0,10,0.2
584660732,5,4,4.0,9,0.4444444444444444
584684867,1,9,1.0,10,0.1
584762524,2,7,2.0,9,0.2222222222222222
584799710,1,9,1.0,10,0.1
584809271,3,7,3.0,10,0.3
584829264,1,8,1.0,9,0.1111111111111111
584844414,1,18,1.0,19,0.05263157894736842
584849840,3,6,3.0,9,0.3333333333333333
584851924,1,15,1.0,16,0.0625
584857436,8,2,2.0,10,0.2
584869081,18,11,11.0,29,0.3793103448275862
584869495,9,1,1.0,10,0.1
584870069,8,2,2.0,10,0.2
584870222,5,5,5.0,10,0.5
584870432,23,4,4.0,27,0.14814814814814814
584903812,1,18,1.0,19,0.05263157894736842
585023249,1,9,1.0,10,0.1
585034829,4,6,4.0,10,0.4
585061484,1,9,1.0,10,0.1
585085237,1,18,1.0,19,0.05263157894736842
585085673,5,24,5.0,29,0.1724137931034483
585117200,1,9,1.0,10,0.1
585121785,3,5,3.0,8,0.375
585159110,2,7,2.0,9,0.2222222222222222
585163691,1,9,1.0,10,0.1
585223749,1,17,1.0,18,0.05555555555555555
585224408,2,7,2.0,9,0.2222222222222222
585350632,9,10,9.0,19,0.47368421052631576
585369477,5,5,5.0,10,0.5
585374603,1,9,1.0,10,0.1
585388333,1,8,1.0,9,0.1111111111111111
585410112,2,17,2.0,19,0.10526315789473684
585422836,3,6,3.0,9,0.3333333333333333
585628803,23,6,6.0,29,0.20689655172413793
585728332,1,7,1.0,8,0.125
585749836,1,9,1.0,10,0.1
585785627,2,7,2.0,9,0.2222222222222222
585789765,1,8,1.0,9,0.1111111111111111
585806884,2,7,2.0,9,0.2222222222222222
585873787,4,6,4.0,10,0.4
585963898,4,5,4.0,9,0.4444444444444444
585970684,1,9,1.0,10,0.1
585997907,1,9,1.0,10,0.1
586018711,25,3,3.0,28,0.10714285714285714
586019275,8,1,1.0,9,0.1111111111111111
586019387,7,3,3.0,10,0.3
586019920,5,5,5.0,10,0.5
586020068,5,4,4.0,9,0.4444444444444444
586075305,3,6,3.0,9,0.3333333333333333
586088976,5,5,5.0,10,0.5
586202945,2,7,2.0,9,0.2222222222222222
586206412,7,3,3.0,10,0.3
586238784,2,7,2.0,9,0.2222222222222222
586242626,1,8,1.0,9,0.1111111111111111
586244745,2,17,2.0,19,0.10526315789473684
586248990,2,8,2.0,10,0.2
586249526,4,6,4.0,10,0.4
586262237,2,7,2.0,9,0.2222222222222222
586293525,1,7,1.0,8,0.125
586300471,5,3,3.0,8,0.375
586307235,1,9,1.0,10,0.1
586308207,5,5,5.0,10,0.5
586309542,1,8,1.0,9,0.1111111111111111
586411921,6,4,4.0,10,0.4
586446701,5,4,4.0,9,0.4444444444444444
586451859,6,14,6.0,20,0.3
586532191,2,7,2.0,9,0.2222222222222222
586544241,1,7,1.0,8,0.125
586559878,1,8,1.0,9,0.1111111111111111
586576570,1,9,1.0,10,0.1
586598465,5,14,5.0,19,0.2631578947368421
586635412,14,15,14.0,29,0.4827586206896552
586636745,1,7,1.0,8,0.125
586648748,2,6,2.0,8,0.25
586683800,9,1,1.0,10,0.1
586685811,5,4,4.0,9,0.4444444444444444
586688430,2,8,2.0,10,0.2
586690530,1,9,1.0,10,0.1
586696438,2,8,2.0,10,0.2
586700680,8,2,2.0,10,0.2
586719915,22,4,4.0,26,0.15384615384615385
586731394,8,1,1.0,9,0.1111111111111111
586788965,5,4,4.0,9,0.4444444444444444
586801247,1,9,1.0,10,0.1
586808010,1,9,1.0,10,0.1
586810696,1,8,1.0,9,0.1111111111111111
586837409,1,9,1.0,10,0.1
586966708,1,9,1.0,10,0.1
586997347,1,9,1.0,10,0.1
587027264,1,7,1.0,8,0.125
587027945,2,6,2.0,8,0.25
587029089,1,9,1.0,10,0.1
587128739,1,9,1.0,10,0.1
587136067,1,9,1.0,10,0.1
587149301,7,3,3.0,10,0.3
587213286,4,6,4.0,10,0.4
587213618,1,9,1.0,10,0.1
587216970,2,8,2.0,10,0.2
587273522,1,18,1.0,19,0.05263157894736842
587358853,9,10,9.0,19,0.47368421052631576
587373953,1,9,1.0,10,0.1
587379312,2,8,2.0,10,0.2
587425376,6,4,4.0,10,0.4
587439042,7,3,3.0,10,0.3
587461604,3,7,3.0,10,0.3
587461814,5,15,5.0,20,0.25
587501008,1,9,1.0,10,0.1
587560045,18,1,1.0,19,0.05263157894736842
587582659,3,6,3.0,9,0.3333333333333333
587582796,8,1,1.0,9,0.1111111111111111
587583086,8,2,2.0,10,0.2
587583242,2,8,2.0,10,0.2
587594678,11,14,11.0,25,0.44
587606871,3,6,3.0,9,0.3333333333333333
587611430,7,3,3.0,10,0.3
587616723,2,16,2.0,18,0.1111111111111111
587630657,17,12,12.0,29,0.41379310344827586
587671794,5,4,4.0,9,0.4444444444444444
587677397,6,4,4.0,10,0.4
587688264,2,18,2.0,20,0.1
587700941,1,9,1.0,10,0.1
587716326,6,4,4.0,10,0.4
587716906,9,1,1.0,10,0.1
587719429,5,3,3.0,8,0.375
587719515,9,1,1.0,10,0.1
587719613,24,3,3.0,27,0.1111111111111111
587719927,9,1,1.0,10,0.1
587720213,5,5,5.0,10,0.5
587720289,7,3,3.0,10,0.3
587720411,5,5,5.0,10,0.5
587720484,2,8,2.0,10,0.2
587720556,8,1,1.0,9,0.1111111111111111
587720637,4,4,4.0,8,0.5
587721021,8,1,1.0,9,0.1111111111111111
587721095,9,1,1.0,10,0.1
587721250,5,4,4.0,9,0.4444444444444444
587721420,8,2,2.0,10,0.2
587721510,4,5,4.0,9,0.4444444444444444
587721582,7,3,3.0,10,0.3
587747029,1,9,1.0,10,0.1
587782872,3,7,3.0,10,0.3
587786023,7,2,2.0,9,0.2222222222222222
587792842,8,2,2.0,10,0.2
587794456,8,1,1.0,9,0.1111111111111111
587795087,8,1,1.0,9,0.1111111111111111
587795473,1,9,1.0,10,0.1
587818068,1,17,1.0,18,0.05555555555555555
587820722,1,9,1.0,10,0.1
587834858,6,4,4.0,10,0.4
587886446,2,7,2.0,9,0.2222222222222222
587917818,1,18,1.0,19,0.05263157894736842
587923237,1,9,1.0,10,0.1
587995275,1,9,1.0,10,0.1
587998610,3,17,3.0,20,0.15
588001418,1,9,1.0,10,0.1
588004487,1,17,1.0,18,0.05555555555555555
588020328,3,7,3.0,10,0.3
588021858,4,6,4.0,10,0.4
588022096,1,9,1.0,10,0.1
588022253,2,7,2.0,9,0.2222222222222222
588094428,9,1,1.0,10,0.1
588223874,1,19,1.0,20,0.05
588225110,3,7,3.0,10,0.3
588237357,1,18,1.0,19,0.05263157894736842
588245280,1,7,1.0,8,0.125
588260118,2,8,2.0,10,0.2
588264443,6,3,3.0,9,0.3333333333333333
588279176,2,8,2.0,10,0.2
588313021,1,7,1.0,8,0.125
588313891,15,14,14.0,29,0.4827586206896552
588316839,3,7,3.0,10,0.3
588338701,1,8,1.0,9,0.1111111111111111
588343264,9,1,1.0,10,0.1
588350111,1,25,1.0,26,0.038461538461538464
588352184,1,9,1.0,10,0.1
588352274,5,14,5.0,19,0.2631578947368421
588352696,6,4,4.0,10,0.4
588372240,1,9,1.0,10,0.1
588378594,2,8,2.0,10,0.2
588384564,2,7,2.0,9,0.2222222222222222
588387446,1,9,1.0,10,0.1
588396898,1,9,1.0,10,0.1
588397248,1,9,1.0,10,0.1
588398224,2,6,2.0,8,0.25
588452274,1,8,1.0,9,0.1111111111111111
588480231,1,9,1.0,10,0.1
588488069,4,4,4.0,8,0.5
588525122,4,6,4.0,10,0.4
588560344,1,8,1.0,9,0.1111111111111111
588562165,1,7,1.0,8,0.125
588566094,1,9,1.0,10,0.1
588587817,2,8,2.0,10,0.2
588589634,1,18,1.0,19,0.05263157894736842
588604047,1,9,1.0,10,0.1
588604926,1,8,1.0,9,0.1111111111111111
588609210,1,9,1.0,10,0.1
588648623,1,9,1.0,10,0.1
588655374,2,7,2.0,9,0.2222222222222222
588674661,1,9,1.0,10,0.1
588678902,8,1,1.0,9,0.1111111111111111
588679460,2,8,2.0,10,0.2
588679703,5,14,5.0,19,0.2631578947368421
588702707,1,9,1.0,10,0.1
588711502,1,27,1.0,28,0.03571428571428571
588711622,5,5,5.0,10,0.5
588717594,11,17,11.0,28,0.39285714285714285
588718252,2,8,2.0,10,0.2
588737106,3,7,3.0,10,0.3
588738320,2,7,2.0,9,0.2222222222222222
588744035,3,17,3.0,20,0.15
588755132,1,9,1.0,10,0.1
588758550,3,7,3.0,10,0.3
588769828,1,9,1.0,10,0.1
588771510,4,6,4.0,10,0.4
588794314,1,9,1.0,10,0.1
588805827,7,2,2.0,9,0.2222222222222222
588817559,4,15,4.0,19,0.21052631578947367
588818701,2,7,2.0,9,0.2222222222222222
588830260,1,9,1.0,10,0.1
588834830,2,8,2.0,10,0.2
588839601,6,3,3.0,9,0.3333333333333333
588844595,1,18,1.0,19,0.05263157894736842
588861990,1,19,1.0,20,0.05
588872123,8,2,2.0,10,0.2
588990762,1,8,1.0,9,0.1111111111111111
589006459,1,9,1.0,10,0.1
589015561,1,9,1.0,10,0.1
589039509,2,8,2.0,10,0.2
589050939,3,7,3.0,10,0.3
589052705,3,7,3.0,10,0.3
589055340,3,6,3.0,9,0.3333333333333333
589056957,6,4,4.0,10,0.4
589059608,1,7,1.0,8,0.125
589081671,3,6,3.0,9,0.3333333333333333
589084174,1,19,1.0,20,0.05
589100039,1,7,1.0,8,0.125
589116868,1,9,1.0,10,0.1
589117071,4,6,4.0,10,0.4
589117139,1,8,1.0,9,0.1111111111111111
589117336,1,7,1.0,8,0.125
589119957,1,8,1.0,9,0.1111111111111111
589203052,1,8,1.0,9,0.1111111111111111
589203653,1,8,1.0,9,0.1111111111111111
589262094,9,1,1.0,10,0.1
589275937,3,7,3.0,10,0.3
589294031,9,1,1.0,10,0.1
589385726,1,7,1.0,8,0.125
589393537,5,4,4.0,9,0.4444444444444444
589395162,3,7,3.0,10,0.3
589396985,4,5,4.0,9,0.4444444444444444
589402748,1,8,1.0,9,0.1111111111111111
589402977,1,7,1.0,8,0.125
589451241,1,19,1.0,20,0.05
589451985,3,6,3.0,9,0.3333333333333333
589452907,4,5,4.0,9,0.4444444444444444
589466864,2,8,2.0,10,0.2
589489106,1,9,1.0,10,0.1
589494448,5,5,5.0,10,0.5
589494861,7,3,3.0,10,0.3
589507786,1,9,1.0,10,0.1
589535665,1,9,1.0,10,0.1
589596666,12,8,8.0,20,0.4
589658040,7,3,3.0,10,0.3
589741867,4,6,4.0,10,0.4
589773756,3,7,3.0,10,0.3
589777211,2,8,2.0,10,0.2
589798337,1,9,1.0,10,0.1
589884856,2,8,2.0,10,0.2
589897127,1,8,1.0,9,0.1111111111111111
589941266,1,9,1.0,10,0.1
589958525,1,9,1.0,10,0.1
589961950,8,2,2.0,10,0.2
590009998,1,8,1.0,9,0.1111111111111111
590028186,1,19,1.0,20,0.05
590076111,1,8,1.0,9,0.1111111111111111
590076886,1,27,1.0,28,0.03571428571428571
590097351,2,8,2.0,10,0.2
590140885,1,9,1.0,10,0.1
590153836,2,8,2.0,10,0.2
590262031,1,9,1.0,10,0.1
590263404,3,7,3.0,10,0.3
590287826,3,7,3.0,10,0.3
590291694,2,6,2.0,8,0.25
590293670,3,7,3.0,10,0.3
590301027,4,5,4.0,9,0.4444444444444444
590301294,4,6,4.0,10,0.4
590309309,3,7,3.0,10,0.3
590310945,7,3,3.0,10,0.3
590342758,2,8,2.0,10,0.2
590371877,1,7,1.0,8,0.125
590374717,2,8,2.0,10,0.2
590375091,4,6,4.0,10,0.4
590376841,6,4,4.0,10,0.4
590381144,2,8,2.0,10,0.2
590388458,2,8,2.0,10,0.2
590393528,5,23,5.0,28,0.17857142857142858
590416645,2,18,2.0,20,0.1
590478431,6,4,4.0,10,0.4
590518008,1,9,1.0,10,0.1
590522944,1,8,1.0,9,0.1111111111111111
590528859,2,17,2.0,19,0.10526315789473684
590529138,2,8,2.0,10,0.2
590536342,3,7,3.0,10,0.3
590552846,9,1,1.0,10,0.1
590559937,1,9,1.0,10,0.1
590612771,7,13,7.0,20,0.35
590650337,4,6,4.0,10,0.4
590652591,3,16,3.0,19,0.15789473684210525
590665343,2,8,2.0,10,0.2
590768759,1,8,1.0,9,0.1111111111111111
590774555,6,3,3.0,9,0.3333333333333333
590776779,6,3,3.0,9,0.3333333333333333
590802068,1,28,1.0,29,0.034482758620689655
590807064,1,8,1.0,9,0.1111111111111111
590840525,4,6,4.0,10,0.4
590886789,1,8,1.0,9,0.1111111111111111
590915709,1,8,1.0,9,0.1111111111111111
590917787,1,9,1.0,10,0.1
590919622,2,26,2.0,28,0.07142857142857142
590926613,3,6,3.0,9,0.3333333333333333
590928326,3,7,3.0,10,0.3
591114626,2,8,2.0,10,0.2
591124544,4,5,4.0,9,0.4444444444444444
591228595,1,8,1.0,9,0.1111111111111111
591253128,3,6,3.0,9,0.3333333333333333
591283827,2,8,2.0,10,0.2
591315178,3,7,3.0,10,0.3
591320106,1,7,1.0,8,0.125
591335035,1,8,1.0,9,0.1111111111111111
591362717,2,7,2.0,9,0.2222222222222222
591363258,1,9,1.0,10,0.1
591363961,1,7,1.0,8,0.125
591364297,2,7,2.0,9,0.2222222222222222
591367000,1,8,1.0,9,0.1111111111111111
591372907,1,8,1.0,9,0.1111111111111111
591406618,9,1,1.0,10,0.1
591407217,6,4,4.0,10,0.4
591423189,1,28,1.0,29,0.034482758620689655
591424046,1,9,1.0,10,0.1
591426530,1,17,1.0,18,0.05555555555555555
591460693,2,8,2.0,10,0.2
591484130,2,17,2.0,19,0.10526315789473684
591579563,12,17,12.0,29,0.41379310344827586
591595652,5,5,5.0,10,0.5
591622961,3,24,3.0,27,0.1111111111111111
591663902,8,1,1.0,9,0.1111111111111111
591675990,1,8,1.0,9,0.1111111111111111
591690543,2,8,2.0,10,0.2
591721853,1,9,1.0,10,0.1
591726469,1,8,1.0,9,0.1111111111111111
591772545,1,8,1.0,9,0.1111111111111111
591774757,8,21,8.0,29,0.27586206896551724
591775217,4,5,4.0,9,0.4444444444444444
591780880,2,6,2.0,8,0.25
591834146,6,4,4.0,10,0.4
591842759,3,16,3.0,19,0.15789473684210525
591904282,4,16,4.0,20,0.2
591933435,1,8,1.0,9,0.1111111111111111
591966449,5,13,5.0,18,0.2777777777777778
591972990,1,18,1.0,19,0.05263157894736842
591998796,1,8,1.0,9,0.1111111111111111
592007112,1,8,1.0,9,0.1111111111111111
592027893,10,17,10.0,27,0.37037037037037035
592028504,1,28,1.0,29,0.034482758620689655
592093525,1,17,1.0,18,0.05555555555555555
592126866,2,8,2.0,10,0.2
592136704,1,18,1.0,19,0.05263157894736842
592139704,7,12,7.0,19,0.3684210526315789
592139968,17,11,11.0,28,0.39285714285714285
592148683,1,8,1.0,9,0.1111111111111111
592152952,4,6,4.0,10,0.4
592153523,5,3,3.0,8,0.375
592153541,1,7,1.0,8,0.125
592182936,1,9,1.0,10,0.1
592193549,1,9,1.0,10,0.1
592197218,1,8,1.0,9,0.1111111111111111
592226514,4,14,4.0,18,0.2222222222222222
592238856,7,1,1.0,8,0.125
592252616,1,8,1.0,9,0.1111111111111111
592252948,17,3,3.0,20,0.15
592254745,3,7,3.0,10,0.3
592255227,11,15,11.0,26,0.4230769230769231
592255541,1,9,1.0,10,0.1
592269856,2,7,2.0,9,0.2222222222222222
592272171,3,5,3.0,8,0.375
592275464,1,9,1.0,10,0.1
592281116,1,9,1.0,10,0.1
592283701,1,8,1.0,9,0.1111111111111111
592284037,1,9,1.0,10,0.1
592360254,1,19,1.0,20,0.05
592365744,6,4,4.0,10,0.4
592388125,2,8,2.0,10,0.2
592396436,1,8,1.0,9,0.1111111111111111
592406154,1,9,1.0,10,0.1
592424060,10,8,8.0,18,0.4444444444444444
592472798,2,8,2.0,10,0.2
592473452,6,3,3.0,9,0.3333333333333333
592478037,5,5,5.0,10,0.5
592479222,5,4,4.0,9,0.4444444444444444
592479424,4,5,4.0,9,0.4444444444444444
592481435,3,6,3.0,9,0.3333333333333333
592481785,4,6,4.0,10,0.4
592518765,3,7,3.0,10,0.3
592534756,1,9,1.0,10,0.1
592556286,2,7,2.0,9,0.2222222222222222
592585792,2,7,2.0,9,0.2222222222222222
592589165,1,9,1.0,10,0.1
592623624,2,8,2.0,10,0.2
592694930,1,8,1.0,9,0.1111111111111111
592714906,5,5,5.0,10,0.5
592715316,8,1,1.0,9,0.1111111111111111
592715401,8,1,1.0,9,0.1111111111111111
592748320,4,6,4.0,10,0.4
592749277,2,8,2.0,10,0.2
592751530,7,23,7.0,30,0.23333333333333334
592757727,5,4,4.0,9,0.4444444444444444
592759367,1,19,1.0,20,0.05
592770495,1,18,1.0,19,0.05263157894736842
592770717,1,8,1.0,9,0.1111111111111111
592771049,1,9,1.0,10,0.1
592774072,3,7,3.0,10,0.3
592776826,1,9,1.0,10,0.1
592781380,1,9,1.0,10,0.1
592785653,1,26,1.0,27,0.037037037037037035
592786880,4,23,4.0,27,0.14814814814814814
592789151,1,8,1.0,9,0.1111111111111111
592825886,1,7,1.0,8,0.125
592845799,1,9,1.0,10,0.1
592848003,2,26,2.0,28,0.07142857142857142
592849041,3,6,3.0,9,0.3333333333333333
592849526,1,9,1.0,10,0.1
592849628,1,18,1.0,19,0.05263157894736842
592858101,1,9,1.0,10,0.1
592859151,1,9,1.0,10,0.1
592872878,9,1,1.0,10,0.1
592943729,3,7,3.0,10,0.3
592944456,3,7,3.0,10,0.3
592960063,5,5,5.0,10,0.5
592985241,1,19,1.0,20,0.05
593049862,1,9,1.0,10,0.1
593055543,3,7,3.0,10,0.3
593081201,2,8,2.0,10,0.2
593108564,1,9,1.0,10,0.1
593129226,3,5,3.0,8,0.375
593181015,2,8,2.0,10,0.2
593202135,2,7,2.0,9,0.2222222222222222
593238941,1,7,1.0,8,0.125
593248681,1,9,1.0,10,0.1
593249405,6,4,4.0,10,0.4
593249527,7,1,1.0,8,0.125
593259941,1,9,1.0,10,0.1
593284348,1,9,1.0,10,0.1
593285333,1,9,1.0,10,0.1
593285523,1,7,1.0,8,0.125
593287952,4,6,4.0,10,0.4
593327379,5,14,5.0,19,0.2631578947368421
593343511,8,2,2.0,10,0.2
593347031,1,7,1.0,8,0.125
593349974,2,6,2.0,8,0.25
593364521,1,9,1.0,10,0.1
593366008,4,6,4.0,10,0.4
593375187,2,8,2.0,10,0.2
593379033,1,8,1.0,9,0.1111111111111111
593381640,3,6,3.0,9,0.3333333333333333
593417229,5,5,5.0,10,0.5
593448646,1,9,1.0,10,0.1
593507933,3,6,3.0,9,0.3333333333333333
593511967,2,6,2.0,8,0.25
593549117,3,17,3.0,20,0.15
593575705,1,19,1.0,20,0.05
593610239,1,8,1.0,9,0.1111111111111111
593626173,9,1,1.0,10,0.1
593650263,2,7,2.0,9,0.2222222222222222
593659720,2,8,2.0,10,0.2
593663362,2,18,2.0,20,0.1
593701323,1,18,1.0,19,0.05263157894736842
593761826,7,22,7.0,29,0.2413793103448276
593768963,2,8,2.0,10,0.2
593770883,1,19,1.0,20,0.05
593794212,1,8,1.0,9,0.1111111111111111
593825287,2,26,2.0,28,0.07142857142857142
593829739,2,8,2.0,10,0.2
593830158,8,22,8.0,30,0.26666666666666666
593837296,3,16,3.0,19,0.15789473684210525
593837566,1,7,1.0,8,0.125
593840815,1,9,1.0,10,0.1
593878579,2,28,2.0,30,0.06666666666666667
593881186,4,5,4.0,9,0.4444444444444444
593907609,7,3,3.0,10,0.3
593907868,5,4,4.0,9,0.4444444444444444
593926134,1,7,1.0,8,0.125
593956418,4,6,4.0,10,0.4
593964721,1,8,1.0,9,0.1111111111111111
593973030,1,8,1.0,9,0.1111111111111111
594034818,2,8,2.0,10,0.2
594046006,1,8,1.0,9,0.1111111111111111
594065344,1,9,1.0,10,0.1
594066763,1,9,1.0,10,0.1
594067449,1,27,1.0,28,0.03571428571428571
594072349,1,8,1.0,9,0.1111111111111111
594082913,2,8,2.0,10,0.2
594083164,3,6,3.0,9,0.3333333333333333
594083851,3,6,3.0,9,0.3333333333333333
594084193,1,9,1.0,10,0.1
594086572,2,8,2.0,10,0.2
594102890,1,8,1.0,9,0.1111111111111111
594213461,3,7,3.0,10,0.3
594271742,1,8,1.0,9,0.1111111111111111
594272201,2,7,2.0,9,0.2222222222222222
594274850,5,4,4.0,9,0.4444444444444444
594276754,2,27,2.0,29,0.06896551724137931
594311516,1,8,1.0,9,0.1111111111111111
594314166,3,7,3.0,10,0.3
594314718,1,7,1.0,8,0.125
594349839,1,9,1.0,10,0.1
594359262,1,8,1.0,9,0.1111111111111111
594361477,2,8,2.0,10,0.2
594361772,2,6,2.0,8,0.25
594363241,4,6,4.0,10,0.4
594365769,1,26,1.0,27,0.037037037037037035
594367330,1,8,1.0,9,0.1111111111111111
594385979,1,9,1.0,10,0.1
594386117,1,8,1.0,9,0.1111111111111111
594386237,5,5,5.0,10,0.5
594387161,1,9,1.0,10,0.1
594388694,9,1,1.0,10,0.1
594389598,8,2,2.0,10,0.2
594426251,3,16,3.0,19,0.15789473684210525
594449800,1,19,1.0,20,0.05
594460032,1,8,1.0,9,0.1111111111111111
594467481,2,8,2.0,10,0.2
594467720,1,9,1.0,10,0.1
594468475,5,5,5.0,10,0.5
594468544,7,2,2.0,9,0.2222222222222222
594472650,1,8,1.0,9,0.1111111111111111
594495116,1,9,1.0,10,0.1
594542215,1,9,1.0,10,0.1
594555779,17,1,1.0,18,0.05555555555555555
594555846,8,2,2.0,10,0.2
594555934,8,1,1.0,9,0.1111111111111111
594556005,17,3,3.0,20,0.15
594556522,2,7,2.0,9,0.2222222222222222
594556793,8,1,1.0,9,0.1111111111111111
594557737,9,1,1.0,10,0.1
594557864,9,1,1.0,10,0.1
594596360,3,7,3.0,10,0.3
594604581,3,24,3.0,27,0.1111111111111111
594605776,7,21,7.0,28,0.25
594606883,4,5,4.0,9,0.4444444444444444
594607852,3,6,3.0,9,0.3333333333333333
594612029,5,3,3.0,8,0.375
594622960,1,9,1.0,10,0.1
594629316,3,5,3.0,8,0.375
594670766,3,7,3.0,10,0.3
594695514,1,7,1.0,8,0.125
594757921,1,7,1.0,8,0.125
594766282,2,8,2.0,10,0.2
594767135,1,9,1.0,10,0.1
594767192,14,16,14.0,30,0.4666666666666667
594767926,1,8,1.0,9,0.1111111111111111
594787152,28,1,1.0,29,0.034482758620689655
594796305,5,4,4.0,9,0.4444444444444444
594818933,1,17,1.0,18,0.05555555555555555
594847540,1,9,1.0,10,0.1
594874614,4,5,4.0,9,0.4444444444444444
594876992,1,18,1.0,19,0.05263157894736842
594888453,1,9,1.0,10,0.1
594893280,1,18,1.0,19,0.05263157894736842
594941524,5,5,5.0,10,0.5
595042828,3,6,3.0,9,0.3333333333333333
595046065,1,9,1.0,10,0.1
595048403,4,5,4.0,9,0.4444444444444444
595077227,2,6,2.0,8,0.25
595077313,3,7,3.0,10,0.3
595164616,2,8,2.0,10,0.2
595334531,1,8,1.0,9,0.1111111111111111
595343926,1,9,1.0,10,0.1
595455177,2,16,2.0,18,0.1111111111111111
595526569,3,7,3.0,10,0.3
595530605,1,9,1.0,10,0.1
595531678,5,4,4.0,9,0.4444444444444444
595533584,1,9,1.0,10,0.1
595535007,5,4,4.0,9,0.4444444444444444
595561699,1,7,1.0,8,0.125
595585914,1,8,1.0,9,0.1111111111111111
595589581,1,8,1.0,9,0.1111111111111111
595629774,4,6,4.0,10,0.4
595665818,5,5,5.0,10,0.5
595670850,2,8,2.0,10,0.2
595672029,5,4,4.0,9,0.4444444444444444
595674883,3,7,3.0,10,0.3
595679788,1,9,1.0,10,0.1
595712146,1,18,1.0,19,0.05263157894736842
595762051,2,18,2.0,20,0.1
595771149,1,18,1.0,19,0.05263157894736842
595784451,3,16,3.0,19,0.15789473684210525
595786102,2,8,2.0,10,0.2
595787434,1,9,1.0,10,0.1
595803987,2,7,2.0,9,0.2222222222222222
595823002,1,26,1.0,27,0.037037037037037035
595843148,4,15,4.0,19,0.21052631578947367
595845967,1,9,1.0,10,0.1
595863702,2,18,2.0,20,0.1
595905701,6,24,6.0,30,0.2
595931914,2,15,2.0,17,0.11764705882352941
595948761,16,6,6.0,22,0.2727272727272727
596000840,4,5,4.0,9,0.4444444444444444
596033184,4,16,4.0,20,0.2
596057195,9,1,1.0,10,0.1
596073144,1,9,1.0,10,0.1
596076377,1,9,1.0,10,0.1
596077003,2,26,2.0,28,0.07142857142857142
596083836,1,9,1.0,10,0.1
596098722,1,9,1.0,10,0.1
596102799,3,7,3.0,10,0.3
596111069,2,8,2.0,10,0.2
596114949,1,7,1.0,8,0.125
596115045,8,1,1.0,9,0.1111111111111111
596118151,1,27,1.0,28,0.03571428571428571
596143189,9,1,1.0,10,0.1
596143287,1,8,1.0,9,0.1111111111111111
596143597,2,6,2.0,8,0.25
596147503,2,7,2.0,9,0.2222222222222222
596163695,7,3,3.0,10,0.3
596182531,7,3,3.0,10,0.3
596195447,3,5,3.0,8,0.375
596246089,6,4,4.0,10,0.4
596262950,1,8,1.0,9,0.1111111111111111
596263156,1,8,1.0,9,0.1111111111111111
596272500,2,6,2.0,8,0.25
596282873,1,8,1.0,9,0.1111111111111111
596288339,1,9,1.0,10,0.1
596291381,1,19,1.0,20,0.05
596302504,8,2,2.0,10,0.2
596304622,9,1,1.0,10,0.1
596304628,8,2,2.0,10,0.2
596305455,15,3,3.0,18,0.16666666666666666
596310129,2,7,2.0,9,0.2222222222222222
596312953,5,3,3.0,8,0.375
596314488,7,2,2.0,9,0.2222222222222222
596321934,1,9,1.0,10,0.1
596325579,1,8,1.0,9,0.1111111111111111
596344461,2,8,2.0,10,0.2
596349297,4,6,4.0,10,0.4
596363489,1,9,1.0,10,0.1
596369859,1,9,1.0,10,0.1
596377903,3,7,3.0,10,0.3
596451435,1,9,1.0,10,0.1
596496286,4,24,4.0,28,0.14285714285714285
596517581,9,11,9.0,20,0.45
596547977,2,6,2.0,8,0.25
596627916,2,26,2.0,28,0.07142857142857142
596630958,1,18,1.0,19,0.05263157894736842
596640150,6,4,4.0,10,0.4
596653349,2,8,2.0,10,0.2
596666593,1,9,1.0,10,0.1
596699396,2,16,2.0,18,0.1111111111111111
596715017,1,8,1.0,9,0.1111111111111111
596723609,1,9,1.0,10,0.1
596747125,3,7,3.0,10,0.3
596748651,1,9,1.0,10,0.1
596753082,6,3,3.0,9,0.3333333333333333
596754486,4,5,4.0,9,0.4444444444444444
596770219,2,8,2.0,10,0.2
596770493,1,9,1.0,10,0.1
596784217,2,8,2.0,10,0.2
596791237,1,7,1.0,8,0.125
596792495,1,8,1.0,9,0.1111111111111111
596798058,4,5,4.0,9,0.4444444444444444
596808549,1,8,1.0,9,0.1111111111111111
596841711,1,8,1.0,9,0.1111111111111111
596877656,1,8,1.0,9,0.1111111111111111
596932287,1,9,1.0,10,0.1
596935390,3,7,3.0,10,0.3
596948436,5,4,4.0,9,0.4444444444444444
596981028,3,7,3.0,10,0.3
596984572,4,6,4.0,10,0.4
597014294,6,4,4.0,10,0.4
597050479,1,8,1.0,9,0.1111111111111111
597053835,1,19,1.0,20,0.05
597073776,1,8,1.0,9,0.1111111111111111
597088196,2,24,2.0,26,0.07692307692307693
597091273,2,8,2.0,10,0.2
597093235,1,9,1.0,10,0.1
597109029,1,9,1.0,10,0.1
597147844,2,8,2.0,10,0.2
597149231,3,5,3.0,8,0.375
597157622,1,8,1.0,9,0.1111111111111111
597192413,6,4,4.0,10,0.4
597206827,5,5,5.0,10,0.5
597207093,3,7,3.0,10,0.3
597223886,7,2,2.0,9,0.2222222222222222
597288418,1,8,1.0,9,0.1111111111111111
597310420,2,8,2.0,10,0.2
597321001,1,8,1.0,9,0.1111111111111111
597328237,5,3,3.0,8,0.375
597351983,6,4,4.0,10,0.4
597372453,20,10,10.0,30,0.3333333333333333
597431208,1,9,1.0,10,0.1
597438949,1,27,1.0,28,0.03571428571428571
597463358,1,8,1.0,9,0.1111111111111111
597464728,2,7,2.0,9,0.2222222222222222
597469666,3,7,3.0,10,0.3
597528550,2,7,2.0,9,0.2222222222222222
597535403,5,5,5.0,10,0.5
597539516,7,2,2.0,9,0.2222222222222222
597574736,1,9,1.0,10,0.1
597575152,4,6,4.0,10,0.4
597576510,3,7,3.0,10,0.3
597580187,7,3,3.0,10,0.3
597613424,1,8,1.0,9,0.1111111111111111
597614297,1,9,1.0,10,0.1
597616120,1,9,1.0,10,0.1
597627773,3,25,3.0,28,0.10714285714285714
597628763,7,3,3.0,10,0.3
597651472,3,7,3.0,10,0.3
597651502,1,9,1.0,10,0.1
597661783,2,8,2.0,10,0.2
597718169,1,9,1.0,10,0.1
597750823,1,9,1.0,10,0.1
597758599,1,9,1.0,10,0.1
597761097,2,8,2.0,10,0.2
597770841,1,17,1.0,18,0.05555555555555555
597810069,3,15,3.0,18,0.16666666666666666
597817492,4,5,4.0,9,0.4444444444444444
597832681,1,9,1.0,10,0.1
597885691,3,7,3.0,10,0.3
597885786,8,20,8.0,28,0.2857142857142857
597890741,1,8,1.0,9,0.1111111111111111
597955094,3,26,3.0,29,0.10344827586206896
597972951,4,4,4.0,8,0.5
597979946,1,8,1.0,9,0.1111111111111111
598003871,1,17,1.0,18,0.05555555555555555
598007859,6,4,4.0,10,0.4
598047862,9,1,1.0,10,0.1
598172871,2,8,2.0,10,0.2
598176461,1,9,1.0,10,0.1
598239896,8,10,8.0,18,0.4444444444444444
598252808,4,6,4.0,10,0.4
598256816,2,8,2.0,10,0.2
598257968,2,8,2.0,10,0.2
598269660,2,7,2.0,9,0.2222222222222222
598277763,8,20,8.0,28,0.2857142857142857
598279195,3,7,3.0,10,0.3
598282638,1,8,1.0,9,0.1111111111111111
598294060,2,8,2.0,10,0.2
598326543,2,6,2.0,8,0.25
598373829,1,7,1.0,8,0.125
598416349,1,9,1.0,10,0.1
598433786,1,9,1.0,10,0.1
598450430,1,19,1.0,20,0.05
598453074,1,8,1.0,9,0.1111111111111111
598455490,1,7,1.0,8,0.125
598458342,3,7,3.0,10,0.3
598495216,2,7,2.0,9,0.2222222222222222
598500648,1,18,1.0,19,0.05263157894736842
598509405,1,8,1.0,9,0.1111111111111111
598527487,5,4,4.0,9,0.4444444444444444
598530498,1,9,1.0,10,0.1
598536274,1,9,1.0,10,0.1
598539069,6,4,4.0,10,0.4
598539162,7,2,2.0,9,0.2222222222222222
598571726,1,8,1.0,9,0.1111111111111111
598583242,3,5,3.0,8,0.375
598591376,4,5,4.0,9,0.4444444444444444
598596259,3,7,3.0,10,0.3
598622364,2,8,2.0,10,0.2
598623228,3,7,3.0,10,0.3
598657928,2,8,2.0,10,0.2
598661143,1,9,1.0,10,0.1
598716401,3,25,3.0,28,0.10714285714285714
598722603,1,7,1.0,8,0.125
598724596,5,4,4.0,9,0.4444444444444444
598727292,3,7,3.0,10,0.3
598735805,1,19,1.0,20,0.05
598737164,2,7,2.0,9,0.2222222222222222
598738351,3,6,3.0,9,0.3333333333333333
598743599,1,8,1.0,9,0.1111111111111111
598756248,1,7,1.0,8,0.125
598757250,1,9,1.0,10,0.1
598774240,1,9,1.0,10,0.1
598813304,9,1,1.0,10,0.1
598827275,1,7,1.0,8,0.125
598859792,9,1,1.0,10,0.1
598883358,6,4,4.0,10,0.4
598890529,1,9,1.0,10,0.1
598896625,1,8,1.0,9,0.1111111111111111
598897344,2,17,2.0,19,0.10526315789473684
598925233,1,9,1.0,10,0.1
598955106,4,6,4.0,10,0.4
598982942,7,12,7.0,19,0.3684210526315789
599005593,2,8,2.0,10,0.2
599020742,1,19,1.0,20,0.05
599043969,2,7,2.0,9,0.2222222222222222
599051761,2,7,2.0,9,0.2222222222222222
599055014,9,20,9.0,29,0.3103448275862069
599056232,1,8,1.0,9,0.1111111111111111
599088942,7,2,2.0,9,0.2222222222222222
599089194,7,2,2.0,9,0.2222222222222222
599105461,1,19,1.0,20,0.05
599130181,8,2,2.0,10,0.2
599134218,6,3,3.0,9,0.3333333333333333
599159032,3,6,3.0,9,0.3333333333333333
599196477,3,5,3.0,8,0.375
599196816,1,7,1.0,8,0.125
599197627,1,8,1.0,9,0.1111111111111111
599234984,3,7,3.0,10,0.3
599235811,2,7,2.0,9,0.2222222222222222
599236127,1,7,1.0,8,0.125
599236479,3,19,3.0,22,0.13636363636363635
599236628,3,7,3.0,10,0.3
599265080,4,6,4.0,10,0.4
599345736,3,6,3.0,9,0.3333333333333333
599362709,1,18,1.0,19,0.05263157894736842
599396066,2,7,2.0,9,0.2222222222222222
599398820,1,9,1.0,10,0.1
599404704,1,9,1.0,10,0.1
599415672,1,8,1.0,9,0.1111111111111111
599419939,3,5,3.0,8,0.375
599465922,8,1,1.0,9,0.1111111111111111
599481986,1,9,1.0,10,0.1
599499334,9,1,1.0,10,0.1
599516594,1,28,1.0,29,0.034482758620689655
599518744,1,7,1.0,8,0.125
599519230,2,8,2.0,10,0.2
599519857,2,8,2.0,10,0.2
599523388,1,8,1.0,9,0.1111111111111111
599581465,1,19,1.0,20,0.05
599625172,1,7,1.0,8,0.125
599625243,1,9,1.0,10,0.1
599638332,5,5,5.0,10,0.5
599650842,1,18,1.0,19,0.05263157894736842
599681606,2,7,2.0,9,0.2222222222222222
599685762,1,9,1.0,10,0.1
599767411,1,17,1.0,18,0.05555555555555555
599767934,2,8,2.0,10,0.2
599772634,7,3,3.0,10,0.3
599774282,2,8,2.0,10,0.2
599795438,1,9,1.0,10,0.1
599804382,2,8,2.0,10,0.2
599856838,3,6,3.0,9,0.3333333333333333
599897155,1,9,1.0,10,0.1
599897263,1,9,1.0,10,0.1
599908576,2,6,2.0,8,0.25
599917308,1,8,1.0,9,0.1111111111111111
599917379,11,18,11.0,29,0.3793103448275862
599917732,2,27,2.0,29,0.06896551724137931
599928704,3,7,3.0,10,0.3
599928824,5,23,5.0,28,0.17857142857142858
599933393,3,7,3.0,10,0.3
599937421,1,9,1.0,10,0.1
599942351,2,8,2.0,10,0.2
599942885,3,7,3.0,10,0.3
600003166,1,7,1.0,8,0.125
600013114,4,5,4.0,9,0.4444444444444444
600013370,14,16,14.0,30,0.4666666666666667
600013452,3,6,3.0,9,0.3333333333333333
600014467,2,6,2.0,8,0.25
600015050,3,6,3.0,9,0.3333333333333333
600016120,2,7,2.0,9,0.2222222222222222
600020089,4,5,4.0,9,0.4444444444444444
600020626,1,8,1.0,9,0.1111111111111111
600021795,2,8,2.0,10,0.2
600024598,1,9,1.0,10,0.1
600025439,1,9,1.0,10,0.1
600067590,1,7,1.0,8,0.125
600067790,2,8,2.0,10,0.2
600069214,3,7,3.0,10,0.3
600069723,9,1,1.0,10,0.1
600088349,7,13,7.0,20,0.35
600092821,3,7,3.0,10,0.3
600095616,1,8,1.0,9,0.1111111111111111
600111151,1,9,1.0,10,0.1
600116139,1,8,1.0,9,0.1111111111111111
600167754,1,9,1.0,10,0.1
600178718,1,8,1.0,9,0.1111111111111111
600182015,3,6,3.0,9,0.3333333333333333
600232586,8,1,1.0,9,0.1111111111111111
600232715,1,18,1.0,19,0.05263157894736842
600232753,7,2,2.0,9,0.2222222222222222
600233201,28,2,2.0,30,0.06666666666666667
600233252,7,3,3.0,10,0.3
600244013,27,1,1.0,28,0.03571428571428571
600338324,1,9,1.0,10,0.1
600366841,3,7,3.0,10,0.3
600374059,2,7,2.0,9,0.2222222222222222
600387479,3,6,3.0,9,0.3333333333333333
600397431,1,29,1.0,30,0.03333333333333333
600403968,4,6,4.0,10,0.4
600407431,1,28,1.0,29,0.034482758620689655
600419570,4,6,4.0,10,0.4
600425428,1,9,1.0,10,0.1
600469439,1,8,1.0,9,0.1111111111111111
600471890,6,4,4.0,10,0.4
600473021,1,9,1.0,10,0.1
600571632,1,17,1.0,18,0.05555555555555555
600634732,1,8,1.0,9,0.1111111111111111
600645499,2,8,2.0,10,0.2
600645551,2,8,2.0,10,0.2
600645633,3,7,3.0,10,0.3
600645663,7,2,2.0,9,0.2222222222222222
600647126,8,2,2.0,10,0.2
600647350,6,3,3.0,9,0.3333333333333333
600647468,8,1,1.0,9,0.1111111111111111
600647490,9,1,1.0,10,0.1
600672084,1,8,1.0,9,0.1111111111111111
600672209,2,8,2.0,10,0.2
600672362,4,6,4.0,10,0.4
600672488,4,5,4.0,9,0.4444444444444444
600689832,7,1,1.0,8,0.125
600690579,2,8,2.0,10,0.2
600694977,3,27,3.0,30,0.1
600713641,8,1,1.0,9,0.1111111111111111
600736373,2,7,2.0,9,0.2222222222222222
600790486,2,8,2.0,10,0.2
600797472,1,9,1.0,10,0.1
600797926,1,18,1.0,19,0.05263157894736842
600803752,2,6,2.0,8,0.25
600819432,4,6,4.0,10,0.4
600820245,2,7,2.0,9,0.2222222222222222
600820315,1,9,1.0,10,0.1
600820388,5,24,5.0,29,0.1724137931034483
600820779,7,2,2.0,9,0.2222222222222222
600821106,2,8,2.0,10,0.2
600821348,4,6,4.0,10,0.4
600821661,5,5,5.0,10,0.5
600821862,2,7,2.0,9,0.2222222222222222
600823002,2,8,2.0,10,0.2
600848805,1,9,1.0,10,0.1
600853573,1,18,1.0,19,0.05263157894736842
600857110,3,6,3.0,9,0.3333333333333333
600943012,1,9,1.0,10,0.1
600946231,5,4,4.0,9,0.4444444444444444
601060988,1,17,1.0,18,0.05555555555555555
601069966,6,21,6.0,27,0.2222222222222222
601085783,1,8,1.0,9,0.1111111111111111
601091147,1,9,1.0,10,0.1
601096500,1,8,1.0,9,0.1111111111111111
601103401,3,6,3.0,9,0.3333333333333333
601142147,1,8,1.0,9,0.1111111111111111
601152740,1,9,1.0,10,0.1
601153986,1,16,1.0,17,0.058823529411764705
601176730,1,7,1.0,8,0.125
601240958,1,9,1.0,10,0.1
601248291,2,8,2.0,10,0.2
601255565,1,18,1.0,19,0.05263157894736842
601273293,2,6,2.0,8,0.25
601273303,5,5,5.0,10,0.5
601308350,1,9,1.0,10,0.1
601314348,1,8,1.0,9,0.1111111111111111
601417018,1,8,1.0,9,0.1111111111111111
601419144,5,5,5.0,10,0.5
601420083,1,9,1.0,10,0.1
601424771,4,5,4.0,9,0.4444444444444444
601425129,1,8,1.0,9,0.1111111111111111
601446808,7,12,7.0,19,0.3684210526315789
601534515,2,7,2.0,9,0.2222222222222222
601541663,1,19,1.0,20,0.05
601544176,2,8,2.0,10,0.2
601570391,1,26,1.0,27,0.037037037037037035
601702489,2,15,2.0,17,0.11764705882352941
601711647,2,7,2.0,9,0.2222222222222222
601711725,2,8,2.0,10,0.2
601733481,1,9,1.0,10,0.1
601735842,1,9,1.0,10,0.1
601865344,1,9,1.0,10,0.1
601886915,3,6,3.0,9,0.3333333333333333
601887422,22,8,8.0,30,0.26666666666666666
601889201,1,8,1.0,9,0.1111111111111111
601904923,1,8,1.0,9,0.1111111111111111
601923032,1,9,1.0,10,0.1
601923089,7,3,3.0,10,0.3
601923594,3,7,3.0,10,0.3
601923685,3,5,3.0,8,0.375
601924310,4,5,4.0,9,0.4444444444444444
601998976,5,5,5.0,10,0.5
602012935,6,4,4.0,10,0.4
602019954,7,3,3.0,10,0.3
602029324,3,6,3.0,9,0.3333333333333333
602038357,2,8,2.0,10,0.2
602056342,1,7,1.0,8,0.125
602061653,2,7,2.0,9,0.2222222222222222
602066677,9,20,9.0,29,0.3103448275862069
602076048,2,7,2.0,9,0.2222222222222222
602078920,1,18,1.0,19,0.05263157894736842
602087234,2,8,2.0,10,0.2
602090786,3,7,3.0,10,0.3
602092740,1,7,1.0,8,0.125
602095186,3,7,3.0,10,0.3
602108986,3,7,3.0,10,0.3
602127157,2,8,2.0,10,0.2
602139974,1,9,1.0,10,0.1
602147779,4,25,4.0,29,0.13793103448275862
602157999,7,3,3.0,10,0.3
602167778,8,2,2.0,10,0.2
602170170,1,8,1.0,9,0.1111111111111111
602195115,6,4,4.0,10,0.4
602195291,3,7,3.0,10,0.3
602196182,5,4,4.0,9,0.4444444444444444
602197812,1,8,1.0,9,0.1111111111111111
602215254,2,6,2.0,8,0.25
602217262,5,5,5.0,10,0.5
602217736,6,4,4.0,10,0.4
602235794,2,8,2.0,10,0.2
602236414,6,3,3.0,9,0.3333333333333333
602236707,7,3,3.0,10,0.3
602236766,8,2,2.0,10,0.2
602260559,1,9,1.0,10,0.1
602316843,1,19,1.0,20,0.05
602345083,2,8,2.0,10,0.2
602361423,1,8,1.0,9,0.1111111111111111
602402848,4,6,4.0,10,0.4
602425331,2,8,2.0,10,0.2
602429765,7,8,7.0,15,0.4666666666666667
602435403,3,6,3.0,9,0.3333333333333333
602476526,25,3,3.0,28,0.10714285714285714
602481121,27,1,1.0,28,0.03571428571428571
602482560,1,18,1.0,19,0.05263157894736842
602508306,1,8,1.0,9,0.1111111111111111
602526850,2,8,2.0,10,0.2
602527412,3,15,3.0,18,0.16666666666666666
602597549,1,18,1.0,19,0.05263157894736842
602598934,3,17,3.0,20,0.15
602637379,5,5,5.0,10,0.5
602638506,2,8,2.0,10,0.2
602641065,4,6,4.0,10,0.4
602641350,2,8,2.0,10,0.2
602649462,1,9,1.0,10,0.1
602748538,1,9,1.0,10,0.1
602755474,1,9,1.0,10,0.1
602768189,2,7,2.0,9,0.2222222222222222
602769288,1,9,1.0,10,0.1
602824028,4,6,4.0,10,0.4
602830045,1,9,1.0,10,0.1
602859131,1,9,1.0,10,0.1
602887145,1,7,1.0,8,0.125
602893906,7,3,3.0,10,0.3
602900018,2,18,2.0,20,0.1
602902657,4,22,4.0,26,0.15384615384615385
602917081,1,9,1.0,10,0.1
602920262,1,8,1.0,9,0.1111111111111111
602923429,2,7,2.0,9,0.2222222222222222
602923984,4,24,4.0,28,0.14285714285714285
602944318,1,9,1.0,10,0.1
602996860,1,8,1.0,9,0.1111111111111111
603088732,1,9,1.0,10,0.1
603095688,1,9,1.0,10,0.1
603145050,2,8,2.0,10,0.2
603230132,4,6,4.0,10,0.4
603249737,3,6,3.0,9,0.3333333333333333
603306545,1,9,1.0,10,0.1
603314236,1,18,1.0,19,0.05263157894736842
603328153,5,3,3.0,8,0.375
603328180,19,10,10.0,29,0.3448275862068966
603329158,2,8,2.0,10,0.2
603332641,1,8,1.0,9,0.1111111111111111
603397970,1,19,1.0,20,0.05
603464305,1,9,1.0,10,0.1
603531825,2,18,2.0,20,0.1
603576557,1,18,1.0,19,0.05263157894736842
603580770,1,9,1.0,10,0.1
603585709,1,8,1.0,9,0.1111111111111111
603587657,1,9,1.0,10,0.1
603589736,1,9,1.0,10,0.1
603596709,1,9,1.0,10,0.1
603643393,3,7,3.0,10,0.3
603644664,1,9,1.0,10,0.1
603647388,1,9,1.0,10,0.1
603656335,2,7,2.0,9,0.2222222222222222
603661578,7,1,1.0,8,0.125
603702381,2,8,2.0,10,0.2
603703381,6,4,4.0,10,0.4
603703979,3,7,3.0,10,0.3
603704374,1,7,1.0,8,0.125
603705039,7,3,3.0,10,0.3
603749349,1,28,1.0,29,0.034482758620689655
603754153,1,9,1.0,10,0.1
603778835,2,8,2.0,10,0.2
603796739,1,9,1.0,10,0.1
603832172,3,7,3.0,10,0.3
603846196,9,9,9.0,18,0.5
603868518,1,18,1.0,19,0.05263157894736842
603875890,1,9,1.0,10,0.1
603882791,1,7,1.0,8,0.125
603900973,2,8,2.0,10,0.2
603948413,1,9,1.0,10,0.1
603950404,4,6,4.0,10,0.4
603954652,1,8,1.0,9,0.1111111111111111
603968591,5,24,5.0,29,0.1724137931034483
603970069,1,9,1.0,10,0.1
604007089,2,8,2.0,10,0.2
604027692,7,2,2.0,9,0.2222222222222222
604031138,2,7,2.0,9,0.2222222222222222
604042822,2,7,2.0,9,0.2222222222222222
604076674,5,5,5.0,10,0.5
604099381,4,5,4.0,9,0.4444444444444444
604104993,1,8,1.0,9,0.1111111111111111
604108890,4,5,4.0,9,0.4444444444444444
604151665,5,5,5.0,10,0.5
604155684,8,2,2.0,10,0.2
604183598,1,9,1.0,10,0.1
604183768,2,8,2.0,10,0.2
604191458,5,22,5.0,27,0.18518518518518517
604218774,1,9,1.0,10,0.1
604230716,6,21,6.0,27,0.2222222222222222
604231290,4,6,4.0,10,0.4
604237849,1,28,1.0,29,0.034482758620689655
604238898,6,3,3.0,9,0.3333333333333333
604239743,8,1,1.0,9,0.1111111111111111
604304432,2,8,2.0,10,0.2
604306422,17,9,9.0,26,0.34615384615384615
604326416,1,9,1.0,10,0.1
604344108,3,7,3.0,10,0.3
604405927,2,17,2.0,19,0.10526315789473684
604436420,1,7,1.0,8,0.125
604451132,6,4,4.0,10,0.4
604451406,2,6,2.0,8,0.25
604457585,2,8,2.0,10,0.2
604464200,1,9,1.0,10,0.1
604467375,1,18,1.0,19,0.05263157894736842
604475634,1,16,1.0,17,0.058823529411764705
604520034,7,2,2.0,9,0.2222222222222222
604534917,6,3,3.0,9,0.3333333333333333
604539957,8,2,2.0,10,0.2
604546057,5,5,5.0,10,0.5
604554237,4,6,4.0,10,0.4
604556213,1,8,1.0,9,0.1111111111111111
604558144,7,2,2.0,9,0.2222222222222222
604575647,2,8,2.0,10,0.2
604579851,2,8,2.0,10,0.2
604611041,1,9,1.0,10,0.1
604622982,1,9,1.0,10,0.1
604652776,1,8,1.0,9,0.1111111111111111
604656994,8,2,2.0,10,0.2
604675366,8,2,2.0,10,0.2
604675791,7,3,3.0,10,0.3
604675872,8,2,2.0,10,0.2
604676447,4,5,4.0,9,0.4444444444444444
604676865,4,6,4.0,10,0.4
604742759,1,7,1.0,8,0.125
604759898,2,7,2.0,9,0.2222222222222222
604807950,1,9,1.0,10,0.1
604855302,3,7,3.0,10,0.3
604860061,5,5,5.0,10,0.5
604930742,1,19,1.0,20,0.05
604936538,9,1,1.0,10,0.1
604961003,3,7,3.0,10,0.3
604973267,3,7,3.0,10,0.3
604991870,3,7,3.0,10,0.3
605034662,3,6,3.0,9,0.3333333333333333
605049173,3,7,3.0,10,0.3
605054190,2,8,2.0,10,0.2
605070453,1,9,1.0,10,0.1
605076118,1,9,1.0,10,0.1
605079854,1,8,1.0,9,0.1111111111111111
605092206,2,8,2.0,10,0.2
605097061,1,18,1.0,19,0.05263157894736842
605099733,2,7,2.0,9,0.2222222222222222
605101308,3,7,3.0,10,0.3
605104536,1,8,1.0,9,0.1111111111111111
605122680,2,7,2.0,9,0.2222222222222222
605135817,5,4,4.0,9,0.4444444444444444
605140128,1,9,1.0,10,0.1
605197306,1,8,1.0,9,0.1111111111111111
605208766,1,9,1.0,10,0.1
605229082,1,7,1.0,8,0.125
605229966,1,7,1.0,8,0.125
605230696,5,3,3.0,8,0.375
605231182,3,5,3.0,8,0.375
605231624,1,9,1.0,10,0.1
605232315,2,6,2.0,8,0.25
605296655,1,8,1.0,9,0.1111111111111111
605300649,6,24,6.0,30,0.2
605308921,2,8,2.0,10,0.2
605347612,1,19,1.0,20,0.05
605347937,2,8,2.0,10,0.2
605357258,3,7,3.0,10,0.3
605358736,1,9,1.0,10,0.1
605435533,2,28,2.0,30,0.06666666666666667
605442499,1,7,1.0,8,0.125
605456478,9,1,1.0,10,0.1
605506292,1,9,1.0,10,0.1
605508446,1,19,1.0,20,0.05
605559936,1,9,1.0,10,0.1
605597689,1,16,1.0,17,0.058823529411764705
605607444,1,17,1.0,18,0.05555555555555555
605617285,2,8,2.0,10,0.2
605664243,1,9,1.0,10,0.1
605742820,1,9,1.0,10,0.1
605796141,3,16,3.0,19,0.15789473684210525
605822535,7,2,2.0,9,0.2222222222222222
605863838,2,8,2.0,10,0.2
605865240,1,18,1.0,19,0.05263157894736842
605873507,1,9,1.0,10,0.1
605874625,1,9,1.0,10,0.1
605907166,2,8,2.0,10,0.2
605907305,2,7,2.0,9,0.2222222222222222
605912323,1,7,1.0,8,0.125
605953576,1,8,1.0,9,0.1111111111111111
605963509,2,8,2.0,10,0.2
605984493,11,18,11.0,29,0.3793103448275862
605999713,1,9,1.0,10,0.1
606021107,1,8,1.0,9,0.1111111111111111
606090847,3,27,3.0,30,0.1
606092952,1,9,1.0,10,0.1
606095922,9,1,1.0,10,0.1
606183571,1,8,1.0,9,0.1111111111111111
606215386,3,7,3.0,10,0.3
606217759,1,19,1.0,20,0.05
606232348,1,27,1.0,28,0.03571428571428571
606232473,1,8,1.0,9,0.1111111111111111
606234072,1,9,1.0,10,0.1
606236334,1,9,1.0,10,0.1
606239060,1,9,1.0,10,0.1
606242767,1,8,1.0,9,0.1111111111111111
606243389,1,9,1.0,10,0.1
606297050,1,9,1.0,10,0.1
606297056,1,9,1.0,10,0.1
606306317,1,18,1.0,19,0.05263157894736842
606316280,12,18,12.0,30,0.4
606419566,1,8,1.0,9,0.1111111111111111
606448246,2,8,2.0,10,0.2
606450319,3,7,3.0,10,0.3
606456429,1,9,1.0,10,0.1
606461679,3,7,3.0,10,0.3
606473607,1,18,1.0,19,0.05263157894736842
606475437,1,9,1.0,10,0.1
606476211,2,8,2.0,10,0.2
606566568,9,1,1.0,10,0.1
606566742,6,3,3.0,9,0.3333333333333333
606611601,8,2,2.0,10,0.2
606611911,2,8,2.0,10,0.2
606616784,1,9,1.0,10,0.1
606629068,5,4,4.0,9,0.4444444444444444
606631520,3,6,3.0,9,0.3333333333333333
606655706,2,8,2.0,10,0.2
606700470,3,7,3.0,10,0.3
606700666,1,8,1.0,9,0.1111111111111111
606701428,2,8,2.0,10,0.2
606739846,15,3,3.0,18,0.16666666666666666
606768539,2,17,2.0,19,0.10526315789473684
606770736,3,5,3.0,8,0.375
606771329,2,8,2.0,10,0.2
606771824,2,8,2.0,10,0.2
606772317,9,21,9.0,30,0.3
606774764,6,3,3.0,9,0.3333333333333333
606817174,3,7,3.0,10,0.3
606819175,2,18,2.0,20,0.1
606821242,1,9,1.0,10,0.1
606822357,2,8,2.0,10,0.2
606849051,1,8,1.0,9,0.1111111111111111
606904385,1,8,1.0,9,0.1111111111111111
606925367,1,9,1.0,10,0.1
606943969,1,9,1.0,10,0.1
606968237,1,9,1.0,10,0.1
606975459,4,6,4.0,10,0.4
607002101,5,22,5.0,27,0.18518518518518517
607038936,22,6,6.0,28,0.21428571428571427
607043933,3,7,3.0,10,0.3
607048498,6,3,3.0,9,0.3333333333333333
607100574,1,9,1.0,10,0.1
607126905,7,22,7.0,29,0.2413793103448276
607197311,1,18,1.0,19,0.05263157894736842
607231053,1,9,1.0,10,0.1
607244913,2,8,2.0,10,0.2
607272141,1,9,1.0,10,0.1
607365713,2,8,2.0,10,0.2
607365767,1,18,1.0,19,0.05263157894736842
607379338,1,9,1.0,10,0.1
607390374,3,6,3.0,9,0.3333333333333333
607399600,1,8,1.0,9,0.1111111111111111
607432704,5,4,4.0,9,0.4444444444444444
607512549,7,2,2.0,9,0.2222222222222222
607550479,4,25,4.0,29,0.13793103448275862
607574876,3,7,3.0,10,0.3
607575704,2,7,2.0,9,0.2222222222222222
607576140,5,5,5.0,10,0.5
607576431,6,4,4.0,10,0.4
607576753,9,1,1.0,10,0.1
607582471,2,8,2.0,10,0.2
607583476,1,8,1.0,9,0.1111111111111111
607584079,1,9,1.0,10,0.1
607584725,2,7,2.0,9,0.2222222222222222
607605359,4,6,4.0,10,0.4
607611788,4,6,4.0,10,0.4
607629245,2,8,2.0,10,0.2
607661191,6,3,3.0,9,0.3333333333333333
607719504,1,9,1.0,10,0.1
607726638,1,7,1.0,8,0.125
607732748,1,8,1.0,9,0.1111111111111111
607735151,9,11,9.0,20,0.45
607756733,1,8,1.0,9,0.1111111111111111
607817377,1,9,1.0,10,0.1
607823536,5,4,4.0,9,0.4444444444444444
607833607,5,5,5.0,10,0.5
607833737,1,9,1.0,10,0.1
607870493,1,8,1.0,9,0.1111111111111111
607878252,1,19,1.0,20,0.05
607879092,7,2,2.0,9,0.2222222222222222
607884334,4,6,4.0,10,0.4
607903401,1,9,1.0,10,0.1
608037255,2,6,2.0,8,0.25
608040804,1,9,1.0,10,0.1
608053925,2,8,2.0,10,0.2
608054130,2,7,2.0,9,0.2222222222222222
608067734,1,9,1.0,10,0.1
608103483,1,9,1.0,10,0.1
608183898,3,7,3.0,10,0.3
608184200,10,18,10.0,28,0.35714285714285715
608197035,1,9,1.0,10,0.1
608203672,3,16,3.0,19,0.15789473684210525
608212185,8,1,1.0,9,0.1111111111111111
608249401,1,9,1.0,10,0.1
608305560,3,17,3.0,20,0.15
608307036,3,7,3.0,10,0.3
608312983,5,5,5.0,10,0.5
608313756,3,7,3.0,10,0.3
608313858,24,6,6.0,30,0.2
608314474,6,3,3.0,9,0.3333333333333333
608425520,1,7,1.0,8,0.125
608506666,1,8,1.0,9,0.1111111111111111
608527975,1,9,1.0,10,0.1
608533942,1,9,1.0,10,0.1
608561755,4,5,4.0,9,0.4444444444444444
608570501,5,4,4.0,9,0.4444444444444444
608577174,6,4,4.0,10,0.4
608577468,2,8,2.0,10,0.2
608586106,8,2,2.0,10,0.2
608586132,2,8,2.0,10,0.2
608593110,5,14,5.0,19,0.2631578947368421
608606352,1,8,1.0,9,0.1111111111111111
608631371,1,9,1.0,10,0.1
608643773,2,8,2.0,10,0.2
608644262,3,7,3.0,10,0.3
608646011,8,2,2.0,10,0.2
608646470,3,7,3.0,10,0.3
608657769,8,9,8.0,17,0.47058823529411764
608661148,1,8,1.0,9,0.1111111111111111
608661991,2,8,2.0,10,0.2
608662366,8,1,1.0,9,0.1111111111111111
608680296,1,8,1.0,9,0.1111111111111111
608682777,1,7,1.0,8,0.125
608697230,4,5,4.0,9,0.4444444444444444
608704532,2,7,2.0,9,0.2222222222222222
608709367,6,22,6.0,28,0.21428571428571427
608714366,1,7,1.0,8,0.125
608718488,5,22,5.0,27,0.18518518518518517
608718906,4,6,4.0,10,0.4
608745706,1,9,1.0,10,0.1
608751442,4,6,4.0,10,0.4
608755576,1,9,1.0,10,0.1
608758751,2,8,2.0,10,0.2
608781203,1,18,1.0,19,0.05263157894736842
608786171,2,6,2.0,8,0.25
608806227,1,7,1.0,8,0.125
608839830,1,8,1.0,9,0.1111111111111111
608972925,2,18,2.0,20,0.1
609016866,7,3,3.0,10,0.3
609036248,2,8,2.0,10,0.2
609040599,2,8,2.0,10,0.2
609050696,2,7,2.0,9,0.2222222222222222
609061417,9,1,1.0,10,0.1
609061691,5,5,5.0,10,0.5
609072650,1,9,1.0,10,0.1
609076590,7,3,3.0,10,0.3
609076873,1,8,1.0,9,0.1111111111111111
609076978,1,27,1.0,28,0.03571428571428571
609079776,1,9,1.0,10,0.1
609079794,4,16,4.0,20,0.2
609101367,1,7,1.0,8,0.125
609137184,8,1,1.0,9,0.1111111111111111
609137577,9,1,1.0,10,0.1
609156773,1,16,1.0,17,0.058823529411764705
609175851,4,6,4.0,10,0.4
609177009,1,16,1.0,17,0.058823529411764705
609185729,5,5,5.0,10,0.5
609185887,10,18,10.0,28,0.35714285714285715
609186802,1,9,1.0,10,0.1
609187197,2,6,2.0,8,0.25
609187573,1,9,1.0,10,0.1
609192705,4,5,4.0,9,0.4444444444444444
609258135,4,6,4.0,10,0.4
609279197,2,8,2.0,10,0.2
609279595,1,7,1.0,8,0.125
609286640,5,5,5.0,10,0.5
609286685,6,2,2.0,8,0.25
609288466,3,6,3.0,9,0.3333333333333333
609290313,1,8,1.0,9,0.1111111111111111
609292267,7,3,3.0,10,0.3
609296080,2,8,2.0,10,0.2
609298247,1,9,1.0,10,0.1
609316568,1,8,1.0,9,0.1111111111111111
609321212,1,8,1.0,9,0.1111111111111111
609324461,3,7,3.0,10,0.3
609324737,2,7,2.0,9,0.2222222222222222
609326558,1,7,1.0,8,0.125
609326874,4,6,4.0,10,0.4
609327151,1,17,1.0,18,0.05555555555555555
609327660,3,7,3.0,10,0.3
609330822,19,10,10.0,29,0.3448275862068966
609330958,1,9,1.0,10,0.1
609331492,1,8,1.0,9,0.1111111111111111
609332629,3,7,3.0,10,0.3
609336000,3,7,3.0,10,0.3
609341095,1,7,1.0,8,0.125
609353878,2,8,2.0,10,0.2
609416063,1,8,1.0,9,0.1111111111111111
609421169,5,20,5.0,25,0.2
609422909,4,6,4.0,10,0.4
609431978,2,7,2.0,9,0.2222222222222222
609433208,2,7,2.0,9,0.2222222222222222
609434256,7,3,3.0,10,0.3
609435970,7,2,2.0,9,0.2222222222222222
609445806,9,1,1.0,10,0.1
609446037,1,8,1.0,9,0.1111111111111111
609450201,5,5,5.0,10,0.5
609457735,5,4,4.0,9,0.4444444444444444
609467264,1,18,1.0,19,0.05263157894736842
609473684,2,8,2.0,10,0.2
609500464,1,9,1.0,10,0.1
609502384,3,7,3.0,10,0.3
609515130,3,7,3.0,10,0.3
609527197,8,1,1.0,9,0.1111111111111111
609528774,7,2,2.0,9,0.2222222222222222
609536566,8,2,2.0,10,0.2
609537838,27,2,2.0,29,0.06896551724137931
609543030,1,8,1.0,9,0.1111111111111111
609544971,1,9,1.0,10,0.1
609558460,2,7,2.0,9,0.2222222222222222
609561248,8,1,1.0,9,0.1111111111111111
609568337,1,18,1.0,19,0.05263157894736842
609612495,4,5,4.0,9,0.4444444444444444
609644966,1,16,1.0,17,0.058823529411764705
609673270,3,6,3.0,9,0.3333333333333333
609698750,1,9,1.0,10,0.1
609717687,1,9,1.0,10,0.1
609731323,3,7,3.0,10,0.3
609791670,2,8,2.0,10,0.2
609846568,1,8,1.0,9,0.1111111111111111
609847031,2,17,2.0,19,0.10526315789473684
609867848,1,19,1.0,20,0.05
609909690,2,16,2.0,18,0.1111111111111111
609933612,4,5,4.0,9,0.4444444444444444
609955533,1,9,1.0,10,0.1
609959276,9,1,1.0,10,0.1
609966708,11,9,9.0,20,0.45
609968467,1,8,1.0,9,0.1111111111111111
609969720,2,8,2.0,10,0.2
609972939,9,1,1.0,10,0.1
610057547,4,5,4.0,9,0.4444444444444444
610087426,1,9,1.0,10,0.1
610106358,1,8,1.0,9,0.1111111111111111
610116853,2,7,2.0,9,0.2222222222222222
610202623,1,19,1.0,20,0.05
610237785,2,27,2.0,29,0.06896551724137931
610239189,2,7,2.0,9,0.2222222222222222
610240912,1,8,1.0,9,0.1111111111111111
610241047,1,9,1.0,10,0.1
610337927,1,9,1.0,10,0.1
610340083,6,4,4.0,10,0.4
610345870,6,3,3.0,9,0.3333333333333333
610346666,9,1,1.0,10,0.1
610365940,1,8,1.0,9,0.1111111111111111
610387955,1,8,1.0,9,0.1111111111111111
610400595,1,8,1.0,9,0.1111111111111111
610419000,3,7,3.0,10,0.3
610504746,8,9,8.0,17,0.47058823529411764
610522153,1,9,1.0,10,0.1
610524127,7,2,2.0,9,0.2222222222222222
610534902,1,7,1.0,8,0.125
610564497,1,9,1.0,10,0.1
610577258,1,9,1.0,10,0.1
610579846,1,9,1.0,10,0.1
610580142,3,24,3.0,27,0.1111111111111111
610580201,1,9,1.0,10,0.1
610581207,2,8,2.0,10,0.2
610590422,2,7,2.0,9,0.2222222222222222
610610899,7,2,2.0,9,0.2222222222222222
610635889,8,18,8.0,26,0.3076923076923077
610670336,3,6,3.0,9,0.3333333333333333
610690505,1,9,1.0,10,0.1
610704969,1,9,1.0,10,0.1
610705050,5,5,5.0,10,0.5
610763361,1,18,1.0,19,0.05263157894736842
610766052,1,7,1.0,8,0.125
610809720,1,9,1.0,10,0.1
610845328,7,3,3.0,10,0.3
610864192,5,5,5.0,10,0.5
610882543,1,25,1.0,26,0.038461538461538464
610967606,2,7,2.0,9,0.2222222222222222
610967863,4,5,4.0,9,0.4444444444444444
610983830,4,6,4.0,10,0.4
610985440,7,2,2.0,9,0.2222222222222222
610997130,1,9,1.0,10,0.1
610997326,4,6,4.0,10,0.4
611004531,1,9,1.0,10,0.1
611030815,1,18,1.0,19,0.05263157894736842
611061898,1,7,1.0,8,0.125
611075300,1,9,1.0,10,0.1
611078204,3,7,3.0,10,0.3
611078286,6,3,3.0,9,0.3333333333333333
611114547,4,6,4.0,10,0.4
611122592,7,3,3.0,10,0.3
611122879,8,19,8.0,27,0.2962962962962963
611123636,1,8,1.0,9,0.1111111111111111
611125432,2,8,2.0,10,0.2
611125934,1,9,1.0,10,0.1
611126485,3,7,3.0,10,0.3
611126945,5,4,4.0,9,0.4444444444444444
611128396,17,8,8.0,25,0.32
611130406,2,17,2.0,19,0.10526315789473684
611130734,1,18,1.0,19,0.05263157894736842
611134202,1,9,1.0,10,0.1
611141481,1,8,1.0,9,0.1111111111111111
611141952,1,9,1.0,10,0.1
611142887,5,4,4.0,9,0.4444444444444444
611143607,1,8,1.0,9,0.1111111111111111
611146992,1,9,1.0,10,0.1
611147798,1,8,1.0,9,0.1111111111111111
611148698,3,7,3.0,10,0.3
611234139,1,19,1.0,20,0.05
611263276,2,8,2.0,10,0.2
611271512,1,7,1.0,8,0.125
611271897,1,8,1.0,9,0.1111111111111111
611276952,1,16,1.0,17,0.058823529411764705
611279496,2,7,2.0,9,0.2222222222222222
611281922,1,18,1.0,19,0.05263157894736842
611326161,2,7,2.0,9,0.2222222222222222
611348292,1,8,1.0,9,0.1111111111111111
611357147,1,8,1.0,9,0.1111111111111111
611363849,3,6,3.0,9,0.3333333333333333
611370989,1,9,1.0,10,0.1
611376060,12,16,12.0,28,0.42857142857142855
611376122,4,5,4.0,9,0.4444444444444444
611376193,2,8,2.0,10,0.2
611376239,3,7,3.0,10,0.3
611376305,1,9,1.0,10,0.1
611378362,1,8,1.0,9,0.1111111111111111
611400339,15,14,14.0,29,0.4827586206896552
611400416,3,7,3.0,10,0.3
611400934,7,2,2.0,9,0.2222222222222222
611403788,1,9,1.0,10,0.1
611411121,1,8,1.0,9,0.1111111111111111
611438860,1,9,1.0,10,0.1
611447529,8,2,2.0,10,0.2
611450160,6,3,3.0,9,0.3333333333333333
611455541,1,8,1.0,9,0.1111111111111111
611503622,4,5,4.0,9,0.4444444444444444
611514130,4,24,4.0,28,0.14285714285714285
611537986,1,8,1.0,9,0.1111111111111111
611538649,16,14,14.0,30,0.4666666666666667
611540787,3,6,3.0,9,0.3333333333333333
611568991,5,5,5.0,10,0.5
611617078,1,8,1.0,9,0.1111111111111111
611643230,1,9,1.0,10,0.1
611650602,1,8,1.0,9,0.1111111111111111
611663210,5,4,4.0,9,0.4444444444444444
611667084,4,23,4.0,27,0.14814814814814814
611669229,5,4,4.0,9,0.4444444444444444
611676307,17,10,10.0,27,0.37037037037037035
611678470,1,9,1.0,10,0.1
611679174,2,8,2.0,10,0.2
611681241,2,8,2.0,10,0.2
611682636,5,5,5.0,10,0.5
611685595,21,7,7.0,28,0.25
611685784,7,2,2.0,9,0.2222222222222222
611695109,2,7,2.0,9,0.2222222222222222
611704913,1,8,1.0,9,0.1111111111111111
611714996,2,8,2.0,10,0.2
611718528,2,8,2.0,10,0.2
611726860,1,8,1.0,9,0.1111111111111111
611736500,5,3,3.0,8,0.375
611737694,1,7,1.0,8,0.125
611752004,7,2,2.0,9,0.2222222222222222
611752240,13,16,13.0,29,0.4482758620689655
611752675,7,23,7.0,30,0.23333333333333334
611754642,2,17,2.0,19,0.10526315789473684
611755860,1,9,1.0,10,0.1
611758936,7,10,7.0,17,0.4117647058823529
611760248,3,6,3.0,9,0.3333333333333333
611760605,8,2,2.0,10,0.2
611761048,5,5,5.0,10,0.5
611762478,3,6,3.0,9,0.3333333333333333
611763360,6,11,6.0,17,0.35294117647058826
611786462,3,7,3.0,10,0.3
611790459,2,16,2.0,18,0.1111111111111111
611802301,3,6,3.0,9,0.3333333333333333
611808016,1,9,1.0,10,0.1
611815596,1,18,1.0,19,0.05263157894736842
611836065,7,23,7.0,30,0.23333333333333334
611838649,4,6,4.0,10,0.4
611848609,1,9,1.0,10,0.1
611860978,19,9,9.0,28,0.32142857142857145
611861984,1,27,1.0,28,0.03571428571428571
611867332,1,8,1.0,9,0.1111111111111111
611869638,1,9,1.0,10,0.1
611873994,8,1,1.0,9,0.1111111111111111
611874698,9,1,1.0,10,0.1
611877889,16,14,14.0,30,0.4666666666666667
611881519,1,9,1.0,10,0.1
611881645,1,9,1.0,10,0.1
611881949,2,7,2.0,9,0.2222222222222222
611892052,1,8,1.0,9,0.1111111111111111
611892499,3,7,3.0,10,0.3
611894099,6,4,4.0,10,0.4
611903407,4,25,4.0,29,0.13793103448275862
611920485,3,6,3.0,9,0.3333333333333333
611954631,8,20,8.0,28,0.2857142857142857
611956937,3,6,3.0,9,0.3333333333333333
611961378,6,13,6.0,19,0.3157894736842105
611962761,1,9,1.0,10,0.1
611964659,1,9,1.0,10,0.1
611992033,1,17,1.0,18,0.05555555555555555
611994066,1,9,1.0,10,0.1
612009720,4,5,4.0,9,0.4444444444444444
612015084,1,8,1.0,9,0.1111111111111111
612090935,3,7,3.0,10,0.3
612108841,1,9,1.0,10,0.1
612114762,1,8,1.0,9,0.1111111111111111
612157926,3,6,3.0,9,0.3333333333333333
612158120,4,5,4.0,9,0.4444444444444444
612159559,2,8,2.0,10,0.2
612160497,1,9,1.0,10,0.1
612162202,3,7,3.0,10,0.3
612176505,1,19,1.0,20,0.05
612185549,1,8,1.0,9,0.1111111111111111
612189189,1,8,1.0,9,0.1111111111111111
612194194,2,8,2.0,10,0.2
612197829,4,24,4.0,28,0.14285714285714285
612205423,1,9,1.0,10,0.1
612210605,9,18,9.0,27,0.3333333333333333
612211284,9,11,9.0,20,0.45
612211501,4,6,4.0,10,0.4
612212246,7,2,2.0,9,0.2222222222222222
612227120,1,9,1.0,10,0.1
612233587,5,14,5.0,19,0.2631578947368421
612236497,1,9,1.0,10,0.1
612245006,7,3,3.0,10,0.3
612256629,3,17,3.0,20,0.15
612268281,8,2,2.0,10,0.2
612312528,1,9,1.0,10,0.1
612336216,3,15,3.0,18,0.16666666666666666
612345627,1,9,1.0,10,0.1
612346954,1,19,1.0,20,0.05
612388356,5,3,3.0,8,0.375
612389065,8,2,2.0,10,0.2
612390132,6,2,2.0,8,0.25
612395456,6,21,6.0,27,0.2222222222222222
612396238,2,8,2.0,10,0.2
612397496,2,8,2.0,10,0.2
612401854,1,18,1.0,19,0.05263157894736842
612404937,1,9,1.0,10,0.1
612405551,1,7,1.0,8,0.125
612407950,2,8,2.0,10,0.2
612409275,2,24,2.0,26,0.07692307692307693
612417295,1,17,1.0,18,0.05555555555555555
612474859,7,3,3.0,10,0.3
612481398,1,9,1.0,10,0.1
612485878,5,5,5.0,10,0.5
612486854,20,8,8.0,28,0.2857142857142857
612526039,1,9,1.0,10,0.1
612531204,3,6,3.0,9,0.3333333333333333
612548380,8,1,1.0,9,0.1111111111111111
612581287,3,15,3.0,18,0.16666666666666666
612598440,2,6,2.0,8,0.25
612598737,2,8,2.0,10,0.2
612607251,6,22,6.0,28,0.21428571428571427
612609418,6,3,3.0,9,0.3333333333333333
612630504,4,5,4.0,9,0.4444444444444444
612632799,3,7,3.0,10,0.3
612644015,6,4,4.0,10,0.4
612645588,1,9,1.0,10,0.1
612656525,7,3,3.0,10,0.3
612668346,1,8,1.0,9,0.1111111111111111
612677017,1,9,1.0,10,0.1
612684831,4,24,4.0,28,0.14285714285714285
612697291,3,7,3.0,10,0.3
612729724,6,3,3.0,9,0.3333333333333333
612730911,2,7,2.0,9,0.2222222222222222
612736896,1,8,1.0,9,0.1111111111111111
612739353,8,2,2.0,10,0.2
612741982,4,5,4.0,9,0.4444444444444444
612744103,3,7,3.0,10,0.3
612795479,3,6,3.0,9,0.3333333333333333
612796913,2,7,2.0,9,0.2222222222222222
612810167,3,7,3.0,10,0.3
612810697,8,2,2.0,10,0.2
612823406,3,7,3.0,10,0.3
612823617,1,9,1.0,10,0.1
612826778,3,17,3.0,20,0.15
612860438,1,8,1.0,9,0.1111111111111111
612877003,1,18,1.0,19,0.05263157894736842
612889820,1,19,1.0,20,0.05
612918783,2,6,2.0,8,0.25
612921110,4,4,4.0,8,0.5
612921228,5,5,5.0,10,0.5
612977978,1,8,1.0,9,0.1111111111111111
612978125,5,5,5.0,10,0.5
612999992,1,19,1.0,20,0.05
613014442,1,9,1.0,10,0.1
613023858,1,19,1.0,20,0.05
613045443,3,7,3.0,10,0.3
613064958,8,1,1.0,9,0.1111111111111111
613088025,1,17,1.0,18,0.05555555555555555
613088486,2,7,2.0,9,0.2222222222222222
613095327,2,8,2.0,10,0.2
613100224,8,2,2.0,10,0.2
613151041,1,8,1.0,9,0.1111111111111111
613165481,1,9,1.0,10,0.1
613173779,1,9,1.0,10,0.1
613174366,5,4,4.0,9,0.4444444444444444
613176306,2,6,2.0,8,0.25
613177885,1,18,1.0,19,0.05263157894736842
613181470,1,7,1.0,8,0.125
613185655,1,7,1.0,8,0.125
613188992,1,7,1.0,8,0.125
613192006,2,8,2.0,10,0.2
613199034,1,7,1.0,8,0.125
613201102,2,8,2.0,10,0.2
613205733,1,9,1.0,10,0.1
613295922,2,8,2.0,10,0.2
613318886,2,8,2.0,10,0.2
613330728,1,7,1.0,8,0.125
613332177,1,9,1.0,10,0.1
613335809,1,9,1.0,10,0.1
613337853,2,8,2.0,10,0.2
613340580,3,6,3.0,9,0.3333333333333333
613368305,2,17,2.0,19,0.10526315789473684
613373261,10,16,10.0,26,0.38461538461538464
613376828,2,7,2.0,9,0.2222222222222222
613407734,1,17,1.0,18,0.05555555555555555
613408286,2,6,2.0,8,0.25
613408616,1,19,1.0,20,0.05
613436334,2,8,2.0,10,0.2
613436509,1,9,1.0,10,0.1
613462556,3,17,3.0,20,0.15
613463716,2,8,2.0,10,0.2
613465186,7,3,3.0,10,0.3
613477770,1,7,1.0,8,0.125
613502568,2,17,2.0,19,0.10526315789473684
613528142,1,7,1.0,8,0.125
613528480,1,9,1.0,10,0.1
613538068,5,4,4.0,9,0.4444444444444444
613554887,7,2,2.0,9,0.2222222222222222
613555360,6,20,6.0,26,0.23076923076923078
613590036,2,7,2.0,9,0.2222222222222222
613603323,4,5,4.0,9,0.4444444444444444
613607262,1,28,1.0,29,0.034482758620689655
613608868,2,8,2.0,10,0.2
613609060,1,9,1.0,10,0.1
613610490,1,8,1.0,9,0.1111111111111111
613632656,2,8,2.0,10,0.2
613633100,2,7,2.0,9,0.2222222222222222
613656846,8,2,2.0,10,0.2
613712094,3,6,3.0,9,0.3333333333333333
613713041,1,7,1.0,8,0.125
613716250,2,7,2.0,9,0.2222222222222222
613721143,3,7,3.0,10,0.3
613721213,1,9,1.0,10,0.1
613761156,2,7,2.0,9,0.2222222222222222
613786511,3,6,3.0,9,0.3333333333333333
613794752,3,5,3.0,8,0.375
613817006,3,7,3.0,10,0.3
613817215,2,8,2.0,10,0.2
613840914,1,9,1.0,10,0.1
613847654,8,2,2.0,10,0.2
613849112,1,9,1.0,10,0.1
613849356,27,1,1.0,28,0.03571428571428571
613867130,2,7,2.0,9,0.2222222222222222
613871005,2,7,2.0,9,0.2222222222222222
613890786,6,22,6.0,28,0.21428571428571427
613915585,1,9,1.0,10,0.1
613922973,1,9,1.0,10,0.1
613944676,2,17,2.0,19,0.10526315789473684
613949169,2,28,2.0,30,0.06666666666666667
613966118,1,9,1.0,10,0.1
613976966,7,3,3.0,10,0.3
613985898,1,8,1.0,9,0.1111111111111111
614008447,3,7,3.0,10,0.3
614014801,2,6,2.0,8,0.25
614029638,1,9,1.0,10,0.1
614030369,1,9,1.0,10,0.1
614035196,2,8,2.0,10,0.2
614037695,3,7,3.0,10,0.3
614038844,3,7,3.0,10,0.3
614057778,7,23,7.0,30,0.23333333333333334
614109279,3,7,3.0,10,0.3
614126949,1,19,1.0,20,0.05
614199035,2,8,2.0,10,0.2
614218994,1,9,1.0,10,0.1
614252621,1,9,1.0,10,0.1
614255116,6,3,3.0,9,0.3333333333333333
614255553,7,2,2.0,9,0.2222222222222222
614271962,1,9,1.0,10,0.1
614281656,2,8,2.0,10,0.2
614286542,2,8,2.0,10,0.2
614340765,4,25,4.0,29,0.13793103448275862
614351222,3,5,3.0,8,0.375
614376538,1,18,1.0,19,0.05263157894736842
614393948,2,8,2.0,10,0.2
614398706,8,2,2.0,10,0.2
614400747,22,7,7.0,29,0.2413793103448276
614400833,9,1,1.0,10,0.1
614407510,2,8,2.0,10,0.2
614409177,2,8,2.0,10,0.2
614409692,2,8,2.0,10,0.2
614415844,1,9,1.0,10,0.1
614419443,5,5,5.0,10,0.5
614486058,1,9,1.0,10,0.1
614495736,1,7,1.0,8,0.125
614526831,6,4,4.0,10,0.4
614540816,1,8,1.0,9,0.1111111111111111
614547117,1,29,1.0,30,0.03333333333333333
614580954,1,8,1.0,9,0.1111111111111111
614589424,5,13,5.0,18,0.2777777777777778
614597474,1,8,1.0,9,0.1111111111111111
614653585,1,19,1.0,20,0.05
614660977,3,6,3.0,9,0.3333333333333333
614674715,1,7,1.0,8,0.125
614695219,1,17,1.0,18,0.05555555555555555
614728216,1,9,1.0,10,0.1
614794896,7,2,2.0,9,0.2222222222222222
614810963,6,4,4.0,10,0.4
614842100,3,7,3.0,10,0.3
614852426,1,8,1.0,9,0.1111111111111111
614852466,2,17,2.0,19,0.10526315789473684
614852881,1,8,1.0,9,0.1111111111111111
614885600,3,17,3.0,20,0.15
614891842,6,4,4.0,10,0.4
614891914,3,7,3.0,10,0.3
614892097,5,4,4.0,9,0.4444444444444444
614900351,1,9,1.0,10,0.1
614912551,1,9,1.0,10,0.1
614923254,3,7,3.0,10,0.3
614969588,1,9,1.0,10,0.1
614977242,1,9,1.0,10,0.1
614982253,6,4,4.0,10,0.4
614982645,6,4,4.0,10,0.4
615000845,2,8,2.0,10,0.2
615009847,1,19,1.0,20,0.05
615009887,5,5,5.0,10,0.5
615010001,3,6,3.0,9,0.3333333333333333
615012778,7,3,3.0,10,0.3
615012819,4,5,4.0,9,0.4444444444444444
615033768,1,18,1.0,19,0.05263157894736842
615037116,8,2,2.0,10,0.2
615037483,2,8,2.0,10,0.2
615038228,3,7,3.0,10,0.3
615040965,2,8,2.0,10,0.2
615046616,1,8,1.0,9,0.1111111111111111
615087296,6,3,3.0,9,0.3333333333333333
615087790,8,2,2.0,10,0.2
615089326,3,7,3.0,10,0.3
615090256,1,7,1.0,8,0.125
615091280,1,9,1.0,10,0.1
615091810,8,2,2.0,10,0.2
615091878,17,3,3.0,20,0.15
615104440,15,3,3.0,18,0.16666666666666666
615123500,1,29,1.0,30,0.03333333333333333
615133820,3,7,3.0,10,0.3
615136842,2,8,2.0,10,0.2
615137890,3,6,3.0,9,0.3333333333333333
615138024,7,3,3.0,10,0.3
615146749,2,7,2.0,9,0.2222222222222222
615161320,1,8,1.0,9,0.1111111111111111
615172790,1,9,1.0,10,0.1
615199293,8,2,2.0,10,0.2
615199621,6,3,3.0,9,0.3333333333333333
615200468,14,4,4.0,18,0.2222222222222222
615225872,9,1,1.0,10,0.1
615226234,2,7,2.0,9,0.2222222222222222
615226796,5,3,3.0,8,0.375
615228314,6,4,4.0,10,0.4
615233981,2,7,2.0,9,0.2222222222222222
615234327,2,6,2.0,8,0.25
615234574,2,7,2.0,9,0.2222222222222222
615234691,7,3,3.0,10,0.3
615235466,7,3,3.0,10,0.3
615236194,1,9,1.0,10,0.1
615237081,8,1,1.0,9,0.1111111111111111
615237239,6,4,4.0,10,0.4
615250435,6,3,3.0,9,0.3333333333333333
615253139,2,8,2.0,10,0.2
615253411,2,7,2.0,9,0.2222222222222222
615254088,3,6,3.0,9,0.3333333333333333
615254161,1,9,1.0,10,0.1
615255030,2,7,2.0,9,0.2222222222222222
615256701,2,7,2.0,9,0.2222222222222222
615257466,6,4,4.0,10,0.4
615279815,9,1,1.0,10,0.1
615280978,1,9,1.0,10,0.1
615282768,1,9,1.0,10,0.1
615297490,1,8,1.0,9,0.1111111111111111
615310375,24,3,3.0,27,0.1111111111111111
615313200,1,9,1.0,10,0.1
615365706,1,16,1.0,17,0.058823529411764705
615377303,5,25,5.0,30,0.16666666666666666
615378703,4,5,4.0,9,0.4444444444444444
615463702,2,7,2.0,9,0.2222222222222222
615488741,1,8,1.0,9,0.1111111111111111
615494854,2,6,2.0,8,0.25
615575907,1,8,1.0,9,0.1111111111111111
615585006,7,3,3.0,10,0.3
615615117,6,4,4.0,10,0.4
615669811,4,6,4.0,10,0.4
615693255,2,8,2.0,10,0.2
615720605,1,9,1.0,10,0.1
615721885,5,5,5.0,10,0.5
615723379,6,3,3.0,9,0.3333333333333333
615739202,1,9,1.0,10,0.1
615739857,4,6,4.0,10,0.4
615740134,1,9,1.0,10,0.1
615742315,3,6,3.0,9,0.3333333333333333
615743657,1,9,1.0,10,0.1
615744440,2,8,2.0,10,0.2
615746331,3,6,3.0,9,0.3333333333333333
615748232,6,4,4.0,10,0.4
615750341,4,6,4.0,10,0.4
615750457,1,9,1.0,10,0.1
615751560,3,7,3.0,10,0.3
615754937,1,8,1.0,9,0.1111111111111111
615762537,3,15,3.0,18,0.16666666666666666
615816363,1,9,1.0,10,0.1
615816534,1,9,1.0,10,0.1
615844140,1,9,1.0,10,0.1
615864047,1,8,1.0,9,0.1111111111111111
615942519,3,6,3.0,9,0.3333333333333333
615947554,6,4,4.0,10,0.4
615950840,3,7,3.0,10,0.3
615962556,1,18,1.0,19,0.05263157894736842
615983654,1,8,1.0,9,0.1111111111111111
615987836,5,5,5.0,10,0.5
616074224,6,4,4.0,10,0.4
616122165,6,2,2.0,8,0.25
616127727,7,23,7.0,30,0.23333333333333334
616149724,1,9,1.0,10,0.1
616193432,4,4,4.0,8,0.5
616196444,6,3,3.0,9,0.3333333333333333
616217492,1,9,1.0,10,0.1
616220391,2,8,2.0,10,0.2
616241971,7,3,3.0,10,0.3
616243180,4,6,4.0,10,0.4
616303779,1,18,1.0,19,0.05263157894736842
616324302,7,3,3.0,10,0.3
616328306,1,9,1.0,10,0.1
616328636,1,9,1.0,10,0.1
616330505,2,8,2.0,10,0.2
616331415,6,24,6.0,30,0.2
616332810,2,8,2.0,10,0.2
616355938,4,6,4.0,10,0.4
616358091,2,7,2.0,9,0.2222222222222222
616408811,2,8,2.0,10,0.2
616441152,1,9,1.0,10,0.1
616444629,1,9,1.0,10,0.1
616447261,1,9,1.0,10,0.1
616474768,3,6,3.0,9,0.3333333333333333
616485495,7,3,3.0,10,0.3
616485655,7,2,2.0,9,0.2222222222222222
616492618,5,4,4.0,9,0.4444444444444444
616515917,4,6,4.0,10,0.4
616529617,6,3,3.0,9,0.3333333333333333
616541811,1,9,1.0,10,0.1
616543871,1,7,1.0,8,0.125
616549646,6,4,4.0,10,0.4
616577372,23,6,6.0,29,0.20689655172413793
616593374,1,19,1.0,20,0.05
616665589,1,9,1.0,10,0.1
616667083,6,4,4.0,10,0.4
616671422,4,5,4.0,9,0.4444444444444444
616673273,6,3,3.0,9,0.3333333333333333
616674129,1,9,1.0,10,0.1
616680039,3,6,3.0,9,0.3333333333333333
616726638,1,9,1.0,10,0.1
616802279,1,18,1.0,19,0.05263157894736842
616815109,2,8,2.0,10,0.2
616829562,1,9,1.0,10,0.1
616838550,7,3,3.0,10,0.3
616839321,7,3,3.0,10,0.3
616842468,3,7,3.0,10,0.3
616857764,4,4,4.0,8,0.5
616858746,2,6,2.0,8,0.25
616880520,8,1,1.0,9,0.1111111111111111
616920541,8,2,2.0,10,0.2
616921927,1,9,1.0,10,0.1
616941061,3,7,3.0,10,0.3
616946112,1,17,1.0,18,0.05555555555555555
616946635,9,20,9.0,29,0.3103448275862069
616956354,6,23,6.0,29,0.20689655172413793
616961993,4,25,4.0,29,0.13793103448275862
616998319,6,4,4.0,10,0.4
617011665,1,9,1.0,10,0.1
617071465,3,6,3.0,9,0.3333333333333333
617074603,2,7,2.0,9,0.2222222222222222
617075718,2,6,2.0,8,0.25
617077679,2,8,2.0,10,0.2
617088878,1,8,1.0,9,0.1111111111111111
617093264,5,4,4.0,9,0.4444444444444444
617095379,1,9,1.0,10,0.1
617106552,7,3,3.0,10,0.3
617138284,8,1,1.0,9,0.1111111111111111
617165791,3,13,3.0,16,0.1875
617166774,7,3,3.0,10,0.3
617167606,6,13,6.0,19,0.3157894736842105
617167857,4,5,4.0,9,0.4444444444444444
617168238,4,5,4.0,9,0.4444444444444444
617172446,6,3,3.0,9,0.3333333333333333
617220670,6,21,6.0,27,0.2222222222222222
617221051,6,23,6.0,29,0.20689655172413793
617223080,1,9,1.0,10,0.1
617269467,6,4,4.0,10,0.4
617270278,3,7,3.0,10,0.3
617341947,2,8,2.0,10,0.2
617363179,2,8,2.0,10,0.2
617414205,4,5,4.0,9,0.4444444444444444
617414293,1,9,1.0,10,0.1
617423223,1,8,1.0,9,0.1111111111111111
617448085,2,7,2.0,9,0.2222222222222222
617452457,3,6,3.0,9,0.3333333333333333
617470780,3,15,3.0,18,0.16666666666666666
617515483,1,9,1.0,10,0.1
617543603,2,8,2.0,10,0.2
617544356,1,9,1.0,10,0.1
617551639,19,9,9.0,28,0.32142857142857145
617551970,1,9,1.0,10,0.1
617557782,6,30,6.0,36,0.16666666666666666
617568214,1,18,1.0,19,0.05263157894736842
617572180,4,6,4.0,10,0.4
617573449,3,6,3.0,9,0.3333333333333333
617573893,1,8,1.0,9,0.1111111111111111
617575765,1,8,1.0,9,0.1111111111111111
617590356,2,17,2.0,19,0.10526315789473684
617621053,1,18,1.0,19,0.05263157894736842
617638337,1,9,1.0,10,0.1
617666958,2,8,2.0,10,0.2
617667122,3,7,3.0,10,0.3
617687238,2,15,2.0,17,0.11764705882352941
617720491,2,25,2.0,27,0.07407407407407407
617720886,5,5,5.0,10,0.5
617726887,5,5,5.0,10,0.5
617735379,4,6,4.0,10,0.4
617736583,3,7,3.0,10,0.3
617744894,1,9,1.0,10,0.1
617758890,3,7,3.0,10,0.3
617760650,1,8,1.0,9,0.1111111111111111
617795110,8,1,1.0,9,0.1111111111111111
617809797,2,8,2.0,10,0.2
617839784,1,9,1.0,10,0.1
617881865,1,9,1.0,10,0.1
617890670,2,8,2.0,10,0.2
617911985,3,7,3.0,10,0.3
617920610,2,6,2.0,8,0.25
617924081,1,9,1.0,10,0.1
617951206,3,7,3.0,10,0.3
617951328,8,2,2.0,10,0.2
617951373,8,2,2.0,10,0.2
617985584,1,17,1.0,18,0.05555555555555555
618049058,9,1,1.0,10,0.1
618051160,1,19,1.0,20,0.05
618058718,4,6,4.0,10,0.4
618058762,3,7,3.0,10,0.3
618058834,4,6,4.0,10,0.4
618064064,2,16,2.0,18,0.1111111111111111
618090435,1,18,1.0,19,0.05263157894736842
618106884,1,9,1.0,10,0.1
618114294,2,18,2.0,20,0.1
618169269,3,6,3.0,9,0.3333333333333333
618170356,3,7,3.0,10,0.3
618171714,7,2,2.0,9,0.2222222222222222
618172152,1,9,1.0,10,0.1
618173057,5,4,4.0,9,0.4444444444444444
618173208,1,7,1.0,8,0.125
618179742,7,2,2.0,9,0.2222222222222222
618180745,7,3,3.0,10,0.3
618185956,2,8,2.0,10,0.2
618187204,3,6,3.0,9,0.3333333333333333
618191672,17,11,11.0,28,0.39285714285714285
618223571,2,6,2.0,8,0.25
618243129,1,8,1.0,9,0.1111111111111111
618294855,3,17,3.0,20,0.15
618310767,1,9,1.0,10,0.1
618311871,9,21,9.0,30,0.3
618314477,3,5,3.0,8,0.375
618327859,3,6,3.0,9,0.3333333333333333
618342549,2,8,2.0,10,0.2
618375751,6,2,2.0,8,0.25
618378359,8,2,2.0,10,0.2
618378549,5,5,5.0,10,0.5
618393825,1,9,1.0,10,0.1
618413710,2,8,2.0,10,0.2
618414136,2,8,2.0,10,0.2
618415878,1,8,1.0,9,0.1111111111111111
618422729,2,7,2.0,9,0.2222222222222222
618449038,4,6,4.0,10,0.4
618452357,7,3,3.0,10,0.3
618473546,1,17,1.0,18,0.05555555555555555
618478506,3,7,3.0,10,0.3
618495821,1,7,1.0,8,0.125
618503290,2,8,2.0,10,0.2
618507356,26,1,1.0,27,0.037037037037037035
618509372,2,18,2.0,20,0.1
618519659,8,2,2.0,10,0.2
618526723,2,8,2.0,10,0.2
618530272,3,7,3.0,10,0.3
618545007,1,16,1.0,17,0.058823529411764705
618549809,5,4,4.0,9,0.4444444444444444
618551326,7,2,2.0,9,0.2222222222222222
618554957,1,8,1.0,9,0.1111111111111111
618555654,3,7,3.0,10,0.3
618562525,4,6,4.0,10,0.4
618562917,1,9,1.0,10,0.1
618602275,1,9,1.0,10,0.1
618602385,4,6,4.0,10,0.4
618657015,3,6,3.0,9,0.3333333333333333
618665802,8,2,2.0,10,0.2
618728467,1,9,1.0,10,0.1
618752214,1,9,1.0,10,0.1
618812511,2,8,2.0,10,0.2
618816998,1,9,1.0,10,0.1
618821638,11,17,11.0,28,0.39285714285714285
618858921,2,7,2.0,9,0.2222222222222222
618864312,9,1,1.0,10,0.1
618865345,2,7,2.0,9,0.2222222222222222
618867385,5,4,4.0,9,0.4444444444444444
618873753,1,8,1.0,9,0.1111111111111111
618875256,4,6,4.0,10,0.4
618888550,1,9,1.0,10,0.1
618924151,1,7,1.0,8,0.125
618956661,2,8,2.0,10,0.2
619030974,4,6,4.0,10,0.4
619031672,6,4,4.0,10,0.4
619032935,2,26,2.0,28,0.07142857142857142
619065754,5,15,5.0,20,0.25
619092226,2,7,2.0,9,0.2222222222222222
619095507,1,8,1.0,9,0.1111111111111111
619157133,8,2,2.0,10,0.2
619186988,8,1,1.0,9,0.1111111111111111
619188796,1,18,1.0,19,0.05263157894736842
619217677,1,9,1.0,10,0.1
619232102,3,6,3.0,9,0.3333333333333333
619287748,2,8,2.0,10,0.2
619288120,2,8,2.0,10,0.2
619309005,8,2,2.0,10,0.2
619309696,6,3,3.0,9,0.3333333333333333
619311339,6,3,3.0,9,0.3333333333333333
619312025,8,2,2.0,10,0.2
619326142,2,6,2.0,8,0.25
619341117,1,9,1.0,10,0.1
619348609,1,9,1.0,10,0.1
619355866,2,8,2.0,10,0.2
619372538,2,18,2.0,20,0.1
619375931,1,18,1.0,19,0.05263157894736842
619391566,1,7,1.0,8,0.125
619397946,1,8,1.0,9,0.1111111111111111
619399148,4,6,4.0,10,0.4
619399245,1,9,1.0,10,0.1
619399788,2,8,2.0,10,0.2
619400448,1,9,1.0,10,0.1
619400851,1,8,1.0,9,0.1111111111111111
619416371,3,7,3.0,10,0.3
619420114,1,9,1.0,10,0.1
619448952,3,23,3.0,26,0.11538461538461539
619461668,4,5,4.0,9,0.4444444444444444
619506908,1,19,1.0,20,0.05
619538639,8,2,2.0,10,0.2
619542416,5,5,5.0,10,0.5
619544357,1,7,1.0,8,0.125
619551732,2,7,2.0,9,0.2222222222222222
619554190,3,6,3.0,9,0.3333333333333333
619555903,3,6,3.0,9,0.3333333333333333
619581479,1,9,1.0,10,0.1
619628478,5,4,4.0,9,0.4444444444444444
619636032,1,9,1.0,10,0.1
619645277,1,9,1.0,10,0.1
619679988,1,18,1.0,19,0.05263157894736842
619689866,1,7,1.0,8,0.125
619756451,3,17,3.0,20,0.15
619789993,1,19,1.0,20,0.05
619793151,9,1,1.0,10,0.1
619793535,2,8,2.0,10,0.2
619846844,17,9,9.0,26,0.34615384615384615
619852611,5,3,3.0,8,0.375
619854054,8,2,2.0,10,0.2
619870742,1,9,1.0,10,0.1
619872036,2,8,2.0,10,0.2
619913600,1,8,1.0,9,0.1111111111111111
619942184,8,2,2.0,10,0.2
619954837,9,1,1.0,10,0.1
619954927,6,2,2.0,8,0.25
619955099,1,9,1.0,10,0.1
619964410,9,1,1.0,10,0.1
620025525,3,17,3.0,20,0.15
620051235,1,9,1.0,10,0.1
620056196,24,6,6.0,30,0.2
620074211,1,18,1.0,19,0.05263157894736842
620135691,2,17,2.0,19,0.10526315789473684
620151314,15,14,14.0,29,0.4827586206896552
620156922,1,9,1.0,10,0.1
620164937,2,8,2.0,10,0.2
620253180,3,7,3.0,10,0.3
620255101,1,9,1.0,10,0.1
620268219,4,6,4.0,10,0.4
620280159,5,5,5.0,10,0.5
620280405,1,9,1.0,10,0.1
620281457,1,9,1.0,10,0.1
620282072,4,5,4.0,9,0.4444444444444444
620288562,1,9,1.0,10,0.1
620290246,1,18,1.0,19,0.05263157894736842
620295571,3,7,3.0,10,0.3
620320363,2,16,2.0,18,0.1111111111111111
620338330,18,10,10.0,28,0.35714285714285715
620351738,3,7,3.0,10,0.3
620352136,1,27,1.0,28,0.03571428571428571
620352508,7,3,3.0,10,0.3
620383959,1,19,1.0,20,0.05
620387871,1,9,1.0,10,0.1
620390960,1,9,1.0,10,0.1
620415624,1,9,1.0,10,0.1
620416647,3,6,3.0,9,0.3333333333333333
620421091,1,8,1.0,9,0.1111111111111111
620429891,1,17,1.0,18,0.05555555555555555
620456501,5,13,5.0,18,0.2777777777777778
620486160,2,7,2.0,9,0.2222222222222222
620505091,8,21,8.0,29,0.27586206896551724
620584212,3,7,3.0,10,0.3
620584298,8,1,1.0,9,0.1111111111111111
620584336,1,8,1.0,9,0.1111111111111111
620585120,3,6,3.0,9,0.3333333333333333
620592311,1,9,1.0,10,0.1
620658533,1,19,1.0,20,0.05
620659499,4,4,4.0,8,0.5
620659580,5,5,5.0,10,0.5
620660357,2,8,2.0,10,0.2
620660627,3,5,3.0,8,0.375
620660910,2,7,2.0,9,0.2222222222222222
620661198,7,3,3.0,10,0.3
620719311,1,8,1.0,9,0.1111111111111111
620782836,1,27,1.0,28,0.03571428571428571
620785334,3,6,3.0,9,0.3333333333333333
620806740,1,9,1.0,10,0.1
620816521,1,8,1.0,9,0.1111111111111111
620834006,2,7,2.0,9,0.2222222222222222
620888651,1,9,1.0,10,0.1
620911855,1,7,1.0,8,0.125
620912343,1,9,1.0,10,0.1
620928667,1,8,1.0,9,0.1111111111111111
620957343,1,18,1.0,19,0.05263157894736842
620960235,1,9,1.0,10,0.1
620969441,4,6,4.0,10,0.4
621027629,1,8,1.0,9,0.1111111111111111
621040393,2,8,2.0,10,0.2
621049193,1,18,1.0,19,0.05263157894736842
621055376,5,3,3.0,8,0.375
621068955,2,8,2.0,10,0.2
621079716,4,6,4.0,10,0.4
621080476,3,5,3.0,8,0.375
621100568,6,4,4.0,10,0.4
621104951,3,23,3.0,26,0.11538461538461539
621108458,18,10,10.0,28,0.35714285714285715
621118922,1,9,1.0,10,0.1
621130434,2,7,2.0,9,0.2222222222222222
621133713,1,26,1.0,27,0.037037037037037035
621148238,1,8,1.0,9,0.1111111111111111
621148504,1,9,1.0,10,0.1
621179395,1,7,1.0,8,0.125
621194347,2,7,2.0,9,0.2222222222222222
621196024,1,9,1.0,10,0.1
621206123,3,17,3.0,20,0.15
621221327,1,9,1.0,10,0.1
621230357,1,16,1.0,17,0.058823529411764705
621266047,6,13,6.0,19,0.3157894736842105
621284971,3,6,3.0,9,0.3333333333333333
621285333,2,7,2.0,9,0.2222222222222222
621285891,23,4,4.0,27,0.14814814814814814
621286348,4,6,4.0,10,0.4
621304532,6,3,3.0,9,0.3333333333333333
621334043,1,9,1.0,10,0.1
621334254,1,9,1.0,10,0.1
621334804,1,17,1.0,18,0.05555555555555555
621364938,1,9,1.0,10,0.1
621366563,1,8,1.0,9,0.1111111111111111
621367775,2,8,2.0,10,0.2
621378749,7,2,2.0,9,0.2222222222222222
621426414,1,9,1.0,10,0.1
621428677,1,8,1.0,9,0.1111111111111111
621506877,3,7,3.0,10,0.3
621509072,2,8,2.0,10,0.2
621519913,1,9,1.0,10,0.1
621531217,7,2,2.0,9,0.2222222222222222
621561160,2,8,2.0,10,0.2
621561565,2,7,2.0,9,0.2222222222222222
621592282,2,8,2.0,10,0.2
621613949,6,4,4.0,10,0.4
621615653,2,7,2.0,9,0.2222222222222222
621629094,1,9,1.0,10,0.1
621675306,6,3,3.0,9,0.3333333333333333
621677399,8,2,2.0,10,0.2
621685201,5,5,5.0,10,0.5
621685702,1,18,1.0,19,0.05263157894736842
621692435,2,8,2.0,10,0.2
621740405,1,9,1.0,10,0.1
621768860,1,18,1.0,19,0.05263157894736842
621861888,6,24,6.0,30,0.2
621861927,1,7,1.0,8,0.125
621933098,2,8,2.0,10,0.2
621933930,27,2,2.0,29,0.06896551724137931
621966073,1,9,1.0,10,0.1
621970697,7,22,7.0,29,0.2413793103448276
621975124,1,9,1.0,10,0.1
621988850,1,17,1.0,18,0.05555555555555555
622012694,2,27,2.0,29,0.06896551724137931
622055196,6,3,3.0,9,0.3333333333333333
622057029,1,9,1.0,10,0.1
622064284,1,9,1.0,10,0.1
622105328,1,18,1.0,19,0.05263157894736842
622117469,2,8,2.0,10,0.2
622133392,1,8,1.0,9,0.1111111111111111
622199364,4,6,4.0,10,0.4
622230921,1,9,1.0,10,0.1
622239204,2,25,2.0,27,0.07407407407407407
622273462,2,8,2.0,10,0.2
622280256,2,7,2.0,9,0.2222222222222222
622281162,20,9,9.0,29,0.3103448275862069
622334191,1,9,1.0,10,0.1
622335468,6,23,6.0,29,0.20689655172413793
622336580,1,9,1.0,10,0.1
622360944,7,2,2.0,9,0.2222222222222222
622379277,1,9,1.0,10,0.1
622380187,2,7,2.0,9,0.2222222222222222
622411667,3,27,3.0,30,0.1
622413015,7,2,2.0,9,0.2222222222222222
622419296,1,19,1.0,20,0.05
622420768,1,8,1.0,9,0.1111111111111111
622444746,7,21,7.0,28,0.25
622463123,7,2,2.0,9,0.2222222222222222
622465623,1,19,1.0,20,0.05
622465697,1,9,1.0,10,0.1
622509412,7,2,2.0,9,0.2222222222222222
622532640,1,7,1.0,8,0.125
622554374,2,8,2.0,10,0.2
622557494,1,18,1.0,19,0.05263157894736842
622574288,6,11,6.0,17,0.35294117647058826
622596039,1,18,1.0,19,0.05263157894736842
622624125,1,17,1.0,18,0.05555555555555555
622653307,5,5,5.0,10,0.5
622662158,1,9,1.0,10,0.1
622664217,1,7,1.0,8,0.125
622723345,10,20,10.0,30,0.3333333333333333
622723879,8,1,1.0,9,0.1111111111111111
622725015,6,4,4.0,10,0.4
622726648,1,9,1.0,10,0.1
622790512,1,18,1.0,19,0.05263157894736842
622790634,1,9,1.0,10,0.1
622805037,1,8,1.0,9,0.1111111111111111
622806546,6,4,4.0,10,0.4
622810436,1,9,1.0,10,0.1
622818045,1,8,1.0,9,0.1111111111111111
622827299,1,8,1.0,9,0.1111111111111111
622856208,9,16,9.0,25,0.36
622909234,2,7,2.0,9,0.2222222222222222
622956475,3,25,3.0,28,0.10714285714285714
622956917,3,6,3.0,9,0.3333333333333333
622957130,6,3,3.0,9,0.3333333333333333
622957265,6,3,3.0,9,0.3333333333333333
622962716,1,9,1.0,10,0.1
622962887,5,5,5.0,10,0.5
622963341,1,8,1.0,9,0.1111111111111111
622963704,1,19,1.0,20,0.05
622966430,2,8,2.0,10,0.2
622999991,1,9,1.0,10,0.1
623010001,1,9,1.0,10,0.1
623020147,3,7,3.0,10,0.3
623056560,1,9,1.0,10,0.1
623077323,3,15,3.0,18,0.16666666666666666
623097887,1,9,1.0,10,0.1
623158180,3,15,3.0,18,0.16666666666666666
623158530,7,3,3.0,10,0.3
623169066,2,8,2.0,10,0.2
623183613,2,7,2.0,9,0.2222222222222222
623199370,2,16,2.0,18,0.1111111111111111
623204163,2,8,2.0,10,0.2
623206344,2,6,2.0,8,0.25
623221116,1,9,1.0,10,0.1
623261980,4,5,4.0,9,0.4444444444444444
623262012,1,9,1.0,10,0.1
623262107,7,3,3.0,10,0.3
623262871,2,8,2.0,10,0.2
623357098,7,2,2.0,9,0.2222222222222222
623370574,9,1,1.0,10,0.1
623371825,3,7,3.0,10,0.3
623372124,2,8,2.0,10,0.2
623375749,1,9,1.0,10,0.1
623412188,3,6,3.0,9,0.3333333333333333
623414561,10,19,10.0,29,0.3448275862068966
623420881,4,5,4.0,9,0.4444444444444444
623420980,5,5,5.0,10,0.5
623421419,8,19,8.0,27,0.2962962962962963
623421528,3,6,3.0,9,0.3333333333333333
623435400,1,8,1.0,9,0.1111111111111111
623584153,1,9,1.0,10,0.1
623597782,2,8,2.0,10,0.2
623608377,1,9,1.0,10,0.1
623619355,2,7,2.0,9,0.2222222222222222
623627235,7,2,2.0,9,0.2222222222222222
623641209,5,5,5.0,10,0.5
623645710,9,1,1.0,10,0.1
623645794,20,10,10.0,30,0.3333333333333333
623670848,3,7,3.0,10,0.3
623723652,2,8,2.0,10,0.2
623737157,9,1,1.0,10,0.1
623748827,1,9,1.0,10,0.1
623755259,2,8,2.0,10,0.2
623790420,1,18,1.0,19,0.05263157894736842
623840170,24,4,4.0,28,0.14285714285714285
623885253,2,8,2.0,10,0.2
624017507,1,15,1.0,16,0.0625
624033116,5,5,5.0,10,0.5
624033363,1,8,1.0,9,0.1111111111111111
624037168,1,8,1.0,9,0.1111111111111111
624071221,2,17,2.0,19,0.10526315789473684
624097386,1,19,1.0,20,0.05
624122455,1,8,1.0,9,0.1111111111111111
624194179,2,7,2.0,9,0.2222222222222222
624270172,3,6,3.0,9,0.3333333333333333
624334144,1,9,1.0,10,0.1
624359999,6,4,4.0,10,0.4
624360119,7,22,7.0,29,0.2413793103448276
624367726,1,8,1.0,9,0.1111111111111111
624368097,4,6,4.0,10,0.4
624380996,2,8,2.0,10,0.2
624385009,8,1,1.0,9,0.1111111111111111
624410665,1,19,1.0,20,0.05
624473612,1,9,1.0,10,0.1
624490376,3,16,3.0,19,0.15789473684210525
624540030,2,8,2.0,10,0.2
624551243,1,18,1.0,19,0.05263157894736842
624595531,1,9,1.0,10,0.1
624639353,3,7,3.0,10,0.3
624656100,1,18,1.0,19,0.05263157894736842
624656314,1,19,1.0,20,0.05
624664555,2,8,2.0,10,0.2
624721729,1,9,1.0,10,0.1
624754299,1,18,1.0,19,0.05263157894736842
624777078,1,18,1.0,19,0.05263157894736842
624783033,2,8,2.0,10,0.2
624783630,1,8,1.0,9,0.1111111111111111
624807448,2,8,2.0,10,0.2
624846936,1,19,1.0,20,0.05
624886381,2,8,2.0,10,0.2
624919694,2,7,2.0,9,0.2222222222222222
624932439,1,19,1.0,20,0.05
624986102,1,8,1.0,9,0.1111111111111111
625015356,1,9,1.0,10,0.1
625037225,3,7,3.0,10,0.3
625139352,1,18,1.0,19,0.05263157894736842
625141901,1,8,1.0,9,0.1111111111111111
625143362,2,16,2.0,18,0.1111111111111111
625147482,1,7,1.0,8,0.125
625147772,1,9,1.0,10,0.1
625148697,6,4,4.0,10,0.4
625179395,1,9,1.0,10,0.1
625196208,1,8,1.0,9,0.1111111111111111
625245728,1,9,1.0,10,0.1
625247974,1,9,1.0,10,0.1
625249644,9,1,1.0,10,0.1
625251552,3,6,3.0,9,0.3333333333333333
625251863,3,7,3.0,10,0.3
625253958,3,15,3.0,18,0.16666666666666666
625256562,7,2,2.0,9,0.2222222222222222
625274109,4,6,4.0,10,0.4
625274265,6,4,4.0,10,0.4
625293397,2,17,2.0,19,0.10526315789473684
625309407,4,6,4.0,10,0.4
625341726,1,9,1.0,10,0.1
625343323,2,8,2.0,10,0.2
625366600,1,9,1.0,10,0.1
625371452,2,6,2.0,8,0.25
625455486,3,7,3.0,10,0.3
625456062,2,7,2.0,9,0.2222222222222222
625514753,2,8,2.0,10,0.2
625514950,8,1,1.0,9,0.1111111111111111
625538783,1,17,1.0,18,0.05555555555555555
625546119,5,3,3.0,8,0.375
625546376,29,1,1.0,30,0.03333333333333333
625548227,9,1,1.0,10,0.1
625551708,6,23,6.0,29,0.20689655172413793
625553538,8,2,2.0,10,0.2
625559636,1,27,1.0,28,0.03571428571428571
625610544,9,1,1.0,10,0.1
625615876,4,6,4.0,10,0.4
625617743,4,5,4.0,9,0.4444444444444444
625627534,1,18,1.0,19,0.05263157894736842
625629335,7,3,3.0,10,0.3
625646178,1,9,1.0,10,0.1
625653968,3,7,3.0,10,0.3
625654432,3,7,3.0,10,0.3
625735068,2,18,2.0,20,0.1
625759269,28,1,1.0,29,0.034482758620689655
625786661,6,4,4.0,10,0.4
625786810,5,5,5.0,10,0.5
625786899,1,18,1.0,19,0.05263157894736842
625838530,3,6,3.0,9,0.3333333333333333
625839825,8,1,1.0,9,0.1111111111111111
625850709,7,3,3.0,10,0.3
625885202,2,8,2.0,10,0.2
625893314,1,9,1.0,10,0.1
625935895,1,9,1.0,10,0.1
625944070,1,8,1.0,9,0.1111111111111111
625944385,3,7,3.0,10,0.3
626000846,8,2,2.0,10,0.2
626008844,1,19,1.0,20,0.05
626042051,3,7,3.0,10,0.3
626078827,1,9,1.0,10,0.1
626136966,1,7,1.0,8,0.125
626145611,2,7,2.0,9,0.2222222222222222
626155008,1,8,1.0,9,0.1111111111111111
626160963,1,17,1.0,18,0.05555555555555555
626242422,7,3,3.0,10,0.3
626271728,3,7,3.0,10,0.3
626271889,3,6,3.0,9,0.3333333333333333
626316308,4,6,4.0,10,0.4
626317195,6,3,3.0,9,0.3333333333333333
626331575,1,8,1.0,9,0.1111111111111111
626343611,1,9,1.0,10,0.1
626364516,1,8,1.0,9,0.1111111111111111
626368433,2,8,2.0,10,0.2
626368926,2,8,2.0,10,0.2
626369560,1,9,1.0,10,0.1
626381632,4,6,4.0,10,0.4
626382084,1,7,1.0,8,0.125
626389011,1,9,1.0,10,0.1
626391422,3,5,3.0,8,0.375
626419102,4,23,4.0,27,0.14814814814814814
626424765,1,9,1.0,10,0.1
626429380,3,7,3.0,10,0.3
626434610,2,8,2.0,10,0.2
626439569,1,9,1.0,10,0.1
626477078,3,5,3.0,8,0.375
626485575,2,8,2.0,10,0.2
626489554,3,7,3.0,10,0.3
626505200,1,8,1.0,9,0.1111111111111111
626549309,2,8,2.0,10,0.2
626610891,3,7,3.0,10,0.3
626615017,14,13,13.0,27,0.48148148148148145
626620677,2,17,2.0,19,0.10526315789473684
626625549,2,7,2.0,9,0.2222222222222222
626629687,5,3,3.0,8,0.375
626692779,1,9,1.0,10,0.1
626699425,7,3,3.0,10,0.3
626783513,1,8,1.0,9,0.1111111111111111
626817393,2,7,2.0,9,0.2222222222222222
626823182,3,16,3.0,19,0.15789473684210525
626895833,1,18,1.0,19,0.05263157894736842
626912844,1,19,1.0,20,0.05
626926354,1,9,1.0,10,0.1
626936568,1,9,1.0,10,0.1
626947454,2,7,2.0,9,0.2222222222222222
626960132,1,8,1.0,9,0.1111111111111111
626964145,2,8,2.0,10,0.2
627055151,1,9,1.0,10,0.1
627055860,1,9,1.0,10,0.1
627057148,2,6,2.0,8,0.25
627092552,4,26,4.0,30,0.13333333333333333
627093543,5,14,5.0,19,0.2631578947368421
627100751,2,8,2.0,10,0.2
627116161,4,6,4.0,10,0.4
627189452,4,5,4.0,9,0.4444444444444444
627190611,2,8,2.0,10,0.2
627195626,5,3,3.0,8,0.375
627211256,1,9,1.0,10,0.1
627215842,27,3,3.0,30,0.1
627226510,24,2,2.0,26,0.07692307692307693
627226676,8,2,2.0,10,0.2
627226989,8,2,2.0,10,0.2
627230739,4,6,4.0,10,0.4
627247051,4,6,4.0,10,0.4
627254516,1,9,1.0,10,0.1
627258592,2,7,2.0,9,0.2222222222222222
627260535,1,9,1.0,10,0.1
627288092,7,3,3.0,10,0.3
627301281,2,6,2.0,8,0.25
627313427,1,8,1.0,9,0.1111111111111111
627362778,5,4,4.0,9,0.4444444444444444
627377365,1,26,1.0,27,0.037037037037037035
627388940,4,6,4.0,10,0.4
627389901,1,9,1.0,10,0.1
627392165,8,12,8.0,20,0.4
627397189,7,3,3.0,10,0.3
627397888,8,2,2.0,10,0.2
627397994,5,4,4.0,9,0.4444444444444444
627399593,28,2,2.0,30,0.06666666666666667
627399925,3,7,3.0,10,0.3
627401042,1,8,1.0,9,0.1111111111111111
627401405,1,9,1.0,10,0.1
627401422,8,2,2.0,10,0.2
627403976,7,3,3.0,10,0.3
627404879,13,14,13.0,27,0.48148148148148145
627404921,3,6,3.0,9,0.3333333333333333
627449169,1,9,1.0,10,0.1
627452561,3,6,3.0,9,0.3333333333333333
627457765,1,18,1.0,19,0.05263157894736842
627457894,4,5,4.0,9,0.4444444444444444
627459993,4,6,4.0,10,0.4
627460385,8,2,2.0,10,0.2
627464485,1,18,1.0,19,0.05263157894736842
627493073,1,18,1.0,19,0.05263157894736842
627525953,2,8,2.0,10,0.2
627526883,1,8,1.0,9,0.1111111111111111
627532032,1,9,1.0,10,0.1
627539762,3,7,3.0,10,0.3
627542186,6,4,4.0,10,0.4
627549374,1,19,1.0,20,0.05
627582235,2,16,2.0,18,0.1111111111111111
627602473,2,7,2.0,9,0.2222222222222222
627602866,7,3,3.0,10,0.3
627608605,3,7,3.0,10,0.3
627623167,2,7,2.0,9,0.2222222222222222
627632204,3,6,3.0,9,0.3333333333333333
627642085,2,8,2.0,10,0.2
627692601,7,3,3.0,10,0.3
627696006,1,9,1.0,10,0.1
627813252,1,8,1.0,9,0.1111111111111111
627832890,3,14,3.0,17,0.17647058823529413
627855981,4,5,4.0,9,0.4444444444444444
627866343,5,5,5.0,10,0.5
627874117,6,4,4.0,10,0.4
627903209,4,5,4.0,9,0.4444444444444444
628120516,1,17,1.0,18,0.05555555555555555
628127953,8,2,2.0,10,0.2
628142459,9,1,1.0,10,0.1
628227267,1,7,1.0,8,0.125
628250683,1,13,1.0,14,0.07142857142857142
628274123,3,17,3.0,20,0.15
628287123,6,3,3.0,9,0.3333333333333333
628306946,1,19,1.0,20,0.05
628340063,4,13,4.0,17,0.23529411764705882
628343456,17,2,2.0,19,0.10526315789473684
628381291,1,9,1.0,10,0.1
628406856,1,18,1.0,19,0.05263157894736842
628438744,2,8,2.0,10,0.2
628475432,1,9,1.0,10,0.1
628520122,1,8,1.0,9,0.1111111111111111
628525368,1,17,1.0,18,0.05555555555555555
628574104,1,9,1.0,10,0.1
628591314,3,7,3.0,10,0.3
628704242,8,2,2.0,10,0.2
628712605,1,18,1.0,19,0.05263157894736842
628746685,1,9,1.0,10,0.1
628749164,2,8,2.0,10,0.2
628763894,3,6,3.0,9,0.3333333333333333
628789414,1,18,1.0,19,0.05263157894736842
628792284,1,16,1.0,17,0.058823529411764705
628831009,2,6,2.0,8,0.25
628836225,2,8,2.0,10,0.2
628836773,1,9,1.0,10,0.1
628886617,8,1,1.0,9,0.1111111111111111
628899304,6,2,2.0,8,0.25
628933069,2,8,2.0,10,0.2
629016480,2,8,2.0,10,0.2
629028268,1,8,1.0,9,0.1111111111111111
629042312,1,9,1.0,10,0.1
629047252,1,9,1.0,10,0.1
629057506,1,9,1.0,10,0.1
629077695,4,6,4.0,10,0.4
629166940,1,9,1.0,10,0.1
629168346,8,2,2.0,10,0.2
629174315,2,8,2.0,10,0.2
629249693,1,16,1.0,17,0.058823529411764705
629253317,1,9,1.0,10,0.1
629262411,4,6,4.0,10,0.4
629264678,5,15,5.0,20,0.25
629348086,1,9,1.0,10,0.1
629393263,1,9,1.0,10,0.1
629394139,3,7,3.0,10,0.3
629394369,3,7,3.0,10,0.3
629394516,2,7,2.0,9,0.2222222222222222
629424337,2,8,2.0,10,0.2
629498321,1,18,1.0,19,0.05263157894736842
629546307,1,8,1.0,9,0.1111111111111111
629556836,1,7,1.0,8,0.125
629637075,1,9,1.0,10,0.1
629688773,1,8,1.0,9,0.1111111111111111
629695804,1,9,1.0,10,0.1
629698683,2,16,2.0,18,0.1111111111111111
629708696,1,9,1.0,10,0.1
629714989,2,28,2.0,30,0.06666666666666667
629736718,1,9,1.0,10,0.1
629764275,2,17,2.0,19,0.10526315789473684
629784014,1,27,1.0,28,0.03571428571428571
629878151,3,7,3.0,10,0.3
629900629,10,18,10.0,28,0.35714285714285715
629900993,3,7,3.0,10,0.3
629901914,5,23,5.0,28,0.17857142857142858
629969724,9,1,1.0,10,0.1
629986242,8,2,2.0,10,0.2
629988559,2,7,2.0,9,0.2222222222222222
630010217,1,17,1.0,18,0.05555555555555555
630015295,1,9,1.0,10,0.1
630023258,1,18,1.0,19,0.05263157894736842
630037084,7,3,3.0,10,0.3
630039875,1,8,1.0,9,0.1111111111111111
630040261,9,1,1.0,10,0.1
630040787,1,9,1.0,10,0.1
630043187,3,7,3.0,10,0.3
630043434,1,7,1.0,8,0.125
630045596,1,9,1.0,10,0.1
630062607,1,7,1.0,8,0.125
630067510,2,7,2.0,9,0.2222222222222222
630075081,4,14,4.0,18,0.2222222222222222
630075681,1,8,1.0,9,0.1111111111111111
630077069,4,6,4.0,10,0.4
630077172,3,6,3.0,9,0.3333333333333333
630084544,7,2,2.0,9,0.2222222222222222
630095049,9,1,1.0,10,0.1
630095506,2,8,2.0,10,0.2
630103405,4,24,4.0,28,0.14285714285714285
630114193,1,7,1.0,8,0.125
630127449,4,15,4.0,19,0.21052631578947367
630216620,7,2,2.0,9,0.2222222222222222
630217295,3,7,3.0,10,0.3
630260576,1,18,1.0,19,0.05263157894736842
630323516,2,7,2.0,9,0.2222222222222222
630368927,1,9,1.0,10,0.1
630371730,1,17,1.0,18,0.05555555555555555
630375559,4,6,4.0,10,0.4
630386386,1,9,1.0,10,0.1
630393296,1,19,1.0,20,0.05
630394025,3,7,3.0,10,0.3
630395060,2,7,2.0,9,0.2222222222222222
630397636,7,2,2.0,9,0.2222222222222222
630398250,2,17,2.0,19,0.10526315789473684
630404035,1,8,1.0,9,0.1111111111111111
630432238,3,6,3.0,9,0.3333333333333333
630433325,2,8,2.0,10,0.2
630508157,1,8,1.0,9,0.1111111111111111
630509809,4,6,4.0,10,0.4
630510606,1,9,1.0,10,0.1
630511743,1,9,1.0,10,0.1
630512251,2,26,2.0,28,0.07142857142857142
630579533,2,17,2.0,19,0.10526315789473684
630635446,2,7,2.0,9,0.2222222222222222
630648413,4,6,4.0,10,0.4
630649518,1,8,1.0,9,0.1111111111111111
630661924,3,6,3.0,9,0.3333333333333333
630664253,1,9,1.0,10,0.1
630688682,1,9,1.0,10,0.1
630696814,21,4,4.0,25,0.16
630700596,3,6,3.0,9,0.3333333333333333
630707067,2,8,2.0,10,0.2
630786020,1,9,1.0,10,0.1
630795049,1,9,1.0,10,0.1
630804683,1,7,1.0,8,0.125
630828107,4,6,4.0,10,0.4
630828937,4,5,4.0,9,0.4444444444444444
630830062,10,19,10.0,29,0.3448275862068966
630894854,1,8,1.0,9,0.1111111111111111
630900756,7,1,1.0,8,0.125
630902064,4,6,4.0,10,0.4
630902833,1,8,1.0,9,0.1111111111111111
630907527,1,9,1.0,10,0.1
630907556,9,1,1.0,10,0.1
630970409,1,9,1.0,10,0.1
631049837,2,27,2.0,29,0.06896551724137931
631150072,8,12,8.0,20,0.4
631172848,8,1,1.0,9,0.1111111111111111
631174649,6,4,4.0,10,0.4
631175318,1,9,1.0,10,0.1
631176179,9,1,1.0,10,0.1
631177939,8,1,1.0,9,0.1111111111111111
631179397,7,2,2.0,9,0.2222222222222222
631180099,7,3,3.0,10,0.3
631188776,1,19,1.0,20,0.05
631197343,1,9,1.0,10,0.1
631205214,9,19,9.0,28,0.32142857142857145
631208741,2,7,2.0,9,0.2222222222222222
631210918,8,2,2.0,10,0.2
631211714,8,2,2.0,10,0.2
631212156,3,7,3.0,10,0.3
631212412,2,8,2.0,10,0.2
631213631,3,7,3.0,10,0.3
631213991,1,25,1.0,26,0.038461538461538464
631215021,4,5,4.0,9,0.4444444444444444
631219800,3,7,3.0,10,0.3
631249922,4,5,4.0,9,0.4444444444444444
631251051,1,17,1.0,18,0.05555555555555555
631268611,1,8,1.0,9,0.1111111111111111
631303696,3,16,3.0,19,0.15789473684210525
631339119,7,1,1.0,8,0.125
631340743,1,8,1.0,9,0.1111111111111111
631347182,3,14,3.0,17,0.17647058823529413
631350021,2,8,2.0,10,0.2
631350312,6,3,3.0,9,0.3333333333333333
631350527,1,7,1.0,8,0.125
631425295,1,29,1.0,30,0.03333333333333333
631462808,2,8,2.0,10,0.2
631507880,4,6,4.0,10,0.4
631511546,8,10,8.0,18,0.4444444444444444
631532706,1,9,1.0,10,0.1
631532837,4,25,4.0,29,0.13793103448275862
631532933,3,7,3.0,10,0.3
631538636,1,9,1.0,10,0.1
631577095,4,15,4.0,19,0.21052631578947367
631578027,10,17,10.0,27,0.37037037037037035
631582973,1,9,1.0,10,0.1
631609539,1,9,1.0,10,0.1
631622088,1,9,1.0,10,0.1
631626022,9,1,1.0,10,0.1
631651265,1,8,1.0,9,0.1111111111111111
631652707,1,9,1.0,10,0.1
631729585,3,6,3.0,9,0.3333333333333333
631747035,1,9,1.0,10,0.1
631747046,1,7,1.0,8,0.125
631875714,2,17,2.0,19,0.10526315789473684
631881683,2,7,2.0,9,0.2222222222222222
631898083,1,8,1.0,9,0.1111111111111111
631899019,5,5,5.0,10,0.5
631899158,1,18,1.0,19,0.05263157894736842
631924511,4,6,4.0,10,0.4
631926523,1,9,1.0,10,0.1
631940401,1,18,1.0,19,0.05263157894736842
631955580,2,7,2.0,9,0.2222222222222222
631972322,1,17,1.0,18,0.05555555555555555
632019146,3,6,3.0,9,0.3333333333333333
632031313,3,24,3.0,27,0.1111111111111111
632032407,3,7,3.0,10,0.3
632043304,1,9,1.0,10,0.1
632052216,7,3,3.0,10,0.3
632054268,6,3,3.0,9,0.3333333333333333
632054962,7,1,1.0,8,0.125
632055136,7,3,3.0,10,0.3
632055195,7,2,2.0,9,0.2222222222222222
632055234,25,2,2.0,27,0.07407407407407407
632055530,1,8,1.0,9,0.1111111111111111
632061529,1,8,1.0,9,0.1111111111111111
632070700,5,5,5.0,10,0.5
632071098,2,7,2.0,9,0.2222222222222222
632077789,6,3,3.0,9,0.3333333333333333
632087490,2,7,2.0,9,0.2222222222222222
632094053,1,9,1.0,10,0.1
632107812,2,8,2.0,10,0.2
632139074,1,9,1.0,10,0.1
632152939,2,18,2.0,20,0.1
632154715,2,7,2.0,9,0.2222222222222222
632154994,3,16,3.0,19,0.15789473684210525
632207545,9,20,9.0,29,0.3103448275862069
632227954,3,25,3.0,28,0.10714285714285714
632273159,2,8,2.0,10,0.2
632301639,1,9,1.0,10,0.1
632304224,1,8,1.0,9,0.1111111111111111
632317870,1,9,1.0,10,0.1
632354884,3,6,3.0,9,0.3333333333333333
632355440,2,8,2.0,10,0.2
632355888,4,16,4.0,20,0.2
632359500,7,2,2.0,9,0.2222222222222222
632359870,5,5,5.0,10,0.5
632372073,8,2,2.0,10,0.2
632381014,1,9,1.0,10,0.1
632471267,4,6,4.0,10,0.4
632471456,7,20,7.0,27,0.25925925925925924
632472250,7,3,3.0,10,0.3
632473793,1,28,1.0,29,0.034482758620689655
632487444,1,9,1.0,10,0.1
632506332,2,7,2.0,9,0.2222222222222222
632511436,1,9,1.0,10,0.1
632511665,2,7,2.0,9,0.2222222222222222
632512024,1,9,1.0,10,0.1
632512203,4,5,4.0,9,0.4444444444444444
632512558,3,7,3.0,10,0.3
632513382,3,25,3.0,28,0.10714285714285714
632521547,1,9,1.0,10,0.1
632555765,2,8,2.0,10,0.2
632576569,1,19,1.0,20,0.05
632583442,1,9,1.0,10,0.1
632599345,2,7,2.0,9,0.2222222222222222
632601241,8,2,2.0,10,0.2
632613974,2,8,2.0,10,0.2
632615696,8,2,2.0,10,0.2
632648517,1,8,1.0,9,0.1111111111111111
632648936,4,5,4.0,9,0.4444444444444444
632652933,6,4,4.0,10,0.4
632655829,2,8,2.0,10,0.2
632675449,1,9,1.0,10,0.1
632681239,3,7,3.0,10,0.3
632681774,6,3,3.0,9,0.3333333333333333
632737377,1,8,1.0,9,0.1111111111111111
632758629,5,5,5.0,10,0.5
632759909,4,6,4.0,10,0.4
632760504,4,6,4.0,10,0.4
632761575,1,9,1.0,10,0.1
632776723,25,5,5.0,30,0.16666666666666666
632777359,3,7,3.0,10,0.3
632777639,3,7,3.0,10,0.3
632789757,1,9,1.0,10,0.1
632791168,2,8,2.0,10,0.2
632806542,1,28,1.0,29,0.034482758620689655
632837897,1,9,1.0,10,0.1
632841884,7,3,3.0,10,0.3
632927160,4,15,4.0,19,0.21052631578947367
632981640,2,7,2.0,9,0.2222222222222222
632999949,4,16,4.0,20,0.2
633000148,5,5,5.0,10,0.5
633000321,1,27,1.0,28,0.03571428571428571
633020502,4,15,4.0,19,0.21052631578947367
633039119,1,18,1.0,19,0.05263157894736842
633057040,1,9,1.0,10,0.1
633120709,1,8,1.0,9,0.1111111111111111
633127815,1,8,1.0,9,0.1111111111111111
633151608,4,6,4.0,10,0.4
633161224,2,14,2.0,16,0.125
633187318,12,16,12.0,28,0.42857142857142855
633190000,2,7,2.0,9,0.2222222222222222
633190462,1,7,1.0,8,0.125
633190978,15,13,13.0,28,0.4642857142857143
633191521,2,8,2.0,10,0.2
633192008,6,20,6.0,26,0.23076923076923078
633193106,1,9,1.0,10,0.1
633203806,1,8,1.0,9,0.1111111111111111
633205061,1,9,1.0,10,0.1
633212043,2,26,2.0,28,0.07142857142857142
633212906,6,3,3.0,9,0.3333333333333333
633220037,1,8,1.0,9,0.1111111111111111
633237156,3,7,3.0,10,0.3
633244976,4,6,4.0,10,0.4
633245569,15,13,13.0,28,0.4642857142857143
633246457,1,9,1.0,10,0.1
633246906,5,5,5.0,10,0.5
633250780,6,4,4.0,10,0.4
633268464,1,8,1.0,9,0.1111111111111111
633273097,2,8,2.0,10,0.2
633286980,1,8,1.0,9,0.1111111111111111
633326610,2,8,2.0,10,0.2
633344755,1,17,1.0,18,0.05555555555555555
633353236,9,1,1.0,10,0.1
633377339,1,9,1.0,10,0.1
633383387,1,9,1.0,10,0.1
633393191,1,7,1.0,8,0.125
633405720,1,8,1.0,9,0.1111111111111111
633411339,5,5,5.0,10,0.5
633411971,2,7,2.0,9,0.2222222222222222
633415190,1,9,1.0,10,0.1
633421759,1,7,1.0,8,0.125
633429577,5,4,4.0,9,0.4444444444444444
633457205,2,6,2.0,8,0.25
633498400,4,6,4.0,10,0.4
633505162,5,5,5.0,10,0.5
633527652,3,7,3.0,10,0.3
633536786,5,5,5.0,10,0.5
633554510,2,8,2.0,10,0.2
633563118,7,2,2.0,9,0.2222222222222222
633563738,7,3,3.0,10,0.3
633570257,1,9,1.0,10,0.1
633571519,1,8,1.0,9,0.1111111111111111
633586908,3,7,3.0,10,0.3
633617333,6,4,4.0,10,0.4
633621180,1,9,1.0,10,0.1
633633965,4,5,4.0,9,0.4444444444444444
633666754,1,9,1.0,10,0.1
633708799,1,9,1.0,10,0.1
633742512,1,9,1.0,10,0.1
633743498,2,8,2.0,10,0.2
633743675,1,8,1.0,9,0.1111111111111111
633815479,1,19,1.0,20,0.05
633817418,2,7,2.0,9,0.2222222222222222
633821475,1,8,1.0,9,0.1111111111111111
633853183,3,7,3.0,10,0.3
633876405,1,19,1.0,20,0.05
633881122,4,5,4.0,9,0.4444444444444444
633882603,3,7,3.0,10,0.3
633884086,1,9,1.0,10,0.1
633885443,8,20,8.0,28,0.2857142857142857
633888079,1,9,1.0,10,0.1
633890508,3,7,3.0,10,0.3
633892671,4,6,4.0,10,0.4
633901652,1,9,1.0,10,0.1
633902010,2,7,2.0,9,0.2222222222222222
633965880,7,2,2.0,9,0.2222222222222222
633998293,1,8,1.0,9,0.1111111111111111
634009414,4,6,4.0,10,0.4
634186216,26,2,2.0,28,0.07142857142857142
634186308,9,1,1.0,10,0.1
634199866,1,9,1.0,10,0.1
634208669,1,8,1.0,9,0.1111111111111111
634215312,4,5,4.0,9,0.4444444444444444
634215470,1,7,1.0,8,0.125
634215524,1,8,1.0,9,0.1111111111111111
634215701,1,9,1.0,10,0.1
634282094,4,5,4.0,9,0.4444444444444444
634324354,7,1,1.0,8,0.125
634364454,2,23,2.0,25,0.08
634365181,1,8,1.0,9,0.1111111111111111
634367693,2,8,2.0,10,0.2
634369359,2,7,2.0,9,0.2222222222222222
634393250,4,24,4.0,28,0.14285714285714285
634445564,1,8,1.0,9,0.1111111111111111
634447117,4,25,4.0,29,0.13793103448275862
634516394,4,6,4.0,10,0.4
634531460,9,1,1.0,10,0.1
634575214,2,8,2.0,10,0.2
634600191,4,5,4.0,9,0.4444444444444444
634737253,3,5,3.0,8,0.375
634742677,4,14,4.0,18,0.2222222222222222
634768033,1,8,1.0,9,0.1111111111111111
634838708,1,8,1.0,9,0.1111111111111111
634839233,4,5,4.0,9,0.4444444444444444
634899820,1,18,1.0,19,0.05263157894736842
634919465,3,7,3.0,10,0.3
634964573,1,9,1.0,10,0.1
634964729,1,9,1.0,10,0.1
634964956,2,8,2.0,10,0.2
634966835,4,6,4.0,10,0.4
634970848,3,7,3.0,10,0.3
634982740,8,1,1.0,9,0.1111111111111111
635126122,1,9,1.0,10,0.1
635126555,1,7,1.0,8,0.125
635131807,4,26,4.0,30,0.13333333333333333
635146116,2,7,2.0,9,0.2222222222222222
635162324,1,9,1.0,10,0.1
635177059,1,7,1.0,8,0.125
635198275,1,9,1.0,10,0.1
635228124,7,2,2.0,9,0.2222222222222222
635257377,3,6,3.0,9,0.3333333333333333
635266360,7,3,3.0,10,0.3
635266376,9,1,1.0,10,0.1
635378376,4,6,4.0,10,0.4
635382618,2,8,2.0,10,0.2
635384745,1,9,1.0,10,0.1
635387649,1,9,1.0,10,0.1
635389246,5,4,4.0,9,0.4444444444444444
635398311,3,7,3.0,10,0.3
635398773,1,8,1.0,9,0.1111111111111111
635399029,5,5,5.0,10,0.5
635408865,5,14,5.0,19,0.2631578947368421
635414977,7,3,3.0,10,0.3
635415954,19,10,10.0,29,0.3448275862068966
635420371,2,6,2.0,8,0.25
635421282,1,8,1.0,9,0.1111111111111111
635421588,3,16,3.0,19,0.15789473684210525
635427021,1,8,1.0,9,0.1111111111111111
635456399,1,7,1.0,8,0.125
635462452,6,4,4.0,10,0.4
635462989,3,7,3.0,10,0.3
635463112,2,7,2.0,9,0.2222222222222222
635514169,1,9,1.0,10,0.1
635565064,6,4,4.0,10,0.4
635567892,2,7,2.0,9,0.2222222222222222
635578176,7,3,3.0,10,0.3
635599799,4,6,4.0,10,0.4
635601360,4,16,4.0,20,0.2
635658033,2,8,2.0,10,0.2
635733433,2,8,2.0,10,0.2
635741010,1,9,1.0,10,0.1
635744054,5,4,4.0,9,0.4444444444444444
635744188,2,18,2.0,20,0.1
635744705,9,1,1.0,10,0.1
635745526,6,3,3.0,9,0.3333333333333333
635748889,2,6,2.0,8,0.25
635757117,5,5,5.0,10,0.5
635758174,1,9,1.0,10,0.1
635769599,1,8,1.0,9,0.1111111111111111
635777952,3,6,3.0,9,0.3333333333333333
635798458,1,7,1.0,8,0.125
635805633,4,16,4.0,20,0.2
635816703,1,9,1.0,10,0.1
635820007,1,16,1.0,17,0.058823529411764705
635835158,5,13,5.0,18,0.2777777777777778
635848013,4,5,4.0,9,0.4444444444444444
635848910,3,6,3.0,9,0.3333333333333333
635864782,1,18,1.0,19,0.05263157894736842
635871101,3,7,3.0,10,0.3
635938136,1,8,1.0,9,0.1111111111111111
635946285,1,9,1.0,10,0.1
635949928,1,9,1.0,10,0.1
635974442,6,3,3.0,9,0.3333333333333333
635974745,2,7,2.0,9,0.2222222222222222
635979911,5,5,5.0,10,0.5
636004364,4,6,4.0,10,0.4
636004655,2,8,2.0,10,0.2
636005028,1,9,1.0,10,0.1
636005715,3,7,3.0,10,0.3
636019892,5,5,5.0,10,0.5
636021126,6,4,4.0,10,0.4
636021753,2,6,2.0,8,0.25
636026146,2,6,2.0,8,0.25
636059668,6,12,6.0,18,0.3333333333333333
636063864,1,7,1.0,8,0.125
636064185,1,9,1.0,10,0.1
636065416,3,7,3.0,10,0.3
636067874,1,8,1.0,9,0.1111111111111111
636101282,5,5,5.0,10,0.5
636103586,6,3,3.0,9,0.3333333333333333
636122138,1,9,1.0,10,0.1
636125856,1,17,1.0,18,0.05555555555555555
636272840,1,8,1.0,9,0.1111111111111111
636345374,1,8,1.0,9,0.1111111111111111
636415160,1,9,1.0,10,0.1
636419429,2,17,2.0,19,0.10526315789473684
636453923,5,4,4.0,9,0.4444444444444444
636454024,4,6,4.0,10,0.4
636471721,4,5,4.0,9,0.4444444444444444
636500965,1,9,1.0,10,0.1
636502091,1,9,1.0,10,0.1
636503514,4,15,4.0,19,0.21052631578947367
636503813,3,7,3.0,10,0.3
636518238,1,28,1.0,29,0.034482758620689655
636568378,1,7,1.0,8,0.125
636618791,2,6,2.0,8,0.25
636619075,1,9,1.0,10,0.1
636623167,2,7,2.0,9,0.2222222222222222
636624169,23,4,4.0,27,0.14814814814814814
636634518,8,2,2.0,10,0.2
636634999,27,2,2.0,29,0.06896551724137931
636654279,1,9,1.0,10,0.1
636663125,1,9,1.0,10,0.1
636695074,2,7,2.0,9,0.2222222222222222
636701506,1,8,1.0,9,0.1111111111111111
636711965,24,4,4.0,28,0.14285714285714285
636717846,3,7,3.0,10,0.3
636718112,5,5,5.0,10,0.5
636733676,1,9,1.0,10,0.1
636782547,1,8,1.0,9,0.1111111111111111
636786065,1,9,1.0,10,0.1
636797057,1,8,1.0,9,0.1111111111111111
636851206,5,5,5.0,10,0.5
636851493,1,19,1.0,20,0.05
636889496,1,8,1.0,9,0.1111111111111111
636923694,2,7,2.0,9,0.2222222222222222
636964366,1,8,1.0,9,0.1111111111111111
636977586,1,8,1.0,9,0.1111111111111111
637009589,1,26,1.0,27,0.037037037037037035
637032586,2,7,2.0,9,0.2222222222222222
637044807,4,6,4.0,10,0.4
637045939,7,2,2.0,9,0.2222222222222222
637048771,1,9,1.0,10,0.1
637050473,1,9,1.0,10,0.1
637052281,1,26,1.0,27,0.037037037037037035
637069571,1,9,1.0,10,0.1
637076820,1,9,1.0,10,0.1
637112739,1,9,1.0,10,0.1
637114180,5,3,3.0,8,0.375
637143938,10,17,10.0,27,0.37037037037037035
637144106,23,7,7.0,30,0.23333333333333334
637144446,7,3,3.0,10,0.3
637144711,1,9,1.0,10,0.1
637144862,6,4,4.0,10,0.4
637146176,2,7,2.0,9,0.2222222222222222
637146420,5,5,5.0,10,0.5
637146632,2,18,2.0,20,0.1
637147039,3,6,3.0,9,0.3333333333333333
637147234,1,8,1.0,9,0.1111111111111111
637148172,4,5,4.0,9,0.4444444444444444
637157978,4,6,4.0,10,0.4
637211222,23,4,4.0,27,0.14814814814814814
637213623,7,3,3.0,10,0.3
637242390,4,5,4.0,9,0.4444444444444444
637280164,8,1,1.0,9,0.1111111111111111
637281738,1,9,1.0,10,0.1
637299702,6,4,4.0,10,0.4
637303891,11,17,11.0,28,0.39285714285714285
637304454,3,6,3.0,9,0.3333333333333333
637307817,3,7,3.0,10,0.3
637333445,3,16,3.0,19,0.15789473684210525
637375864,6,3,3.0,9,0.3333333333333333
637428116,6,2,2.0,8,0.25
637485995,1,18,1.0,19,0.05263157894736842
637488011,2,15,2.0,17,0.11764705882352941
637492679,5,5,5.0,10,0.5
637500429,1,19,1.0,20,0.05
637528351,4,6,4.0,10,0.4
637529062,29,1,1.0,30,0.03333333333333333
637532195,2,8,2.0,10,0.2
637536424,1,8,1.0,9,0.1111111111111111
637546200,1,8,1.0,9,0.1111111111111111
637564449,1,9,1.0,10,0.1
637565121,2,8,2.0,10,0.2
637565704,5,25,5.0,30,0.16666666666666666
637567719,2,27,2.0,29,0.06896551724137931
637574726,2,8,2.0,10,0.2
637577547,7,3,3.0,10,0.3
637590686,3,7,3.0,10,0.3
637617681,3,7,3.0,10,0.3
637617770,4,6,4.0,10,0.4
637622791,9,1,1.0,10,0.1
637666414,3,6,3.0,9,0.3333333333333333
637698575,5,5,5.0,10,0.5
637698631,1,9,1.0,10,0.1
637706425,7,3,3.0,10,0.3
637706936,6,4,4.0,10,0.4
637734373,4,5,4.0,9,0.4444444444444444
637802697,1,17,1.0,18,0.05555555555555555
637815684,3,7,3.0,10,0.3
637838752,1,9,1.0,10,0.1
637902789,3,6,3.0,9,0.3333333333333333
637902916,4,6,4.0,10,0.4
637939829,3,17,3.0,20,0.15
637970817,5,5,5.0,10,0.5
637985476,1,7,1.0,8,0.125
638004357,2,8,2.0,10,0.2
638155623,1,7,1.0,8,0.125
638195793,11,17,11.0,28,0.39285714285714285
638198083,4,5,4.0,9,0.4444444444444444
638218521,1,9,1.0,10,0.1
638253128,2,7,2.0,9,0.2222222222222222
638258687,1,18,1.0,19,0.05263157894736842
638279262,1,9,1.0,10,0.1
638280586,2,18,2.0,20,0.1
638326916,3,6,3.0,9,0.3333333333333333
638360701,1,9,1.0,10,0.1
638370972,1,9,1.0,10,0.1
638375438,1,17,1.0,18,0.05555555555555555
638388954,2,16,2.0,18,0.1111111111111111
638405473,8,1,1.0,9,0.1111111111111111
638456609,1,8,1.0,9,0.1111111111111111
638494270,7,2,2.0,9,0.2222222222222222
638497035,1,9,1.0,10,0.1
638517303,6,3,3.0,9,0.3333333333333333
638609375,1,9,1.0,10,0.1
638684227,7,3,3.0,10,0.3
638692492,4,4,4.0,8,0.5
638695775,6,4,4.0,10,0.4
638703021,9,1,1.0,10,0.1
638793476,8,2,2.0,10,0.2
638805043,2,18,2.0,20,0.1
638829940,2,8,2.0,10,0.2
638834556,2,18,2.0,20,0.1
638854261,1,15,1.0,16,0.0625
638884257,3,6,3.0,9,0.3333333333333333
638884879,1,8,1.0,9,0.1111111111111111
638885447,1,8,1.0,9,0.1111111111111111
638910645,2,7,2.0,9,0.2222222222222222
638954861,1,8,1.0,9,0.1111111111111111
638955187,2,8,2.0,10,0.2
638956035,3,7,3.0,10,0.3
638956453,4,15,4.0,19,0.21052631578947367
638959884,2,12,2.0,14,0.14285714285714285
639035104,1,9,1.0,10,0.1
639073319,9,1,1.0,10,0.1
639081527,1,9,1.0,10,0.1
639107581,8,2,2.0,10,0.2
639110304,1,18,1.0,19,0.05263157894736842
639195933,1,18,1.0,19,0.05263157894736842
639203680,3,7,3.0,10,0.3
639212418,1,17,1.0,18,0.05555555555555555
639214139,3,7,3.0,10,0.3
639214407,1,18,1.0,19,0.05263157894736842
639216709,5,5,5.0,10,0.5
639237290,7,3,3.0,10,0.3
639247558,1,9,1.0,10,0.1
639254195,1,9,1.0,10,0.1
639258070,5,3,3.0,8,0.375
639262202,4,4,4.0,8,0.5
639270353,1,8,1.0,9,0.1111111111111111
639270686,3,7,3.0,10,0.3
639272892,2,8,2.0,10,0.2
639275423,5,5,5.0,10,0.5
639282755,1,7,1.0,8,0.125
639334834,1,7,1.0,8,0.125
639335376,1,9,1.0,10,0.1
639337142,1,9,1.0,10,0.1
639337757,1,8,1.0,9,0.1111111111111111
639358284,4,16,4.0,20,0.2
639365171,20,1,1.0,21,0.047619047619047616
639369667,2,8,2.0,10,0.2
639382915,9,1,1.0,10,0.1
639383069,4,4,4.0,8,0.5
639383832,2,8,2.0,10,0.2
639383932,4,6,4.0,10,0.4
639396143,1,19,1.0,20,0.05
639396781,3,26,3.0,29,0.10344827586206896
639423463,1,9,1.0,10,0.1
639424909,8,2,2.0,10,0.2
639425707,5,5,5.0,10,0.5
639431875,7,3,3.0,10,0.3
639461758,1,9,1.0,10,0.1
639467792,1,9,1.0,10,0.1
639483316,1,8,1.0,9,0.1111111111111111
639487322,5,5,5.0,10,0.5
639488992,1,9,1.0,10,0.1
639490270,2,8,2.0,10,0.2
639490282,1,7,1.0,8,0.125
639494306,13,13,13.0,26,0.5
639499810,2,7,2.0,9,0.2222222222222222
639506111,3,7,3.0,10,0.3
639506975,21,9,9.0,30,0.3
639599311,1,19,1.0,20,0.05
639615260,1,7,1.0,8,0.125
639615904,5,14,5.0,19,0.2631578947368421
639732566,1,8,1.0,9,0.1111111111111111
639766781,1,18,1.0,19,0.05263157894736842
639816819,4,6,4.0,10,0.4
639817124,4,5,4.0,9,0.4444444444444444
639817178,1,9,1.0,10,0.1
639817258,4,6,4.0,10,0.4
639819409,1,9,1.0,10,0.1
639822833,1,8,1.0,9,0.1111111111111111
639852652,1,18,1.0,19,0.05263157894736842
639888478,2,7,2.0,9,0.2222222222222222
639900329,1,9,1.0,10,0.1
639968226,1,9,1.0,10,0.1
639987535,4,24,4.0,28,0.14285714285714285
639995776,1,19,1.0,20,0.05
640000064,1,19,1.0,20,0.05
640001322,2,8,2.0,10,0.2
640056595,6,3,3.0,9,0.3333333333333333
640136944,4,4,4.0,8,0.5
640156053,1,8,1.0,9,0.1111111111111111
640171888,4,5,4.0,9,0.4444444444444444
640204779,1,27,1.0,28,0.03571428571428571
640207472,6,4,4.0,10,0.4
640207821,6,4,4.0,10,0.4
640238473,1,8,1.0,9,0.1111111111111111
640269967,1,9,1.0,10,0.1
640271554,1,8,1.0,9,0.1111111111111111
640274167,11,16,11.0,27,0.4074074074074074
640286969,1,8,1.0,9,0.1111111111111111
640293271,8,2,2.0,10,0.2
640293548,7,3,3.0,10,0.3
640294081,1,9,1.0,10,0.1
640295615,1,9,1.0,10,0.1
640299408,2,7,2.0,9,0.2222222222222222
640304286,2,16,2.0,18,0.1111111111111111
640404193,1,8,1.0,9,0.1111111111111111
640413002,6,2,2.0,8,0.25
640421441,1,7,1.0,8,0.125
640433282,1,8,1.0,9,0.1111111111111111
640451725,1,9,1.0,10,0.1
640452182,2,8,2.0,10,0.2
640452517,1,9,1.0,10,0.1
640517523,2,8,2.0,10,0.2
640539297,1,8,1.0,9,0.1111111111111111
640571085,1,9,1.0,10,0.1
640686766,5,4,4.0,9,0.4444444444444444
640814735,5,15,5.0,20,0.25
640913301,6,4,4.0,10,0.4
640959172,1,9,1.0,10,0.1
640986599,1,19,1.0,20,0.05
640989742,1,8,1.0,9,0.1111111111111111
641000303,1,8,1.0,9,0.1111111111111111
641007209,1,9,1.0,10,0.1
641018044,8,2,2.0,10,0.2
641020461,2,7,2.0,9,0.2222222222222222
641027588,1,9,1.0,10,0.1
641033139,1,9,1.0,10,0.1
641039902,1,8,1.0,9,0.1111111111111111
641076913,2,8,2.0,10,0.2
641082130,2,25,2.0,27,0.07407407407407407
641089177,1,8,1.0,9,0.1111111111111111
641093351,1,7,1.0,8,0.125
641095767,1,8,1.0,9,0.1111111111111111
641097128,2,26,2.0,28,0.07142857142857142
641102564,2,7,2.0,9,0.2222222222222222
641104244,1,8,1.0,9,0.1111111111111111
641110274,4,5,4.0,9,0.4444444444444444
641111294,1,9,1.0,10,0.1
641121897,3,6,3.0,9,0.3333333333333333
641124789,5,5,5.0,10,0.5
641143884,1,18,1.0,19,0.05263157894736842
641187801,3,7,3.0,10,0.3
641189370,9,1,1.0,10,0.1
641218208,2,8,2.0,10,0.2
641218924,1,9,1.0,10,0.1
641256504,4,5,4.0,9,0.4444444444444444
641257345,3,7,3.0,10,0.3
641275780,1,9,1.0,10,0.1
641276207,1,7,1.0,8,0.125
641276633,1,9,1.0,10,0.1
641288650,5,3,3.0,8,0.375
641300805,6,14,6.0,20,0.3
641301238,3,6,3.0,9,0.3333333333333333
641302153,2,8,2.0,10,0.2
641359199,4,6,4.0,10,0.4
641369238,9,1,1.0,10,0.1
641420437,1,9,1.0,10,0.1
641436979,3,5,3.0,8,0.375
641464160,1,8,1.0,9,0.1111111111111111
641469697,5,4,4.0,9,0.4444444444444444
641471102,2,8,2.0,10,0.2
641477854,4,5,4.0,9,0.4444444444444444
641478015,2,7,2.0,9,0.2222222222222222
641484685,1,8,1.0,9,0.1111111111111111
641488550,4,6,4.0,10,0.4
641491742,6,4,4.0,10,0.4
641563548,9,1,1.0,10,0.1
641580552,2,8,2.0,10,0.2
641583806,1,9,1.0,10,0.1
641584715,1,9,1.0,10,0.1
641585326,1,9,1.0,10,0.1
641672224,1,7,1.0,8,0.125
641681310,1,17,1.0,18,0.05555555555555555
641753374,1,9,1.0,10,0.1
641760254,7,3,3.0,10,0.3
641788819,2,18,2.0,20,0.1
641876167,5,5,5.0,10,0.5
641881835,1,8,1.0,9,0.1111111111111111
642008877,1,25,1.0,26,0.038461538461538464
642022442,1,7,1.0,8,0.125
642042720,5,13,5.0,18,0.2777777777777778
642043043,1,8,1.0,9,0.1111111111111111
642048473,9,21,9.0,30,0.3
642061981,1,8,1.0,9,0.1111111111111111
642068629,2,6,2.0,8,0.25
642068921,5,3,3.0,8,0.375
642083309,5,5,5.0,10,0.5
642083601,2,7,2.0,9,0.2222222222222222
642092954,1,8,1.0,9,0.1111111111111111
642093815,1,9,1.0,10,0.1
642095639,1,17,1.0,18,0.05555555555555555
642146431,7,3,3.0,10,0.3
642146562,8,2,2.0,10,0.2
642147511,6,3,3.0,9,0.3333333333333333
642153316,4,6,4.0,10,0.4
642169488,2,8,2.0,10,0.2
642173896,1,8,1.0,9,0.1111111111111111
642190845,2,18,2.0,20,0.1
642222010,2,6,2.0,8,0.25
642257520,5,15,5.0,20,0.25
642320960,5,5,5.0,10,0.5
642321383,3,7,3.0,10,0.3
642322850,1,9,1.0,10,0.1
642325121,1,7,1.0,8,0.125
642329598,4,6,4.0,10,0.4
642329901,1,8,1.0,9,0.1111111111111111
642386975,1,8,1.0,9,0.1111111111111111
642387523,2,8,2.0,10,0.2
642388010,2,8,2.0,10,0.2
642388799,4,6,4.0,10,0.4
642481098,1,8,1.0,9,0.1111111111111111
642511662,5,5,5.0,10,0.5
642520071,1,19,1.0,20,0.05
642526166,4,6,4.0,10,0.4
642546292,17,9,9.0,26,0.34615384615384615
642549771,1,9,1.0,10,0.1
642552388,6,4,4.0,10,0.4
642636513,2,7,2.0,9,0.2222222222222222
642648159,1,18,1.0,19,0.05263157894736842
642660149,1,9,1.0,10,0.1
642688957,1,8,1.0,9,0.1111111111111111
642691711,1,8,1.0,9,0.1111111111111111
642716815,3,7,3.0,10,0.3
642719005,1,9,1.0,10,0.1
642722432,1,8,1.0,9,0.1111111111111111
642792993,1,26,1.0,27,0.037037037037037035
642809845,1,8,1.0,9,0.1111111111111111
642854801,8,1,1.0,9,0.1111111111111111
642855678,6,3,3.0,9,0.3333333333333333
642876281,2,8,2.0,10,0.2
642876573,1,8,1.0,9,0.1111111111111111
642938698,2,16,2.0,18,0.1111111111111111
642939140,6,4,4.0,10,0.4
642940143,4,6,4.0,10,0.4
642941087,1,19,1.0,20,0.05
642953273,5,14,5.0,19,0.2631578947368421
643000273,1,9,1.0,10,0.1
643042310,3,7,3.0,10,0.3
643042433,8,1,1.0,9,0.1111111111111111
643059406,4,6,4.0,10,0.4
643072117,1,9,1.0,10,0.1
643076448,1,8,1.0,9,0.1111111111111111
643079528,1,9,1.0,10,0.1
643083099,1,9,1.0,10,0.1
643083461,1,9,1.0,10,0.1
643126713,1,7,1.0,8,0.125
643130278,1,18,1.0,19,0.05263157894736842
643149595,1,8,1.0,9,0.1111111111111111
643160023,1,9,1.0,10,0.1
643176769,1,9,1.0,10,0.1
643194191,1,8,1.0,9,0.1111111111111111
643224245,1,18,1.0,19,0.05263157894736842
643235557,1,19,1.0,20,0.05
643237732,1,8,1.0,9,0.1111111111111111
643262691,12,6,6.0,18,0.3333333333333333
643296417,1,9,1.0,10,0.1
643315695,21,8,8.0,29,0.27586206896551724
643324215,22,6,6.0,28,0.21428571428571427
643408432,2,7,2.0,9,0.2222222222222222
643455739,1,19,1.0,20,0.05
643459206,4,5,4.0,9,0.4444444444444444
643460225,1,8,1.0,9,0.1111111111111111
643517271,8,21,8.0,29,0.27586206896551724
643539632,2,18,2.0,20,0.1
643549187,1,7,1.0,8,0.125
643555493,2,8,2.0,10,0.2
643559530,1,8,1.0,9,0.1111111111111111
643597615,4,25,4.0,29,0.13793103448275862
643611981,6,4,4.0,10,0.4
643632929,3,14,3.0,17,0.17647058823529413
643636171,3,7,3.0,10,0.3
643710948,1,9,1.0,10,0.1
643727934,3,6,3.0,9,0.3333333333333333
643760875,1,9,1.0,10,0.1
643761731,1,9,1.0,10,0.1
643762061,1,9,1.0,10,0.1
643779659,1,18,1.0,19,0.05263157894736842
643847196,6,13,6.0,19,0.3157894736842105
643847345,7,3,3.0,10,0.3
643847663,1,9,1.0,10,0.1
643859397,1,9,1.0,10,0.1
643862649,1,8,1.0,9,0.1111111111111111
643864096,3,16,3.0,19,0.15789473684210525
643869327,3,17,3.0,20,0.15
643877797,4,5,4.0,9,0.4444444444444444
643884702,2,6,2.0,8,0.25
643885949,7,1,1.0,8,0.125
643887378,6,3,3.0,9,0.3333333333333333
643887447,6,4,4.0,10,0.4
643888053,26,2,2.0,28,0.07142857142857142
643888976,7,3,3.0,10,0.3
643937976,3,6,3.0,9,0.3333333333333333
643938047,1,9,1.0,10,0.1
643938563,4,5,4.0,9,0.4444444444444444
643938753,5,14,5.0,19,0.2631578947368421
643940749,2,8,2.0,10,0.2
643942407,4,24,4.0,28,0.14285714285714285
643943519,2,8,2.0,10,0.2
643943786,2,7,2.0,9,0.2222222222222222
643944174,2,8,2.0,10,0.2
643962483,1,8,1.0,9,0.1111111111111111
643985218,1,7,1.0,8,0.125
643990504,4,4,4.0,8,0.5
643991342,1,9,1.0,10,0.1
643992918,3,5,3.0,8,0.375
643994201,2,8,2.0,10,0.2
643995637,6,4,4.0,10,0.4
644016060,2,8,2.0,10,0.2
644020833,1,17,1.0,18,0.05555555555555555
644035318,2,8,2.0,10,0.2
644036846,2,7,2.0,9,0.2222222222222222
644036996,2,8,2.0,10,0.2
644037072,2,8,2.0,10,0.2
644038117,3,6,3.0,9,0.3333333333333333
644054073,5,5,5.0,10,0.5
644054345,1,9,1.0,10,0.1
644059511,1,8,1.0,9,0.1111111111111111
644086584,8,1,1.0,9,0.1111111111111111
644165635,2,8,2.0,10,0.2
644180354,1,8,1.0,9,0.1111111111111111
644237529,1,9,1.0,10,0.1
644289046,2,8,2.0,10,0.2
644316246,3,7,3.0,10,0.3
644321299,1,18,1.0,19,0.05263157894736842
644324593,1,9,1.0,10,0.1
644352221,1,9,1.0,10,0.1
644372656,2,8,2.0,10,0.2
644379297,1,19,1.0,20,0.05
644479487,3,6,3.0,9,0.3333333333333333
644509981,2,8,2.0,10,0.2
644541711,1,9,1.0,10,0.1
644549410,4,4,4.0,8,0.5
644598453,4,6,4.0,10,0.4
644611521,1,8,1.0,9,0.1111111111111111
644643848,1,9,1.0,10,0.1
644699940,1,9,1.0,10,0.1
644700394,1,8,1.0,9,0.1111111111111111
644729625,7,3,3.0,10,0.3
644742454,15,8,8.0,23,0.34782608695652173
644743842,4,6,4.0,10,0.4
644744214,3,5,3.0,8,0.375
644744617,9,1,1.0,10,0.1
644769816,4,14,4.0,18,0.2222222222222222
644788212,1,18,1.0,19,0.05263157894736842
644805444,4,6,4.0,10,0.4
644831569,2,8,2.0,10,0.2
644839429,1,18,1.0,19,0.05263157894736842
644844910,1,18,1.0,19,0.05263157894736842
644873051,1,9,1.0,10,0.1
644883300,1,8,1.0,9,0.1111111111111111
644884492,2,8,2.0,10,0.2
644972735,4,6,4.0,10,0.4
645015234,2,7,2.0,9,0.2222222222222222
645029529,5,5,5.0,10,0.5
645030665,2,7,2.0,9,0.2222222222222222
645031130,12,17,12.0,29,0.41379310344827586
645031860,4,6,4.0,10,0.4
645047197,3,6,3.0,9,0.3333333333333333
645047996,5,4,4.0,9,0.4444444444444444
645048333,6,3,3.0,9,0.3333333333333333
645049574,3,7,3.0,10,0.3
645068155,1,23,1.0,24,0.041666666666666664
645126067,1,8,1.0,9,0.1111111111111111
645136818,2,8,2.0,10,0.2
645174334,20,9,9.0,29,0.3103448275862069
645177657,5,5,5.0,10,0.5
645177744,8,2,2.0,10,0.2
645220823,4,6,4.0,10,0.4
645249196,1,17,1.0,18,0.05555555555555555
645253811,1,9,1.0,10,0.1
645322446,3,25,3.0,28,0.10714285714285714
645330751,1,8,1.0,9,0.1111111111111111
645351748,1,8,1.0,9,0.1111111111111111
645362877,1,9,1.0,10,0.1
645373120,2,8,2.0,10,0.2
645374111,1,9,1.0,10,0.1
645379922,2,16,2.0,18,0.1111111111111111
645408486,4,6,4.0,10,0.4
645408924,3,7,3.0,10,0.3
645408997,9,1,1.0,10,0.1
645526655,3,7,3.0,10,0.3
645542705,1,9,1.0,10,0.1
645563521,1,9,1.0,10,0.1
645563577,2,7,2.0,9,0.2222222222222222
645651301,4,6,4.0,10,0.4
645757745,4,6,4.0,10,0.4
645758195,3,7,3.0,10,0.3
645760761,2,8,2.0,10,0.2
645761677,7,3,3.0,10,0.3
645770637,2,18,2.0,20,0.1
645848796,1,28,1.0,29,0.034482758620689655
645849551,1,9,1.0,10,0.1
645849779,6,4,4.0,10,0.4
645892117,1,19,1.0,20,0.05
645957738,13,15,13.0,28,0.4642857142857143
645996402,3,15,3.0,18,0.16666666666666666
646038586,11,9,9.0,20,0.45
646065148,1,9,1.0,10,0.1
646108391,1,17,1.0,18,0.05555555555555555
646134575,7,3,3.0,10,0.3
646137063,3,7,3.0,10,0.3
646141473,1,8,1.0,9,0.1111111111111111
646148209,2,7,2.0,9,0.2222222222222222
646148220,3,7,3.0,10,0.3
646148855,4,5,4.0,9,0.4444444444444444
646150093,6,4,4.0,10,0.4
646183595,1,8,1.0,9,0.1111111111111111
646188494,4,6,4.0,10,0.4
646198042,2,8,2.0,10,0.2
646254157,3,7,3.0,10,0.3
646261152,1,8,1.0,9,0.1111111111111111
646275306,3,6,3.0,9,0.3333333333333333
646299140,1,15,1.0,16,0.0625
646313598,1,8,1.0,9,0.1111111111111111
646344318,5,4,4.0,9,0.4444444444444444
646346307,4,26,4.0,30,0.13333333333333333
646346629,6,4,4.0,10,0.4
646367377,1,9,1.0,10,0.1
646368754,3,6,3.0,9,0.3333333333333333
646369208,2,8,2.0,10,0.2
646371890,4,5,4.0,9,0.4444444444444444
646404923,3,6,3.0,9,0.3333333333333333
646432439,1,9,1.0,10,0.1
646457464,1,9,1.0,10,0.1
646463794,1,9,1.0,10,0.1
646467778,5,5,5.0,10,0.5
646534797,1,9,1.0,10,0.1
646535567,5,4,4.0,9,0.4444444444444444
646535859,1,9,1.0,10,0.1
646536151,1,9,1.0,10,0.1
646536370,6,3,3.0,9,0.3333333333333333
646543021,4,4,4.0,8,0.5
646543923,1,9,1.0,10,0.1
646544875,3,6,3.0,9,0.3333333333333333
646545157,1,9,1.0,10,0.1
646549965,2,7,2.0,9,0.2222222222222222
646564297,1,9,1.0,10,0.1
646573530,2,15,2.0,17,0.11764705882352941
646594341,12,7,7.0,19,0.3684210526315789
646596270,4,6,4.0,10,0.4
646611996,1,9,1.0,10,0.1
646619895,7,21,7.0,28,0.25
646620021,4,6,4.0,10,0.4
646621889,2,8,2.0,10,0.2
646627052,9,1,1.0,10,0.1
646627076,3,7,3.0,10,0.3
646627389,5,5,5.0,10,0.5
646636582,1,9,1.0,10,0.1
646645169,1,18,1.0,19,0.05263157894736842
646689506,1,19,1.0,20,0.05
646696117,2,8,2.0,10,0.2
646700470,1,9,1.0,10,0.1
646723041,1,9,1.0,10,0.1
646730263,1,17,1.0,18,0.05555555555555555
646765569,7,3,3.0,10,0.3
646766245,2,8,2.0,10,0.2
646766308,1,9,1.0,10,0.1
646766471,5,5,5.0,10,0.5
646792586,1,9,1.0,10,0.1
646798526,2,7,2.0,9,0.2222222222222222
646811904,1,8,1.0,9,0.1111111111111111
646840004,2,8,2.0,10,0.2
646842831,1,8,1.0,9,0.1111111111111111
646859077,2,7,2.0,9,0.2222222222222222
646859888,7,2,2.0,9,0.2222222222222222
646889682,3,7,3.0,10,0.3
646893984,1,9,1.0,10,0.1
646900424,5,3,3.0,8,0.375
646905913,2,7,2.0,9,0.2222222222222222
646907590,3,7,3.0,10,0.3
646928045,2,7,2.0,9,0.2222222222222222
646946451,1,8,1.0,9,0.1111111111111111
646951033,2,7,2.0,9,0.2222222222222222
646959305,9,11,9.0,20,0.45
646980090,2,8,2.0,10,0.2
647005870,1,18,1.0,19,0.05263157894736842
647020948,27,3,3.0,30,0.1
647021209,1,8,1.0,9,0.1111111111111111
647119762,2,8,2.0,10,0.2
647130412,2,18,2.0,20,0.1
647139783,2,8,2.0,10,0.2
647177565,1,29,1.0,30,0.03333333333333333
647191176,2,8,2.0,10,0.2
647191450,2,7,2.0,9,0.2222222222222222
647205937,2,8,2.0,10,0.2
647214372,3,6,3.0,9,0.3333333333333333
647234590,1,9,1.0,10,0.1
647278117,1,8,1.0,9,0.1111111111111111
647322870,6,4,4.0,10,0.4
647325546,3,7,3.0,10,0.3
647326218,5,4,4.0,9,0.4444444444444444
647329093,4,6,4.0,10,0.4
647329355,1,8,1.0,9,0.1111111111111111
647329429,9,1,1.0,10,0.1
647353695,1,9,1.0,10,0.1
647354197,1,9,1.0,10,0.1
647424210,1,8,1.0,9,0.1111111111111111
647424420,3,7,3.0,10,0.3
647428800,7,13,7.0,20,0.35
647466091,1,7,1.0,8,0.125
647481407,2,8,2.0,10,0.2
647481806,5,5,5.0,10,0.5
647484958,1,9,1.0,10,0.1
647500881,1,8,1.0,9,0.1111111111111111
647512957,2,7,2.0,9,0.2222222222222222
647513174,2,7,2.0,9,0.2222222222222222
647513272,3,7,3.0,10,0.3
647516290,2,8,2.0,10,0.2
647517259,2,26,2.0,28,0.07142857142857142
647522251,1,8,1.0,9,0.1111111111111111
647525754,1,9,1.0,10,0.1
647549979,2,8,2.0,10,0.2
647552671,5,5,5.0,10,0.5
647570181,4,5,4.0,9,0.4444444444444444
647570515,1,7,1.0,8,0.125
647571380,3,7,3.0,10,0.3
647590543,1,9,1.0,10,0.1
647595083,1,8,1.0,9,0.1111111111111111
647595928,5,5,5.0,10,0.5
647607802,7,2,2.0,9,0.2222222222222222
647616269,1,8,1.0,9,0.1111111111111111
647682927,7,2,2.0,9,0.2222222222222222
647694270,1,8,1.0,9,0.1111111111111111
647708838,2,17,2.0,19,0.10526315789473684
647722379,2,8,2.0,10,0.2
647725020,1,9,1.0,10,0.1
647753330,2,15,2.0,17,0.11764705882352941
647755912,1,8,1.0,9,0.1111111111111111
647786752,1,9,1.0,10,0.1
647804766,1,8,1.0,9,0.1111111111111111
647871762,8,2,2.0,10,0.2
647889326,1,9,1.0,10,0.1
647912355,4,6,4.0,10,0.4
647943163,1,16,1.0,17,0.058823529411764705
647953207,6,3,3.0,9,0.3333333333333333
647987069,1,8,1.0,9,0.1111111111111111
648026476,1,9,1.0,10,0.1
648033075,3,7,3.0,10,0.3
648048203,6,3,3.0,9,0.3333333333333333
648061024,1,19,1.0,20,0.05
648099701,1,9,1.0,10,0.1
648101690,1,9,1.0,10,0.1
648141396,4,5,4.0,9,0.4444444444444444
648143095,9,1,1.0,10,0.1
648173905,3,6,3.0,9,0.3333333333333333
648227955,1,9,1.0,10,0.1
648257943,2,8,2.0,10,0.2
648289462,8,1,1.0,9,0.1111111111111111
648320008,6,4,4.0,10,0.4
648327837,1,9,1.0,10,0.1
648367485,2,8,2.0,10,0.2
648379221,1,8,1.0,9,0.1111111111111111
648415638,1,9,1.0,10,0.1
648420292,2,6,2.0,8,0.25
648445511,5,14,5.0,19,0.2631578947368421
648454315,1,9,1.0,10,0.1
648458579,1,9,1.0,10,0.1
648476436,4,6,4.0,10,0.4
648483962,6,22,6.0,28,0.21428571428571427
648492261,1,9,1.0,10,0.1
648492593,1,7,1.0,8,0.125
648495137,7,11,7.0,18,0.3888888888888889
648503690,1,9,1.0,10,0.1
648534845,1,17,1.0,18,0.05555555555555555
648539667,1,9,1.0,10,0.1
648576108,2,8,2.0,10,0.2
648622424,1,8,1.0,9,0.1111111111111111
648645603,4,6,4.0,10,0.4
648654741,1,9,1.0,10,0.1
648661870,2,6,2.0,8,0.25
648662812,1,9,1.0,10,0.1
648668326,1,9,1.0,10,0.1
648673557,8,2,2.0,10,0.2
648673598,7,2,2.0,9,0.2222222222222222
648675608,3,7,3.0,10,0.3
648675676,1,8,1.0,9,0.1111111111111111
648686796,1,9,1.0,10,0.1
648710764,1,9,1.0,10,0.1
648724199,1,9,1.0,10,0.1
648751686,3,7,3.0,10,0.3
648752639,2,28,2.0,30,0.06666666666666667
648752919,1,8,1.0,9,0.1111111111111111
648778563,1,7,1.0,8,0.125
648808423,2,16,2.0,18,0.1111111111111111
648819364,8,1,1.0,9,0.1111111111111111
648825624,1,9,1.0,10,0.1
648825928,2,7,2.0,9,0.2222222222222222
648853224,6,11,6.0,17,0.35294117647058826
648872902,2,8,2.0,10,0.2
648873020,1,8,1.0,9,0.1111111111111111
648878027,9,1,1.0,10,0.1
648899307,1,8,1.0,9,0.1111111111111111
648913850,1,8,1.0,9,0.1111111111111111
648915304,4,23,4.0,27,0.14814814814814814
648915677,6,19,6.0,25,0.24
648917662,1,9,1.0,10,0.1
648919229,1,8,1.0,9,0.1111111111111111
648921516,2,7,2.0,9,0.2222222222222222
648998496,2,8,2.0,10,0.2
648998857,1,8,1.0,9,0.1111111111111111
649004946,1,18,1.0,19,0.05263157894736842
649005368,1,18,1.0,19,0.05263157894736842
649031333,1,8,1.0,9,0.1111111111111111
649039171,2,7,2.0,9,0.2222222222222222
649060943,1,8,1.0,9,0.1111111111111111
649130424,2,18,2.0,20,0.1
649139020,24,4,4.0,28,0.14285714285714285
649139717,1,9,1.0,10,0.1
649140150,5,5,5.0,10,0.5
649142585,3,7,3.0,10,0.3
649144175,2,8,2.0,10,0.2
649145995,3,7,3.0,10,0.3
649146477,2,7,2.0,9,0.2222222222222222
649152573,5,5,5.0,10,0.5
649157123,1,9,1.0,10,0.1
649184807,3,7,3.0,10,0.3
649194900,9,1,1.0,10,0.1
649200387,1,9,1.0,10,0.1
649203152,1,18,1.0,19,0.05263157894736842
649218389,12,17,12.0,29,0.41379310344827586
649261947,2,18,2.0,20,0.1
649263952,3,7,3.0,10,0.3
649294296,9,1,1.0,10,0.1
649377897,1,18,1.0,19,0.05263157894736842
649429224,2,18,2.0,20,0.1
649452071,1,19,1.0,20,0.05
649456132,1,7,1.0,8,0.125
649456890,6,3,3.0,9,0.3333333333333333
649465971,1,9,1.0,10,0.1
649487830,3,7,3.0,10,0.3
649489178,7,3,3.0,10,0.3
649520252,1,9,1.0,10,0.1
649521622,6,4,4.0,10,0.4
649522098,3,7,3.0,10,0.3
649522360,7,2,2.0,9,0.2222222222222222
649523010,8,2,2.0,10,0.2
649525178,2,17,2.0,19,0.10526315789473684
649531540,1,9,1.0,10,0.1
649532848,2,8,2.0,10,0.2
649536686,2,8,2.0,10,0.2
649540465,1,9,1.0,10,0.1
649550087,1,17,1.0,18,0.05555555555555555
649551578,5,5,5.0,10,0.5
649578006,1,8,1.0,9,0.1111111111111111
649610894,1,7,1.0,8,0.125
649632850,1,9,1.0,10,0.1
649634331,2,8,2.0,10,0.2
649636869,1,8,1.0,9,0.1111111111111111
649642177,8,1,1.0,9,0.1111111111111111
649643386,1,9,1.0,10,0.1
649669531,8,1,1.0,9,0.1111111111111111
649670023,2,7,2.0,9,0.2222222222222222
649670312,4,5,4.0,9,0.4444444444444444
649672081,1,19,1.0,20,0.05
649675911,3,7,3.0,10,0.3
649685639,2,8,2.0,10,0.2
649747063,1,8,1.0,9,0.1111111111111111
649747370,1,8,1.0,9,0.1111111111111111
649751779,2,6,2.0,8,0.25
649764984,2,6,2.0,8,0.25
649830893,1,9,1.0,10,0.1
649831491,6,22,6.0,28,0.21428571428571427
649860986,9,1,1.0,10,0.1
649861358,11,16,11.0,27,0.4074074074074074
649863582,1,9,1.0,10,0.1
649893082,5,4,4.0,9,0.4444444444444444
649896820,1,9,1.0,10,0.1
649899482,2,8,2.0,10,0.2
649905945,3,7,3.0,10,0.3
649906493,8,1,1.0,9,0.1111111111111111
649922752,1,7,1.0,8,0.125
649927017,1,19,1.0,20,0.05
650010563,1,7,1.0,8,0.125
650019045,1,9,1.0,10,0.1
650019256,1,27,1.0,28,0.03571428571428571
650019597,3,27,3.0,30,0.1
650021526,6,22,6.0,28,0.21428571428571427
650021835,3,7,3.0,10,0.3
650049729,1,9,1.0,10,0.1
650173151,1,19,1.0,20,0.05
650204342,1,9,1.0,10,0.1
650220909,4,6,4.0,10,0.4
650250251,1,8,1.0,9,0.1111111111111111
650294055,1,8,1.0,9,0.1111111111111111
650300089,3,16,3.0,19,0.15789473684210525
650304606,2,8,2.0,10,0.2
650305378,2,18,2.0,20,0.1
650305519,4,5,4.0,9,0.4444444444444444
650306366,2,8,2.0,10,0.2
650327955,2,8,2.0,10,0.2
650337081,2,8,2.0,10,0.2
650380330,1,8,1.0,9,0.1111111111111111
650636561,1,7,1.0,8,0.125
650695372,1,8,1.0,9,0.1111111111111111
650709601,5,14,5.0,19,0.2631578947368421
650712652,1,8,1.0,9,0.1111111111111111
650738641,1,9,1.0,10,0.1
650738809,3,5,3.0,8,0.375
650738865,1,9,1.0,10,0.1
650750493,9,1,1.0,10,0.1
650750794,9,1,1.0,10,0.1
650793984,2,8,2.0,10,0.2
650794718,3,7,3.0,10,0.3
650800620,27,3,3.0,30,0.1
650813294,5,4,4.0,9,0.4444444444444444
650825339,3,7,3.0,10,0.3
650842896,6,24,6.0,30,0.2
650845190,1,9,1.0,10,0.1
650845515,3,7,3.0,10,0.3
650847995,4,26,4.0,30,0.13333333333333333
650848973,1,7,1.0,8,0.125
650851639,2,8,2.0,10,0.2
650875964,5,5,5.0,10,0.5
650907348,1,9,1.0,10,0.1
650931617,2,8,2.0,10,0.2
650933865,1,19,1.0,20,0.05
650937977,1,9,1.0,10,0.1
650940961,1,9,1.0,10,0.1
650941688,6,23,6.0,29,0.20689655172413793
650942086,1,9,1.0,10,0.1
650942812,6,4,4.0,10,0.4
650945087,3,7,3.0,10,0.3
650945824,1,9,1.0,10,0.1
650948431,7,2,2.0,9,0.2222222222222222
650957953,1,19,1.0,20,0.05
650970418,2,7,2.0,9,0.2222222222222222
650980031,1,9,1.0,10,0.1
650994314,1,9,1.0,10,0.1
651003087,9,1,1.0,10,0.1
651003960,4,6,4.0,10,0.4
651018288,1,9,1.0,10,0.1
651032813,3,26,3.0,29,0.10344827586206896
651039522,2,7,2.0,9,0.2222222222222222
651062536,1,19,1.0,20,0.05
651079642,1,27,1.0,28,0.03571428571428571
651103539,8,1,1.0,9,0.1111111111111111
651129445,1,9,1.0,10,0.1
651131274,1,8,1.0,9,0.1111111111111111
651132359,1,7,1.0,8,0.125
651144838,3,6,3.0,9,0.3333333333333333
651175824,1,9,1.0,10,0.1
651221969,4,6,4.0,10,0.4
651238832,2,8,2.0,10,0.2
651251409,1,18,1.0,19,0.05263157894736842
651251822,1,8,1.0,9,0.1111111111111111
651266939,4,5,4.0,9,0.4444444444444444
651267301,3,26,3.0,29,0.10344827586206896
651291976,2,6,2.0,8,0.25
651322716,1,9,1.0,10,0.1
651328494,9,1,1.0,10,0.1
651329018,1,9,1.0,10,0.1
651337802,3,7,3.0,10,0.3
651349675,1,17,1.0,18,0.05555555555555555
651365773,1,9,1.0,10,0.1
651367290,1,27,1.0,28,0.03571428571428571
651477540,1,9,1.0,10,0.1
651503907,9,1,1.0,10,0.1
651504228,9,1,1.0,10,0.1
651522815,8,1,1.0,9,0.1111111111111111
651531212,1,9,1.0,10,0.1
651591921,2,8,2.0,10,0.2
651639275,8,2,2.0,10,0.2
651657182,4,23,4.0,27,0.14814814814814814
651661852,5,5,5.0,10,0.5
651687129,4,6,4.0,10,0.4
651932401,1,7,1.0,8,0.125
651935309,3,6,3.0,9,0.3333333333333333
651936783,3,6,3.0,9,0.3333333333333333
651947372,6,3,3.0,9,0.3333333333333333
651948408,5,5,5.0,10,0.5
651948711,6,4,4.0,10,0.4
651948910,2,7,2.0,9,0.2222222222222222
651949704,6,3,3.0,9,0.3333333333333333
651949924,7,2,2.0,9,0.2222222222222222
651953252,9,1,1.0,10,0.1
651954389,1,8,1.0,9,0.1111111111111111
651960947,1,18,1.0,19,0.05263157894736842
651963769,3,7,3.0,10,0.3
651964492,2,6,2.0,8,0.25
651964797,6,4,4.0,10,0.4
651965200,6,3,3.0,9,0.3333333333333333
651967232,7,2,2.0,9,0.2222222222222222
651967733,6,4,4.0,10,0.4
651968107,5,22,5.0,27,0.18518518518518517
651968453,2,8,2.0,10,0.2
651969463,8,2,2.0,10,0.2
652001826,1,9,1.0,10,0.1
652033570,3,7,3.0,10,0.3
652064016,3,6,3.0,9,0.3333333333333333
652064811,4,5,4.0,9,0.4444444444444444
652064960,8,2,2.0,10,0.2
652097700,1,8,1.0,9,0.1111111111111111
652273190,1,19,1.0,20,0.05
652319223,1,8,1.0,9,0.1111111111111111
652471483,7,2,2.0,9,0.2222222222222222
652478896,1,9,1.0,10,0.1
652500965,17,2,2.0,19,0.10526315789473684
652503138,7,2,2.0,9,0.2222222222222222
652674290,5,5,5.0,10,0.5
652675305,2,8,2.0,10,0.2
652724554,1,8,1.0,9,0.1111111111111111
652731248,1,9,1.0,10,0.1
652731892,1,26,1.0,27,0.037037037037037035
652751161,1,7,1.0,8,0.125
652764095,2,8,2.0,10,0.2
652776717,1,9,1.0,10,0.1
652802136,1,19,1.0,20,0.05
652818229,6,4,4.0,10,0.4
652841758,1,8,1.0,9,0.1111111111111111
652893923,1,18,1.0,19,0.05263157894736842
652904257,2,8,2.0,10,0.2
652910874,7,9,7.0,16,0.4375
652913668,3,7,3.0,10,0.3
652918262,4,15,4.0,19,0.21052631578947367
652936603,1,9,1.0,10,0.1
652937052,2,7,2.0,9,0.2222222222222222
652944376,1,9,1.0,10,0.1
652974557,5,4,4.0,9,0.4444444444444444
653004638,2,8,2.0,10,0.2
653004666,2,27,2.0,29,0.06896551724137931
653010697,1,9,1.0,10,0.1
653011165,5,5,5.0,10,0.5
653013930,1,19,1.0,20,0.05
653020141,2,7,2.0,9,0.2222222222222222
653037920,3,7,3.0,10,0.3
653044529,4,6,4.0,10,0.4
653069547,1,18,1.0,19,0.05263157894736842
653082306,1,9,1.0,10,0.1
653083015,1,8,1.0,9,0.1111111111111111
653083884,4,5,4.0,9,0.4444444444444444
653110576,2,8,2.0,10,0.2
653133360,1,8,1.0,9,0.1111111111111111
653224169,3,7,3.0,10,0.3
653224561,1,9,1.0,10,0.1
653234733,5,5,5.0,10,0.5
653235208,8,1,1.0,9,0.1111111111111111
653236161,6,4,4.0,10,0.4
653254783,1,8,1.0,9,0.1111111111111111
653288205,9,1,1.0,10,0.1
653352283,1,8,1.0,9,0.1111111111111111
653405742,2,8,2.0,10,0.2
653416203,6,4,4.0,10,0.4
653455369,1,18,1.0,19,0.05263157894736842
653480899,1,9,1.0,10,0.1
653504909,1,8,1.0,9,0.1111111111111111
653514731,9,1,1.0,10,0.1
653516263,1,8,1.0,9,0.1111111111111111
653517524,3,7,3.0,10,0.3
653517963,1,8,1.0,9,0.1111111111111111
653519582,7,3,3.0,10,0.3
653519888,1,8,1.0,9,0.1111111111111111
653536861,2,18,2.0,20,0.1
653539795,3,26,3.0,29,0.10344827586206896
653550772,5,3,3.0,8,0.375
653569733,2,7,2.0,9,0.2222222222222222
653572753,1,9,1.0,10,0.1
653575681,3,7,3.0,10,0.3
653576219,1,9,1.0,10,0.1
653600407,3,7,3.0,10,0.3
653611226,6,4,4.0,10,0.4
653618015,1,26,1.0,27,0.037037037037037035
653645674,3,7,3.0,10,0.3
653679886,2,7,2.0,9,0.2222222222222222
653680057,5,4,4.0,9,0.4444444444444444
653680472,19,8,8.0,27,0.2962962962962963
653681793,5,4,4.0,9,0.4444444444444444
653725203,6,3,3.0,9,0.3333333333333333
653730569,16,12,12.0,28,0.42857142857142855
653742144,4,6,4.0,10,0.4
653752207,7,23,7.0,30,0.23333333333333334
653756294,1,9,1.0,10,0.1
653765915,1,8,1.0,9,0.1111111111111111
653766526,6,4,4.0,10,0.4
653766678,1,9,1.0,10,0.1
653766900,9,1,1.0,10,0.1
653808130,4,6,4.0,10,0.4
653819076,1,8,1.0,9,0.1111111111111111
653839336,1,7,1.0,8,0.125
653841731,1,9,1.0,10,0.1
653852455,1,8,1.0,9,0.1111111111111111
653859999,4,6,4.0,10,0.4
653948859,2,8,2.0,10,0.2
653962781,8,2,2.0,10,0.2
653963098,1,8,1.0,9,0.1111111111111111
653967204,1,8,1.0,9,0.1111111111111111
653982021,2,8,2.0,10,0.2
654008168,5,5,5.0,10,0.5
654026334,2,8,2.0,10,0.2
654026727,4,6,4.0,10,0.4
654031660,2,17,2.0,19,0.10526315789473684
654033774,4,6,4.0,10,0.4
654043413,1,16,1.0,17,0.058823529411764705
654058387,6,4,4.0,10,0.4
654064597,1,9,1.0,10,0.1
654069709,1,8,1.0,9,0.1111111111111111
654084122,2,15,2.0,17,0.11764705882352941
654127722,1,18,1.0,19,0.05263157894736842
654135792,4,6,4.0,10,0.4
654169361,1,9,1.0,10,0.1
654215956,1,9,1.0,10,0.1
654221697,1,9,1.0,10,0.1
654233292,1,19,1.0,20,0.05
654264746,5,24,5.0,29,0.1724137931034483
654278038,3,16,3.0,19,0.15789473684210525
654288642,1,7,1.0,8,0.125
654309566,1,9,1.0,10,0.1
654351163,4,6,4.0,10,0.4
654357757,4,6,4.0,10,0.4
654368903,1,19,1.0,20,0.05
654376069,1,18,1.0,19,0.05263157894736842
654404198,5,5,5.0,10,0.5
654436759,1,18,1.0,19,0.05263157894736842
654445938,4,6,4.0,10,0.4
654448006,4,6,4.0,10,0.4
654452888,7,3,3.0,10,0.3
654470800,1,18,1.0,19,0.05263157894736842
654512724,1,8,1.0,9,0.1111111111111111
654531924,2,8,2.0,10,0.2
654559095,2,7,2.0,9,0.2222222222222222
654566560,2,8,2.0,10,0.2
654573613,2,6,2.0,8,0.25
654595939,2,7,2.0,9,0.2222222222222222
654606411,8,1,1.0,9,0.1111111111111111
654636121,1,9,1.0,10,0.1
654642156,3,5,3.0,8,0.375
654648601,1,9,1.0,10,0.1
654654077,3,7,3.0,10,0.3
654670387,2,8,2.0,10,0.2
654705531,1,8,1.0,9,0.1111111111111111
654706986,2,8,2.0,10,0.2
654739491,9,21,9.0,30,0.3
654766308,2,8,2.0,10,0.2
654767174,1,9,1.0,10,0.1
654770782,2,8,2.0,10,0.2
654771595,4,6,4.0,10,0.4
654786011,1,9,1.0,10,0.1
654803786,1,9,1.0,10,0.1
654810601,1,9,1.0,10,0.1
654824352,1,9,1.0,10,0.1
654824625,18,10,10.0,28,0.35714285714285715
654832179,4,5,4.0,9,0.4444444444444444
654846015,17,12,12.0,29,0.41379310344827586
654846207,2,8,2.0,10,0.2
654875492,1,8,1.0,9,0.1111111111111111
654895246,8,11,8.0,19,0.42105263157894735
654895443,2,8,2.0,10,0.2
654908601,1,9,1.0,10,0.1
654912317,2,8,2.0,10,0.2
654917613,5,5,5.0,10,0.5
654944985,1,9,1.0,10,0.1
654945922,2,8,2.0,10,0.2
654947254,1,9,1.0,10,0.1
654960184,9,1,1.0,10,0.1
654961140,1,8,1.0,9,0.1111111111111111
654964712,1,8,1.0,9,0.1111111111111111
654977102,2,18,2.0,20,0.1
654992850,1,8,1.0,9,0.1111111111111111
654996404,6,4,4.0,10,0.4
655042362,1,9,1.0,10,0.1
655047871,1,17,1.0,18,0.05555555555555555
655060738,1,8,1.0,9,0.1111111111111111
655060842,1,8,1.0,9,0.1111111111111111
655072742,8,1,1.0,9,0.1111111111111111
655083279,4,16,4.0,20,0.2
655087839,23,1,1.0,24,0.041666666666666664
655100537,3,7,3.0,10,0.3
655104717,7,2,2.0,9,0.2222222222222222
655105399,1,8,1.0,9,0.1111111111111111
655107051,2,8,2.0,10,0.2
655118556,2,8,2.0,10,0.2
655133953,3,17,3.0,20,0.15
655182110,1,19,1.0,20,0.05
655189087,3,5,3.0,8,0.375
655202857,5,4,4.0,9,0.4444444444444444
655206852,2,7,2.0,9,0.2222222222222222
655212152,1,9,1.0,10,0.1
655219085,2,8,2.0,10,0.2
655251508,6,4,4.0,10,0.4
655251565,7,3,3.0,10,0.3
655265173,4,5,4.0,9,0.4444444444444444
655337896,1,9,1.0,10,0.1
655348649,1,9,1.0,10,0.1
655408509,11,17,11.0,28,0.39285714285714285
655409376,1,8,1.0,9,0.1111111111111111
655413017,3,7,3.0,10,0.3
655414133,5,5,5.0,10,0.5
655416581,5,5,5.0,10,0.5
655425034,3,7,3.0,10,0.3
655458424,1,9,1.0,10,0.1
655483206,3,7,3.0,10,0.3
655507383,1,7,1.0,8,0.125
655574988,4,5,4.0,9,0.4444444444444444
655604351,1,19,1.0,20,0.05
655659135,2,8,2.0,10,0.2
655691405,9,1,1.0,10,0.1
655692080,6,4,4.0,10,0.4
655692311,3,7,3.0,10,0.3
655692426,5,5,5.0,10,0.5
655699836,2,18,2.0,20,0.1
655705944,2,8,2.0,10,0.2
655708323,2,7,2.0,9,0.2222222222222222
655720854,1,27,1.0,28,0.03571428571428571
655729559,2,8,2.0,10,0.2
655729891,6,4,4.0,10,0.4
655731980,1,9,1.0,10,0.1
655738603,5,4,4.0,9,0.4444444444444444
655750781,2,8,2.0,10,0.2
655751300,1,8,1.0,9,0.1111111111111111
655753100,2,7,2.0,9,0.2222222222222222
655753410,1,9,1.0,10,0.1
655753941,1,8,1.0,9,0.1111111111111111
655756175,1,8,1.0,9,0.1111111111111111
655785550,6,4,4.0,10,0.4
655801051,1,8,1.0,9,0.1111111111111111
655816612,2,7,2.0,9,0.2222222222222222
655817706,3,6,3.0,9,0.3333333333333333
655817944,1,8,1.0,9,0.1111111111111111
655840092,8,2,2.0,10,0.2
655852191,1,8,1.0,9,0.1111111111111111
655874010,1,9,1.0,10,0.1
655879377,1,9,1.0,10,0.1
655882555,1,8,1.0,9,0.1111111111111111
655892703,1,9,1.0,10,0.1
655894927,2,8,2.0,10,0.2
655898750,8,1,1.0,9,0.1111111111111111
655899655,1,8,1.0,9,0.1111111111111111
655901932,3,7,3.0,10,0.3
655909540,1,9,1.0,10,0.1
655909854,1,8,1.0,9,0.1111111111111111
655927445,1,7,1.0,8,0.125
655952992,1,9,1.0,10,0.1
655954646,1,7,1.0,8,0.125
655955168,12,8,8.0,20,0.4
655955348,1,8,1.0,9,0.1111111111111111
655956230,1,9,1.0,10,0.1
655964358,6,12,6.0,18,0.3333333333333333
655965793,1,9,1.0,10,0.1
655965908,1,9,1.0,10,0.1
655968082,3,25,3.0,28,0.10714285714285714
655970455,1,9,1.0,10,0.1
655971240,1,8,1.0,9,0.1111111111111111
655972049,9,1,1.0,10,0.1
655972156,1,9,1.0,10,0.1
655973012,2,8,2.0,10,0.2
655974437,5,5,5.0,10,0.5
655981451,2,16,2.0,18,0.1111111111111111
656097801,1,9,1.0,10,0.1
656177790,2,7,2.0,9,0.2222222222222222
656193293,3,16,3.0,19,0.15789473684210525
656272229,3,7,3.0,10,0.3
656303766,1,8,1.0,9,0.1111111111111111
656303945,10,7,7.0,17,0.4117647058823529
656319465,1,9,1.0,10,0.1
656323530,2,7,2.0,9,0.2222222222222222
656323869,6,23,6.0,29,0.20689655172413793
656324783,2,7,2.0,9,0.2222222222222222
656325143,9,1,1.0,10,0.1
656325246,4,5,4.0,9,0.4444444444444444
656339741,18,10,10.0,28,0.35714285714285715
656342862,5,4,4.0,9,0.4444444444444444
656346430,1,9,1.0,10,0.1
656432975,2,8,2.0,10,0.2
656451225,1,8,1.0,9,0.1111111111111111
656461871,8,1,1.0,9,0.1111111111111111
656483212,6,13,6.0,19,0.3157894736842105
656491279,1,9,1.0,10,0.1
656509102,2,8,2.0,10,0.2
656524715,2,8,2.0,10,0.2
656583384,5,5,5.0,10,0.5
656602264,3,7,3.0,10,0.3
656617249,1,8,1.0,9,0.1111111111111111
656618239,1,9,1.0,10,0.1
656621794,1,9,1.0,10,0.1
656636376,1,9,1.0,10,0.1
656691867,1,8,1.0,9,0.1111111111111111
656701978,2,7,2.0,9,0.2222222222222222
656702946,2,7,2.0,9,0.2222222222222222
656710585,6,4,4.0,10,0.4
656747523,5,5,5.0,10,0.5
656766319,7,2,2.0,9,0.2222222222222222
656768185,6,3,3.0,9,0.3333333333333333
656789592,3,7,3.0,10,0.3
656803136,6,10,6.0,16,0.375
656808637,1,8,1.0,9,0.1111111111111111
656809047,1,8,1.0,9,0.1111111111111111
656862492,2,8,2.0,10,0.2
656894142,1,9,1.0,10,0.1
656894524,1,9,1.0,10,0.1
656895449,2,8,2.0,10,0.2
656896669,1,9,1.0,10,0.1
656896941,7,3,3.0,10,0.3
656957489,9,1,1.0,10,0.1
656957954,4,6,4.0,10,0.4
656969294,1,8,1.0,9,0.1111111111111111
657035248,1,9,1.0,10,0.1
657107663,1,7,1.0,8,0.125
657118342,6,4,4.0,10,0.4
657123879,8,2,2.0,10,0.2
657128330,6,23,6.0,29,0.20689655172413793
657159078,1,7,1.0,8,0.125
657194647,1,8,1.0,9,0.1111111111111111
657228463,4,4,4.0,8,0.5
657236475,6,21,6.0,27,0.2222222222222222
657238224,1,9,1.0,10,0.1
657241507,1,8,1.0,9,0.1111111111111111
657272999,2,16,2.0,18,0.1111111111111111
657333099,1,9,1.0,10,0.1
657333289,1,9,1.0,10,0.1
657424820,4,25,4.0,29,0.13793103448275862
657425101,4,5,4.0,9,0.4444444444444444
657425591,2,8,2.0,10,0.2
657435814,1,17,1.0,18,0.05555555555555555
657589116,3,7,3.0,10,0.3
657597860,4,6,4.0,10,0.4
657611335,3,5,3.0,8,0.375
657652486,1,18,1.0,19,0.05263157894736842
657769370,8,2,2.0,10,0.2
657794308,1,9,1.0,10,0.1
657800484,3,15,3.0,18,0.16666666666666666
657805711,1,9,1.0,10,0.1
658071178,1,9,1.0,10,0.1
658080094,1,9,1.0,10,0.1
658080441,1,9,1.0,10,0.1
658138726,1,9,1.0,10,0.1
658494545,1,9,1.0,10,0.1
658511221,5,4,4.0,9,0.4444444444444444
658516467,1,9,1.0,10,0.1
658518710,4,6,4.0,10,0.4
658633922,1,17,1.0,18,0.05555555555555555
658669914,3,16,3.0,19,0.15789473684210525
658794203,1,8,1.0,9,0.1111111111111111
658810736,3,6,3.0,9,0.3333333333333333
658810824,2,8,2.0,10,0.2
658816798,5,5,5.0,10,0.5
658817634,3,7,3.0,10,0.3
658834448,1,9,1.0,10,0.1
658849731,2,17,2.0,19,0.10526315789473684
658919280,1,9,1.0,10,0.1
658920603,3,15,3.0,18,0.16666666666666666
658954316,1,8,1.0,9,0.1111111111111111
658955329,4,6,4.0,10,0.4
658956744,4,6,4.0,10,0.4
658957188,6,4,4.0,10,0.4
659028876,1,9,1.0,10,0.1
659032090,1,9,1.0,10,0.1
659039826,1,8,1.0,9,0.1111111111111111
659040701,6,13,6.0,19,0.3157894736842105
659049043,1,8,1.0,9,0.1111111111111111
659068664,1,9,1.0,10,0.1
659120949,1,9,1.0,10,0.1
659162077,1,9,1.0,10,0.1
659164080,3,7,3.0,10,0.3
659165105,3,7,3.0,10,0.3
659172422,2,8,2.0,10,0.2
659181263,6,22,6.0,28,0.21428571428571427
659211340,9,1,1.0,10,0.1
659225683,1,9,1.0,10,0.1
659227756,1,9,1.0,10,0.1
659292252,3,7,3.0,10,0.3
659303172,8,2,2.0,10,0.2
659304884,6,3,3.0,9,0.3333333333333333
659307869,1,9,1.0,10,0.1
659331165,2,26,2.0,28,0.07142857142857142
659335484,2,17,2.0,19,0.10526315789473684
659346303,9,1,1.0,10,0.1
659346929,7,1,1.0,8,0.125
659357733,1,7,1.0,8,0.125
659358172,1,9,1.0,10,0.1
659374759,3,7,3.0,10,0.3
659376925,1,9,1.0,10,0.1
659385970,8,2,2.0,10,0.2
659508624,2,7,2.0,9,0.2222222222222222
659516499,1,9,1.0,10,0.1
659520208,15,13,13.0,28,0.4642857142857143
659539328,1,9,1.0,10,0.1
659555028,4,16,4.0,20,0.2
659572146,1,19,1.0,20,0.05
659578232,2,8,2.0,10,0.2
659584802,1,9,1.0,10,0.1
659586550,2,8,2.0,10,0.2
659589902,6,4,4.0,10,0.4
659609911,2,7,2.0,9,0.2222222222222222
659614838,2,7,2.0,9,0.2222222222222222
659616066,3,6,3.0,9,0.3333333333333333
659653303,1,9,1.0,10,0.1
659657941,1,9,1.0,10,0.1
659683626,9,1,1.0,10,0.1
659684880,6,2,2.0,8,0.25
659708751,1,18,1.0,19,0.05263157894736842
659725307,6,22,6.0,28,0.21428571428571427
659731987,3,7,3.0,10,0.3
659732173,3,7,3.0,10,0.3
659732433,1,9,1.0,10,0.1
659733231,6,4,4.0,10,0.4
659734943,5,24,5.0,29,0.1724137931034483
659735364,2,8,2.0,10,0.2
659737196,2,6,2.0,8,0.25
659737936,2,7,2.0,9,0.2222222222222222
659753196,4,6,4.0,10,0.4
659853260,2,8,2.0,10,0.2
659864555,2,18,2.0,20,0.1
659905466,2,6,2.0,8,0.25
659906189,4,6,4.0,10,0.4
659906507,9,1,1.0,10,0.1
659938770,2,6,2.0,8,0.25
659940661,7,2,2.0,9,0.2222222222222222
659941317,4,6,4.0,10,0.4
659942002,4,4,4.0,8,0.5
659942945,6,4,4.0,10,0.4
659944095,2,8,2.0,10,0.2
659944248,7,3,3.0,10,0.3
659946219,2,7,2.0,9,0.2222222222222222
659946891,11,15,11.0,26,0.4230769230769231
659948957,10,19,10.0,29,0.3448275862068966
659950145,1,8,1.0,9,0.1111111111111111
659988945,6,14,6.0,20,0.3
659989227,1,8,1.0,9,0.1111111111111111
660039662,1,9,1.0,10,0.1
660068898,2,8,2.0,10,0.2
660072148,1,18,1.0,19,0.05263157894736842
660095164,1,19,1.0,20,0.05
660137987,8,2,2.0,10,0.2
660138164,5,5,5.0,10,0.5
660138384,8,1,1.0,9,0.1111111111111111
660138788,8,2,2.0,10,0.2
660152097,1,8,1.0,9,0.1111111111111111
660240993,2,8,2.0,10,0.2
660241992,9,20,9.0,29,0.3103448275862069
660281767,1,9,1.0,10,0.1
660301830,1,9,1.0,10,0.1
660303436,2,7,2.0,9,0.2222222222222222
660334999,4,6,4.0,10,0.4
660370026,3,7,3.0,10,0.3
660383354,1,19,1.0,20,0.05
660388855,3,7,3.0,10,0.3
660494627,1,9,1.0,10,0.1
660502770,3,16,3.0,19,0.15789473684210525
660507232,1,17,1.0,18,0.05555555555555555
660548806,1,27,1.0,28,0.03571428571428571
660549158,1,9,1.0,10,0.1
660550262,1,7,1.0,8,0.125
660562262,1,8,1.0,9,0.1111111111111111
660565967,2,7,2.0,9,0.2222222222222222
660687062,3,6,3.0,9,0.3333333333333333
660710426,1,8,1.0,9,0.1111111111111111
660849177,1,9,1.0,10,0.1
660866822,8,12,8.0,20,0.4
660957981,1,8,1.0,9,0.1111111111111111
660985747,1,8,1.0,9,0.1111111111111111
660987031,9,1,1.0,10,0.1
661004694,4,6,4.0,10,0.4
661025185,7,3,3.0,10,0.3
661029373,7,1,1.0,8,0.125
661034522,6,4,4.0,10,0.4
661039696,1,8,1.0,9,0.1111111111111111
661048357,6,4,4.0,10,0.4
661057071,1,19,1.0,20,0.05
661073411,1,8,1.0,9,0.1111111111111111
661118601,1,18,1.0,19,0.05263157894736842
661122214,5,5,5.0,10,0.5
661140979,3,7,3.0,10,0.3
661154317,1,7,1.0,8,0.125
661158020,2,7,2.0,9,0.2222222222222222
661179900,3,7,3.0,10,0.3
661183195,3,7,3.0,10,0.3
661210119,1,8,1.0,9,0.1111111111111111
661230813,1,18,1.0,19,0.05263157894736842
661255554,1,9,1.0,10,0.1
661306411,1,8,1.0,9,0.1111111111111111
661308971,1,9,1.0,10,0.1
661326669,2,7,2.0,9,0.2222222222222222
661328258,6,3,3.0,9,0.3333333333333333
661370798,1,17,1.0,18,0.05555555555555555
661436062,2,7,2.0,9,0.2222222222222222
661436460,9,1,1.0,10,0.1
661445985,1,7,1.0,8,0.125
661448732,3,6,3.0,9,0.3333333333333333
661464823,1,9,1.0,10,0.1
661483689,2,7,2.0,9,0.2222222222222222
661484299,24,3,3.0,27,0.1111111111111111
661493203,3,6,3.0,9,0.3333333333333333
661524538,3,17,3.0,20,0.15
661527095,2,7,2.0,9,0.2222222222222222
661529704,2,7,2.0,9,0.2222222222222222
661562851,6,3,3.0,9,0.3333333333333333
661594949,3,5,3.0,8,0.375
661613140,4,6,4.0,10,0.4
661613227,2,8,2.0,10,0.2
661613405,1,9,1.0,10,0.1
661660979,4,22,4.0,26,0.15384615384615385
661672939,1,9,1.0,10,0.1
661681962,1,9,1.0,10,0.1
661688096,1,9,1.0,10,0.1
661689350,3,26,3.0,29,0.10344827586206896
661762410,2,7,2.0,9,0.2222222222222222
661793547,2,8,2.0,10,0.2
661830360,3,7,3.0,10,0.3
661851377,1,18,1.0,19,0.05263157894736842
661898530,1,9,1.0,10,0.1
661909505,5,5,5.0,10,0.5
661924476,2,7,2.0,9,0.2222222222222222
661941579,1,9,1.0,10,0.1
661950218,1,8,1.0,9,0.1111111111111111
662044012,2,8,2.0,10,0.2
662069114,7,1,1.0,8,0.125
662069648,9,1,1.0,10,0.1
662074223,1,8,1.0,9,0.1111111111111111
662074354,3,5,3.0,8,0.375
662076746,3,6,3.0,9,0.3333333333333333
662077158,3,26,3.0,29,0.10344827586206896
662097514,4,24,4.0,28,0.14285714285714285
662098805,2,7,2.0,9,0.2222222222222222
662099503,3,6,3.0,9,0.3333333333333333
662101245,2,7,2.0,9,0.2222222222222222
662115436,1,9,1.0,10,0.1
662125665,4,5,4.0,9,0.4444444444444444
662136526,7,3,3.0,10,0.3
662150658,9,1,1.0,10,0.1
662169836,3,7,3.0,10,0.3
662186863,6,3,3.0,9,0.3333333333333333
662191959,8,1,1.0,9,0.1111111111111111
662192405,7,3,3.0,10,0.3
662194716,1,9,1.0,10,0.1
662196434,1,7,1.0,8,0.125
662197635,5,5,5.0,10,0.5
662198500,3,17,3.0,20,0.15
662200797,8,2,2.0,10,0.2
662200889,5,4,4.0,9,0.4444444444444444
662201865,4,5,4.0,9,0.4444444444444444
662202309,2,7,2.0,9,0.2222222222222222
662204229,6,4,4.0,10,0.4
662204245,1,9,1.0,10,0.1
662220874,2,7,2.0,9,0.2222222222222222
662222518,3,7,3.0,10,0.3
662288213,2,8,2.0,10,0.2
662304986,2,8,2.0,10,0.2
662305465,1,8,1.0,9,0.1111111111111111
662321252,6,4,4.0,10,0.4
662342492,1,8,1.0,9,0.1111111111111111
662342674,2,8,2.0,10,0.2
662343936,1,9,1.0,10,0.1
662345583,1,9,1.0,10,0.1
662405010,1,17,1.0,18,0.05555555555555555
662424557,7,3,3.0,10,0.3
662447345,9,1,1.0,10,0.1
662466140,1,9,1.0,10,0.1
662480944,5,4,4.0,9,0.4444444444444444
662490058,1,9,1.0,10,0.1
662490376,1,9,1.0,10,0.1
662490550,4,22,4.0,26,0.15384615384615385
662491002,1,8,1.0,9,0.1111111111111111
662491208,1,8,1.0,9,0.1111111111111111
662543934,6,4,4.0,10,0.4
662544086,2,8,2.0,10,0.2
662556081,1,8,1.0,9,0.1111111111111111
662569310,5,4,4.0,9,0.4444444444444444
662581592,1,9,1.0,10,0.1
662587669,28,1,1.0,29,0.034482758620689655
662589183,9,1,1.0,10,0.1
662598552,7,3,3.0,10,0.3
662617455,5,5,5.0,10,0.5
662656441,7,21,7.0,28,0.25
662673106,3,6,3.0,9,0.3333333333333333
662675931,1,9,1.0,10,0.1
662676457,2,8,2.0,10,0.2
662676558,2,15,2.0,17,0.11764705882352941
662679402,1,27,1.0,28,0.03571428571428571
662702411,1,17,1.0,18,0.05555555555555555
662715817,4,6,4.0,10,0.4
662746231,8,1,1.0,9,0.1111111111111111
662761694,8,2,2.0,10,0.2
662763580,2,7,2.0,9,0.2222222222222222
662780847,2,7,2.0,9,0.2222222222222222
662789878,7,3,3.0,10,0.3
662790660,8,2,2.0,10,0.2
662794088,3,26,3.0,29,0.10344827586206896
662800995,9,1,1.0,10,0.1
662816100,1,8,1.0,9,0.1111111111111111
662854207,1,9,1.0,10,0.1
662882374,4,6,4.0,10,0.4
662882399,3,26,3.0,29,0.10344827586206896
662901941,1,9,1.0,10,0.1
662902327,1,27,1.0,28,0.03571428571428571
662912574,8,20,8.0,28,0.2857142857142857
662921845,1,7,1.0,8,0.125
662951254,3,7,3.0,10,0.3
662951391,2,8,2.0,10,0.2
662999540,9,1,1.0,10,0.1
663016153,4,6,4.0,10,0.4
663017182,4,5,4.0,9,0.4444444444444444
663026322,3,6,3.0,9,0.3333333333333333
663032952,1,9,1.0,10,0.1
663033026,1,9,1.0,10,0.1
663065862,1,9,1.0,10,0.1
663066919,1,9,1.0,10,0.1
663072567,3,7,3.0,10,0.3
663090874,5,4,4.0,9,0.4444444444444444
663099669,1,17,1.0,18,0.05555555555555555
663104541,3,6,3.0,9,0.3333333333333333
663105578,2,15,2.0,17,0.11764705882352941
663106038,3,7,3.0,10,0.3
663141557,4,6,4.0,10,0.4
663142339,7,3,3.0,10,0.3
663170554,3,24,3.0,27,0.1111111111111111
663171619,2,7,2.0,9,0.2222222222222222
663171899,1,9,1.0,10,0.1
663175206,3,7,3.0,10,0.3
663176242,8,2,2.0,10,0.2
663204684,2,8,2.0,10,0.2
663299010,2,7,2.0,9,0.2222222222222222
663329450,1,9,1.0,10,0.1
663365801,1,9,1.0,10,0.1
663419602,2,8,2.0,10,0.2
663422626,1,8,1.0,9,0.1111111111111111
663443151,2,6,2.0,8,0.25
663445361,2,6,2.0,8,0.25
663473473,4,16,4.0,20,0.2
663507278,9,1,1.0,10,0.1
663527558,1,9,1.0,10,0.1
663552726,2,17,2.0,19,0.10526315789473684
663569674,1,18,1.0,19,0.05263157894736842
663575242,1,8,1.0,9,0.1111111111111111
663727402,2,8,2.0,10,0.2
663733501,1,9,1.0,10,0.1
663769142,2,8,2.0,10,0.2
663782954,2,8,2.0,10,0.2
663817722,3,7,3.0,10,0.3
663831800,9,1,1.0,10,0.1
663852872,2,18,2.0,20,0.1
663911205,5,5,5.0,10,0.5
663913602,5,4,4.0,9,0.4444444444444444
663929859,6,3,3.0,9,0.3333333333333333
663956062,6,4,4.0,10,0.4
663956111,3,7,3.0,10,0.3
663956395,2,8,2.0,10,0.2
663956553,2,7,2.0,9,0.2222222222222222
663984009,5,4,4.0,9,0.4444444444444444
663990858,1,9,1.0,10,0.1
663991888,1,9,1.0,10,0.1
663992527,1,9,1.0,10,0.1
664015428,6,4,4.0,10,0.4
664015777,3,5,3.0,8,0.375
664025458,1,9,1.0,10,0.1
664025649,1,8,1.0,9,0.1111111111111111
664026472,1,9,1.0,10,0.1
664083602,1,18,1.0,19,0.05263157894736842
664105433,7,1,1.0,8,0.125
664105460,6,3,3.0,9,0.3333333333333333
664142429,1,9,1.0,10,0.1
664144293,4,4,4.0,8,0.5
664145061,2,8,2.0,10,0.2
664146783,2,6,2.0,8,0.25
664147746,2,8,2.0,10,0.2
664182537,1,9,1.0,10,0.1
664188061,8,2,2.0,10,0.2
664206251,1,9,1.0,10,0.1
664206892,1,9,1.0,10,0.1
664222353,1,18,1.0,19,0.05263157894736842
664256482,1,8,1.0,9,0.1111111111111111
664269057,8,1,1.0,9,0.1111111111111111
664307608,5,4,4.0,9,0.4444444444444444
664307988,1,9,1.0,10,0.1
664308455,1,9,1.0,10,0.1
664309453,5,4,4.0,9,0.4444444444444444
664340428,1,9,1.0,10,0.1
664349091,1,18,1.0,19,0.05263157894736842
664357317,10,10,10.0,20,0.5
664360304,1,8,1.0,9,0.1111111111111111
664364033,1,9,1.0,10,0.1
664384503,3,7,3.0,10,0.3
664386649,1,9,1.0,10,0.1
664405008,2,7,2.0,9,0.2222222222222222
664418857,3,26,3.0,29,0.10344827586206896
664431911,1,9,1.0,10,0.1
664438975,1,9,1.0,10,0.1
664440848,1,7,1.0,8,0.125
664482784,1,18,1.0,19,0.05263157894736842
664497416,2,16,2.0,18,0.1111111111111111
664525074,1,9,1.0,10,0.1
664525469,3,6,3.0,9,0.3333333333333333
664526507,1,9,1.0,10,0.1
664531105,5,5,5.0,10,0.5
664554847,4,4,4.0,8,0.5
664554974,6,3,3.0,9,0.3333333333333333
664555073,2,7,2.0,9,0.2222222222222222
664555230,7,2,2.0,9,0.2222222222222222
664556013,9,1,1.0,10,0.1
664574740,1,9,1.0,10,0.1
664574921,2,8,2.0,10,0.2
664596876,1,7,1.0,8,0.125
664599556,1,17,1.0,18,0.05555555555555555
664608772,5,5,5.0,10,0.5
664614871,3,5,3.0,8,0.375
664630227,3,7,3.0,10,0.3
664678200,6,3,3.0,9,0.3333333333333333
664680036,2,16,2.0,18,0.1111111111111111
664685252,2,8,2.0,10,0.2
664697770,1,9,1.0,10,0.1
664714309,1,8,1.0,9,0.1111111111111111
664714994,2,8,2.0,10,0.2
664716859,3,7,3.0,10,0.3
664723589,1,9,1.0,10,0.1
664771673,9,1,1.0,10,0.1
664772277,7,3,3.0,10,0.3
664772331,8,2,2.0,10,0.2
664773252,9,1,1.0,10,0.1
664774495,24,4,4.0,28,0.14285714285714285
664774944,7,1,1.0,8,0.125
664775296,5,5,5.0,10,0.5
664775327,1,9,1.0,10,0.1
664775516,4,24,4.0,28,0.14285714285714285
664776686,5,4,4.0,9,0.4444444444444444
664776823,4,5,4.0,9,0.4444444444444444
664777993,2,8,2.0,10,0.2
664778564,1,9,1.0,10,0.1
664786686,3,5,3.0,8,0.375
664793509,4,5,4.0,9,0.4444444444444444
664793860,2,8,2.0,10,0.2
664794367,1,9,1.0,10,0.1
664849800,2,28,2.0,30,0.06666666666666667
664862148,3,7,3.0,10,0.3
664878254,2,7,2.0,9,0.2222222222222222
665023322,7,2,2.0,9,0.2222222222222222
665067467,2,8,2.0,10,0.2
665077373,2,8,2.0,10,0.2
665081833,2,6,2.0,8,0.25
665090313,5,3,3.0,8,0.375
665135792,7,1,1.0,8,0.125
665174242,1,9,1.0,10,0.1
665177922,7,12,7.0,19,0.3684210526315789
665212388,8,1,1.0,9,0.1111111111111111
665255806,1,8,1.0,9,0.1111111111111111
665260914,1,9,1.0,10,0.1
665264806,2,8,2.0,10,0.2
665329959,2,7,2.0,9,0.2222222222222222
665331129,1,18,1.0,19,0.05263157894736842
665333126,3,6,3.0,9,0.3333333333333333
665336519,28,1,1.0,29,0.034482758620689655
665393330,1,9,1.0,10,0.1
665399634,1,9,1.0,10,0.1
665425130,1,18,1.0,19,0.05263157894736842
665446682,5,5,5.0,10,0.5
665446929,3,7,3.0,10,0.3
665447241,1,19,1.0,20,0.05
665450775,4,16,4.0,20,0.2
665487874,4,6,4.0,10,0.4
665527510,8,2,2.0,10,0.2
665547778,18,12,12.0,30,0.4
665563020,2,8,2.0,10,0.2
665587118,3,7,3.0,10,0.3
665610030,2,7,2.0,9,0.2222222222222222
665621878,8,2,2.0,10,0.2
665622753,6,4,4.0,10,0.4
665625373,6,4,4.0,10,0.4
665628344,2,6,2.0,8,0.25
665637557,9,1,1.0,10,0.1
665676851,4,6,4.0,10,0.4
665678350,2,8,2.0,10,0.2
665680181,2,6,2.0,8,0.25
665726229,9,1,1.0,10,0.1
665739358,5,5,5.0,10,0.5
665739619,1,9,1.0,10,0.1
665764675,2,8,2.0,10,0.2
665764911,1,9,1.0,10,0.1
665765307,8,1,1.0,9,0.1111111111111111
665766563,17,2,2.0,19,0.10526315789473684
665769185,1,8,1.0,9,0.1111111111111111
665780219,2,18,2.0,20,0.1
665790068,1,8,1.0,9,0.1111111111111111
665791415,2,8,2.0,10,0.2
665811045,1,8,1.0,9,0.1111111111111111
665812830,1,9,1.0,10,0.1
665840358,1,8,1.0,9,0.1111111111111111
665842452,6,3,3.0,9,0.3333333333333333
665843750,10,18,10.0,28,0.35714285714285715
665858421,9,1,1.0,10,0.1
665893456,4,6,4.0,10,0.4
665901645,2,7,2.0,9,0.2222222222222222
665915103,2,7,2.0,9,0.2222222222222222
665915508,22,3,3.0,25,0.12
665916465,1,7,1.0,8,0.125
665927637,3,7,3.0,10,0.3
665939709,9,1,1.0,10,0.1
665941958,1,26,1.0,27,0.037037037037037035
665958906,9,1,1.0,10,0.1
665974033,1,8,1.0,9,0.1111111111111111
666008892,9,1,1.0,10,0.1
666008921,2,8,2.0,10,0.2
666008959,1,8,1.0,9,0.1111111111111111
666009062,7,3,3.0,10,0.3
666009284,3,7,3.0,10,0.3
666017484,2,7,2.0,9,0.2222222222222222
666022585,3,6,3.0,9,0.3333333333333333
666028406,1,9,1.0,10,0.1
666037768,8,8,8.0,16,0.5
666067391,2,8,2.0,10,0.2
666077567,9,1,1.0,10,0.1
666078932,5,5,5.0,10,0.5
666086541,1,9,1.0,10,0.1
666103979,1,9,1.0,10,0.1
666149683,1,18,1.0,19,0.05263157894736842
666160082,4,6,4.0,10,0.4
666171396,1,9,1.0,10,0.1
666187075,3,16,3.0,19,0.15789473684210525
666209526,1,9,1.0,10,0.1
666257998,4,5,4.0,9,0.4444444444444444
666259701,1,8,1.0,9,0.1111111111111111
666287600,1,9,1.0,10,0.1
666292412,8,1,1.0,9,0.1111111111111111
666292767,4,5,4.0,9,0.4444444444444444
666302443,8,1,1.0,9,0.1111111111111111
666302972,9,1,1.0,10,0.1
666318956,8,2,2.0,10,0.2
666329056,9,1,1.0,10,0.1
666329145,2,8,2.0,10,0.2
666330007,9,1,1.0,10,0.1
666341793,1,9,1.0,10,0.1
666350938,1,8,1.0,9,0.1111111111111111
666376314,6,23,6.0,29,0.20689655172413793
666427274,3,7,3.0,10,0.3
666454415,3,7,3.0,10,0.3
666477831,6,4,4.0,10,0.4
666487189,20,8,8.0,28,0.2857142857142857
666487427,1,9,1.0,10,0.1
666488078,3,6,3.0,9,0.3333333333333333
666489154,2,25,2.0,27,0.07407407407407407
666490221,1,9,1.0,10,0.1
666490359,2,7,2.0,9,0.2222222222222222
666498663,1,9,1.0,10,0.1
666504025,1,8,1.0,9,0.1111111111111111
666504380,1,8,1.0,9,0.1111111111111111
666527755,1,9,1.0,10,0.1
666543494,4,6,4.0,10,0.4
666551408,1,19,1.0,20,0.05
666556029,1,7,1.0,8,0.125
666560081,2,8,2.0,10,0.2
666606322,1,9,1.0,10,0.1
666628785,1,17,1.0,18,0.05555555555555555
666643426,5,5,5.0,10,0.5
666644213,9,1,1.0,10,0.1
666644575,9,18,9.0,27,0.3333333333333333
666656248,9,1,1.0,10,0.1
666659772,7,3,3.0,10,0.3
666669757,1,9,1.0,10,0.1
666671071,1,9,1.0,10,0.1
666674330,3,7,3.0,10,0.3
666674821,11,9,9.0,20,0.45
666675763,3,7,3.0,10,0.3
666676032,5,5,5.0,10,0.5
666676854,1,9,1.0,10,0.1
666702348,6,4,4.0,10,0.4
666710411,6,4,4.0,10,0.4
666738649,1,8,1.0,9,0.1111111111111111
666757846,5,24,5.0,29,0.1724137931034483
666762623,2,18,2.0,20,0.1
666764052,2,18,2.0,20,0.1
666767332,1,9,1.0,10,0.1
666768426,5,5,5.0,10,0.5
666770283,1,8,1.0,9,0.1111111111111111
666773675,1,8,1.0,9,0.1111111111111111
666779831,1,8,1.0,9,0.1111111111111111
666780815,1,9,1.0,10,0.1
666829244,1,18,1.0,19,0.05263157894736842
666835742,9,1,1.0,10,0.1
666838563,2,8,2.0,10,0.2
666840065,2,8,2.0,10,0.2
666843073,1,9,1.0,10,0.1
666854381,1,25,1.0,26,0.038461538461538464
666863588,1,8,1.0,9,0.1111111111111111
666871940,1,9,1.0,10,0.1
666871996,2,8,2.0,10,0.2
666877101,3,6,3.0,9,0.3333333333333333
666878742,2,8,2.0,10,0.2
666881224,2,8,2.0,10,0.2
666890334,10,18,10.0,28,0.35714285714285715
666891827,2,8,2.0,10,0.2
666899103,1,9,1.0,10,0.1
666911531,7,1,1.0,8,0.125
666930127,3,6,3.0,9,0.3333333333333333
667008315,1,19,1.0,20,0.05
667016965,4,6,4.0,10,0.4
667024614,1,9,1.0,10,0.1
667057349,4,6,4.0,10,0.4
667070472,1,8,1.0,9,0.1111111111111111
667103431,2,8,2.0,10,0.2
667166906,2,7,2.0,9,0.2222222222222222
667171556,8,2,2.0,10,0.2
667175059,2,17,2.0,19,0.10526315789473684
667182874,1,9,1.0,10,0.1
667201079,1,9,1.0,10,0.1
667201816,2,7,2.0,9,0.2222222222222222
667202032,3,27,3.0,30,0.1
667204200,4,6,4.0,10,0.4
667212861,2,8,2.0,10,0.2
667220296,2,8,2.0,10,0.2
667235736,1,7,1.0,8,0.125
667241718,2,8,2.0,10,0.2
667316292,1,18,1.0,19,0.05263157894736842
667330725,3,6,3.0,9,0.3333333333333333
667366843,3,6,3.0,9,0.3333333333333333
667378896,3,15,3.0,18,0.16666666666666666
667416072,1,9,1.0,10,0.1
667447719,3,17,3.0,20,0.15
667451327,7,2,2.0,9,0.2222222222222222
667537346,1,8,1.0,9,0.1111111111111111
667538494,1,7,1.0,8,0.125
667539452,6,3,3.0,9,0.3333333333333333
667562443,2,8,2.0,10,0.2
667590844,3,6,3.0,9,0.3333333333333333
667636368,1,9,1.0,10,0.1
667687562,4,5,4.0,9,0.4444444444444444
667697657,1,8,1.0,9,0.1111111111111111
667748639,1,9,1.0,10,0.1
667788765,2,7,2.0,9,0.2222222222222222
667789019,2,7,2.0,9,0.2222222222222222
667871062,1,7,1.0,8,0.125
667918150,15,12,12.0,27,0.4444444444444444
667920613,1,8,1.0,9,0.1111111111111111
667934874,1,9,1.0,10,0.1
667940170,7,2,2.0,9,0.2222222222222222
667940454,7,3,3.0,10,0.3
667971551,8,2,2.0,10,0.2
667971922,8,2,2.0,10,0.2
667987007,1,9,1.0,10,0.1
668011966,1,9,1.0,10,0.1
668032164,1,9,1.0,10,0.1
668033826,1,17,1.0,18,0.05555555555555555
668048847,2,17,2.0,19,0.10526315789473684
668128053,9,1,1.0,10,0.1
668154182,1,9,1.0,10,0.1
668188462,2,8,2.0,10,0.2
668208719,4,6,4.0,10,0.4
668211580,5,4,4.0,9,0.4444444444444444
668212099,2,16,2.0,18,0.1111111111111111
668228159,8,2,2.0,10,0.2
668228349,1,9,1.0,10,0.1
668232151,1,17,1.0,18,0.05555555555555555
668237818,6,4,4.0,10,0.4
668250882,1,8,1.0,9,0.1111111111111111
668256945,3,6,3.0,9,0.3333333333333333
668288702,4,4,4.0,8,0.5
668315336,5,4,4.0,9,0.4444444444444444
668322899,2,8,2.0,10,0.2
668414883,1,8,1.0,9,0.1111111111111111
668424900,2,8,2.0,10,0.2
668426544,3,7,3.0,10,0.3
668428174,4,5,4.0,9,0.4444444444444444
668434740,1,28,1.0,29,0.034482758620689655
668435006,1,9,1.0,10,0.1
668435048,2,6,2.0,8,0.25
668435895,3,7,3.0,10,0.3
668440744,1,8,1.0,9,0.1111111111111111
668443551,1,9,1.0,10,0.1
668443661,3,7,3.0,10,0.3
668473566,7,3,3.0,10,0.3
668473735,2,8,2.0,10,0.2
668487791,2,7,2.0,9,0.2222222222222222
668492143,3,27,3.0,30,0.1
668502763,3,6,3.0,9,0.3333333333333333
668506400,1,7,1.0,8,0.125
668526366,1,7,1.0,8,0.125
668526986,7,3,3.0,10,0.3
668542158,1,9,1.0,10,0.1
668561939,2,8,2.0,10,0.2
668574727,9,1,1.0,10,0.1
668574986,1,7,1.0,8,0.125
668624431,2,8,2.0,10,0.2
668637943,2,8,2.0,10,0.2
668641388,1,9,1.0,10,0.1
668653194,3,7,3.0,10,0.3
668653833,21,8,8.0,29,0.27586206896551724
668689322,2,27,2.0,29,0.06896551724137931
668698275,1,8,1.0,9,0.1111111111111111
668702944,3,7,3.0,10,0.3
668715637,1,9,1.0,10,0.1
668725254,4,6,4.0,10,0.4
668729301,5,4,4.0,9,0.4444444444444444
668762425,1,9,1.0,10,0.1
668778766,1,9,1.0,10,0.1
668830449,1,8,1.0,9,0.1111111111111111
668830994,3,6,3.0,9,0.3333333333333333
668849601,5,5,5.0,10,0.5
668853127,2,8,2.0,10,0.2
668854286,1,9,1.0,10,0.1
668854926,2,8,2.0,10,0.2
668907982,2,7,2.0,9,0.2222222222222222
668919165,3,7,3.0,10,0.3
668951159,5,4,4.0,9,0.4444444444444444
668951831,6,3,3.0,9,0.3333333333333333
668951921,3,7,3.0,10,0.3
668962635,1,17,1.0,18,0.05555555555555555
668981015,7,3,3.0,10,0.3
668998960,5,4,4.0,9,0.4444444444444444
669016959,5,5,5.0,10,0.5
669042516,4,6,4.0,10,0.4
669048576,1,9,1.0,10,0.1
669049562,7,3,3.0,10,0.3
669051099,2,7,2.0,9,0.2222222222222222
669051344,2,7,2.0,9,0.2222222222222222
669051980,2,8,2.0,10,0.2
669071068,1,9,1.0,10,0.1
669072303,8,1,1.0,9,0.1111111111111111
669072479,5,5,5.0,10,0.5
669072698,7,3,3.0,10,0.3
669072887,5,3,3.0,8,0.375
669073309,9,1,1.0,10,0.1
669103383,1,19,1.0,20,0.05
669135456,2,28,2.0,30,0.06666666666666667
669141326,2,7,2.0,9,0.2222222222222222
669161086,2,8,2.0,10,0.2
669161241,3,7,3.0,10,0.3
669163919,3,7,3.0,10,0.3
669167227,7,3,3.0,10,0.3
669181030,5,5,5.0,10,0.5
669181324,5,5,5.0,10,0.5
669181669,2,7,2.0,9,0.2222222222222222
669201905,2,6,2.0,8,0.25
669259626,3,7,3.0,10,0.3
669259755,8,2,2.0,10,0.2
669303137,3,7,3.0,10,0.3
669320703,1,18,1.0,19,0.05263157894736842
669363123,7,2,2.0,9,0.2222222222222222
669381466,1,9,1.0,10,0.1
669388446,1,9,1.0,10,0.1
669389505,1,9,1.0,10,0.1
669405595,2,7,2.0,9,0.2222222222222222
669447422,3,6,3.0,9,0.3333333333333333
669463927,1,9,1.0,10,0.1
669506403,11,15,11.0,26,0.4230769230769231
669528896,2,18,2.0,20,0.1
669557153,7,2,2.0,9,0.2222222222222222
669557246,3,7,3.0,10,0.3
669572753,4,6,4.0,10,0.4
669619322,14,10,10.0,24,0.4166666666666667
669655317,9,1,1.0,10,0.1
669656041,4,6,4.0,10,0.4
669656543,4,6,4.0,10,0.4
669663827,1,9,1.0,10,0.1
669664524,4,6,4.0,10,0.4
669666702,3,23,3.0,26,0.11538461538461539
669728479,1,9,1.0,10,0.1
669730320,2,8,2.0,10,0.2
669732238,6,4,4.0,10,0.4
669732961,1,9,1.0,10,0.1
669755549,2,8,2.0,10,0.2
669775939,1,19,1.0,20,0.05
669781594,1,9,1.0,10,0.1
669783447,1,9,1.0,10,0.1
669783486,5,23,5.0,28,0.17857142857142858
669800650,21,8,8.0,29,0.27586206896551724
669827645,2,18,2.0,20,0.1
669836028,7,3,3.0,10,0.3
669836691,8,1,1.0,9,0.1111111111111111
669837230,6,4,4.0,10,0.4
669893586,2,6,2.0,8,0.25
669899340,1,9,1.0,10,0.1
669902232,3,5,3.0,8,0.375
669903190,21,7,7.0,28,0.25
669905979,1,19,1.0,20,0.05
669958734,3,7,3.0,10,0.3
670008423,2,18,2.0,20,0.1
670045618,3,25,3.0,28,0.10714285714285714
670051082,1,8,1.0,9,0.1111111111111111
670051360,4,6,4.0,10,0.4
670058995,9,1,1.0,10,0.1
670060906,1,9,1.0,10,0.1
670074847,1,9,1.0,10,0.1
670092755,2,7,2.0,9,0.2222222222222222
670224315,4,6,4.0,10,0.4
670248730,2,8,2.0,10,0.2
670280646,8,1,1.0,9,0.1111111111111111
670280993,6,4,4.0,10,0.4
670308969,2,8,2.0,10,0.2
670313268,1,8,1.0,9,0.1111111111111111
670330940,1,9,1.0,10,0.1
670333339,2,16,2.0,18,0.1111111111111111
670396445,4,4,4.0,8,0.5
670402953,1,8,1.0,9,0.1111111111111111
670475908,4,6,4.0,10,0.4
670482622,6,4,4.0,10,0.4
670557426,22,5,5.0,27,0.18518518518518517
670563673,1,9,1.0,10,0.1
670634465,1,8,1.0,9,0.1111111111111111
670641362,6,21,6.0,27,0.2222222222222222
670641518,2,18,2.0,20,0.1
670676644,4,6,4.0,10,0.4
670730602,2,17,2.0,19,0.10526315789473684
670786946,1,9,1.0,10,0.1
670817943,3,7,3.0,10,0.3
670937320,2,7,2.0,9,0.2222222222222222
670958025,3,7,3.0,10,0.3
670972076,1,9,1.0,10,0.1
670982301,6,4,4.0,10,0.4
670982415,2,8,2.0,10,0.2
670984241,3,7,3.0,10,0.3
670984372,2,8,2.0,10,0.2
670986684,6,4,4.0,10,0.4
670987413,1,7,1.0,8,0.125
671029559,2,8,2.0,10,0.2
671032815,2,8,2.0,10,0.2
671045981,3,7,3.0,10,0.3
671058247,1,8,1.0,9,0.1111111111111111
671092848,3,16,3.0,19,0.15789473684210525
671099574,6,4,4.0,10,0.4
671122464,3,6,3.0,9,0.3333333333333333
671174515,1,9,1.0,10,0.1
671195239,1,18,1.0,19,0.05263157894736842
671224799,3,7,3.0,10,0.3
671252745,1,9,1.0,10,0.1
671272736,1,9,1.0,10,0.1
671301353,1,9,1.0,10,0.1
671317199,2,8,2.0,10,0.2
671319125,6,4,4.0,10,0.4
671329613,1,9,1.0,10,0.1
671344376,3,7,3.0,10,0.3
671347116,2,8,2.0,10,0.2
671388761,8,2,2.0,10,0.2
671389263,9,1,1.0,10,0.1
671389748,9,1,1.0,10,0.1
671394639,25,2,2.0,27,0.07407407407407407
671400410,1,19,1.0,20,0.05
671403035,1,9,1.0,10,0.1
671453084,1,19,1.0,20,0.05
671459052,1,9,1.0,10,0.1
671508623,1,9,1.0,10,0.1
671534116,6,4,4.0,10,0.4
671542443,6,4,4.0,10,0.4
671611113,1,8,1.0,9,0.1111111111111111
671772927,1,18,1.0,19,0.05263157894736842
671788468,8,2,2.0,10,0.2
671804001,3,7,3.0,10,0.3
671804265,1,7,1.0,8,0.125
671804447,2,8,2.0,10,0.2
671821952,6,4,4.0,10,0.4
671822363,5,24,5.0,29,0.1724137931034483
671823686,2,17,2.0,19,0.10526315789473684
671824058,7,2,2.0,9,0.2222222222222222
671828821,1,9,1.0,10,0.1
671833693,3,7,3.0,10,0.3
671834516,9,1,1.0,10,0.1
671836642,1,8,1.0,9,0.1111111111111111
671856448,2,7,2.0,9,0.2222222222222222
671944836,8,2,2.0,10,0.2
671988016,9,1,1.0,10,0.1
672099195,2,8,2.0,10,0.2
672108603,2,8,2.0,10,0.2
672110450,4,5,4.0,9,0.4444444444444444
672112081,3,14,3.0,17,0.17647058823529413
672148089,1,9,1.0,10,0.1
672161916,2,8,2.0,10,0.2
672181596,1,9,1.0,10,0.1
672181696,1,9,1.0,10,0.1
672183783,7,3,3.0,10,0.3
672183962,8,1,1.0,9,0.1111111111111111
672184301,5,4,4.0,9,0.4444444444444444
672184404,7,22,7.0,29,0.2413793103448276
672186801,5,5,5.0,10,0.5
672187318,1,9,1.0,10,0.1
672188819,4,6,4.0,10,0.4
672259079,1,9,1.0,10,0.1
672273190,1,9,1.0,10,0.1
672274477,1,18,1.0,19,0.05263157894736842
672281214,3,6,3.0,9,0.3333333333333333
672282547,9,11,9.0,20,0.45
672308949,1,9,1.0,10,0.1
672309144,1,9,1.0,10,0.1
672324510,1,19,1.0,20,0.05
672331309,4,5,4.0,9,0.4444444444444444
672336302,7,13,7.0,20,0.35
672340372,6,4,4.0,10,0.4
672361027,1,9,1.0,10,0.1
672395902,1,17,1.0,18,0.05555555555555555
672397123,1,9,1.0,10,0.1
672412134,1,17,1.0,18,0.05555555555555555
672418942,6,4,4.0,10,0.4
672479506,22,4,4.0,26,0.15384615384615385
672479567,5,4,4.0,9,0.4444444444444444
672479733,6,4,4.0,10,0.4
672480140,7,2,2.0,9,0.2222222222222222
672492922,1,9,1.0,10,0.1
672536841,2,7,2.0,9,0.2222222222222222
672543764,1,9,1.0,10,0.1
672597873,1,27,1.0,28,0.03571428571428571
672642547,9,1,1.0,10,0.1
672646632,1,9,1.0,10,0.1
672660835,1,8,1.0,9,0.1111111111111111
672661742,2,7,2.0,9,0.2222222222222222
672673032,1,9,1.0,10,0.1
672680660,1,9,1.0,10,0.1
672693374,1,17,1.0,18,0.05555555555555555
672715353,14,15,14.0,29,0.4827586206896552
672737448,2,7,2.0,9,0.2222222222222222
672746503,1,9,1.0,10,0.1
672847522,1,8,1.0,9,0.1111111111111111
672853377,6,4,4.0,10,0.4
672854642,4,26,4.0,30,0.13333333333333333
672862223,1,9,1.0,10,0.1
672863484,7,3,3.0,10,0.3
672889162,2,7,2.0,9,0.2222222222222222
672890870,5,5,5.0,10,0.5
672893701,4,5,4.0,9,0.4444444444444444
672895290,2,8,2.0,10,0.2
672895461,3,7,3.0,10,0.3
672896175,2,6,2.0,8,0.25
672897110,3,7,3.0,10,0.3
672900791,2,8,2.0,10,0.2
672904416,4,4,4.0,8,0.5
672912661,1,18,1.0,19,0.05263157894736842
672913582,12,16,12.0,28,0.42857142857142855
672930365,7,3,3.0,10,0.3
672951928,1,16,1.0,17,0.058823529411764705
672965770,1,9,1.0,10,0.1
672998329,1,9,1.0,10,0.1
673025072,1,9,1.0,10,0.1
673028698,1,9,1.0,10,0.1
673084318,7,23,7.0,30,0.23333333333333334
673150620,1,8,1.0,9,0.1111111111111111
673155558,1,17,1.0,18,0.05555555555555555
673159895,6,4,4.0,10,0.4
673179037,1,9,1.0,10,0.1
673213936,1,9,1.0,10,0.1
673214699,2,8,2.0,10,0.2
673215128,1,9,1.0,10,0.1
673246617,2,8,2.0,10,0.2
673246952,3,7,3.0,10,0.3
673248003,4,15,4.0,19,0.21052631578947367
673279149,4,6,4.0,10,0.4
673291957,5,4,4.0,9,0.4444444444444444
673292141,3,16,3.0,19,0.15789473684210525
673361689,3,7,3.0,10,0.3
673472504,3,7,3.0,10,0.3
673510178,1,18,1.0,19,0.05263157894736842
673539375,4,6,4.0,10,0.4
673547355,1,8,1.0,9,0.1111111111111111
673553482,9,1,1.0,10,0.1
673554264,5,25,5.0,30,0.16666666666666666
673559222,1,9,1.0,10,0.1
673586921,1,9,1.0,10,0.1
673587051,5,22,5.0,27,0.18518518518518517
673630794,1,9,1.0,10,0.1
673649729,2,7,2.0,9,0.2222222222222222
673653031,3,5,3.0,8,0.375
673698645,15,12,12.0,27,0.4444444444444444
673699163,2,7,2.0,9,0.2222222222222222
673699686,4,6,4.0,10,0.4
673740932,7,3,3.0,10,0.3
673769503,1,9,1.0,10,0.1
673779490,1,9,1.0,10,0.1
673796768,1,9,1.0,10,0.1
673797307,2,18,2.0,20,0.1
673823097,1,9,1.0,10,0.1
673830844,9,1,1.0,10,0.1
673891995,2,8,2.0,10,0.2
673926664,3,6,3.0,9,0.3333333333333333
673926936,2,8,2.0,10,0.2
673930475,8,1,1.0,9,0.1111111111111111
673932763,9,1,1.0,10,0.1
673962304,7,3,3.0,10,0.3
674033940,1,7,1.0,8,0.125
674053616,1,8,1.0,9,0.1111111111111111
674055900,5,5,5.0,10,0.5
674056134,1,9,1.0,10,0.1
674056534,5,4,4.0,9,0.4444444444444444
674071055,3,7,3.0,10,0.3
674083641,8,2,2.0,10,0.2
674084476,1,9,1.0,10,0.1
674085508,3,6,3.0,9,0.3333333333333333
674085771,8,1,1.0,9,0.1111111111111111
674087066,4,5,4.0,9,0.4444444444444444
674095020,1,18,1.0,19,0.05263157894736842
674168736,2,8,2.0,10,0.2
674169038,1,8,1.0,9,0.1111111111111111
674250930,1,9,1.0,10,0.1
674297794,1,19,1.0,20,0.05
674310051,2,8,2.0,10,0.2
674317077,1,9,1.0,10,0.1
674323988,2,8,2.0,10,0.2
674324980,5,3,3.0,8,0.375
674360757,1,8,1.0,9,0.1111111111111111
674361352,5,5,5.0,10,0.5
674368391,17,12,12.0,29,0.41379310344827586
674391973,5,5,5.0,10,0.5
674416442,1,9,1.0,10,0.1
674416746,7,2,2.0,9,0.2222222222222222
674417411,2,8,2.0,10,0.2
674424676,3,7,3.0,10,0.3
674494374,1,9,1.0,10,0.1
674501194,5,20,5.0,25,0.2
674501943,1,8,1.0,9,0.1111111111111111
674520259,2,16,2.0,18,0.1111111111111111
674552915,1,8,1.0,9,0.1111111111111111
674553275,3,25,3.0,28,0.10714285714285714
674574634,6,21,6.0,27,0.2222222222222222
674599876,2,7,2.0,9,0.2222222222222222
674629196,1,9,1.0,10,0.1
674638019,1,19,1.0,20,0.05
674680850,9,1,1.0,10,0.1
674681276,5,5,5.0,10,0.5
674681620,8,2,2.0,10,0.2
674723166,8,2,2.0,10,0.2
674738461,8,2,2.0,10,0.2
674739032,4,6,4.0,10,0.4
674774742,1,8,1.0,9,0.1111111111111111
674785409,4,6,4.0,10,0.4
674842146,2,8,2.0,10,0.2
674844796,1,9,1.0,10,0.1
674844991,1,9,1.0,10,0.1
674846033,2,7,2.0,9,0.2222222222222222
674846527,9,18,9.0,27,0.3333333333333333
674846805,7,3,3.0,10,0.3
674858333,2,8,2.0,10,0.2
674899301,1,9,1.0,10,0.1
674900244,2,8,2.0,10,0.2
674900680,5,4,4.0,9,0.4444444444444444
674901632,7,3,3.0,10,0.3
674907819,2,7,2.0,9,0.2222222222222222
674925844,8,1,1.0,9,0.1111111111111111
674931895,7,3,3.0,10,0.3
674932251,5,4,4.0,9,0.4444444444444444
674932808,1,9,1.0,10,0.1
675008758,2,8,2.0,10,0.2
675037760,9,18,9.0,27,0.3333333333333333
675043184,3,7,3.0,10,0.3
675052206,8,2,2.0,10,0.2
675057344,2,7,2.0,9,0.2222222222222222
675059984,2,18,2.0,20,0.1
675061585,2,7,2.0,9,0.2222222222222222
675064483,5,4,4.0,9,0.4444444444444444
675087081,2,8,2.0,10,0.2
675115700,1,18,1.0,19,0.05263157894736842
675122897,4,5,4.0,9,0.4444444444444444
675141304,1,9,1.0,10,0.1
675178915,1,7,1.0,8,0.125
675221432,1,9,1.0,10,0.1
675234678,8,2,2.0,10,0.2
675257111,1,9,1.0,10,0.1
675258506,3,7,3.0,10,0.3
675272388,1,9,1.0,10,0.1
675278501,1,9,1.0,10,0.1
675279935,1,9,1.0,10,0.1
675302705,2,17,2.0,19,0.10526315789473684
675339951,7,3,3.0,10,0.3
675365635,7,3,3.0,10,0.3
675393793,3,6,3.0,9,0.3333333333333333
675452400,3,7,3.0,10,0.3
675453688,2,8,2.0,10,0.2
675454894,5,5,5.0,10,0.5
675463365,1,9,1.0,10,0.1
675470426,1,9,1.0,10,0.1
675471172,1,8,1.0,9,0.1111111111111111
675474958,6,3,3.0,9,0.3333333333333333
675479447,1,7,1.0,8,0.125
675532924,1,8,1.0,9,0.1111111111111111
675538075,4,5,4.0,9,0.4444444444444444
675546695,1,18,1.0,19,0.05263157894736842
675548144,1,9,1.0,10,0.1
675593417,1,7,1.0,8,0.125
675607500,2,7,2.0,9,0.2222222222222222
675646075,1,9,1.0,10,0.1
675692863,1,19,1.0,20,0.05
675757268,2,7,2.0,9,0.2222222222222222
675808934,2,6,2.0,8,0.25
675816323,1,9,1.0,10,0.1
675830936,2,8,2.0,10,0.2
675838531,3,6,3.0,9,0.3333333333333333
675889221,2,8,2.0,10,0.2
675904170,1,9,1.0,10,0.1
675907130,2,18,2.0,20,0.1
675922688,5,24,5.0,29,0.1724137931034483
675923004,1,9,1.0,10,0.1
675926864,2,8,2.0,10,0.2
675935945,9,1,1.0,10,0.1
675943052,1,19,1.0,20,0.05
675962528,2,8,2.0,10,0.2
675968394,4,4,4.0,8,0.5
675970249,4,6,4.0,10,0.4
675970651,2,8,2.0,10,0.2
675971111,1,7,1.0,8,0.125
675972196,1,9,1.0,10,0.1
675981655,4,5,4.0,9,0.4444444444444444
676036810,1,8,1.0,9,0.1111111111111111
676070963,1,18,1.0,19,0.05263157894736842
676119171,1,8,1.0,9,0.1111111111111111
676127423,3,7,3.0,10,0.3
676156576,14,13,13.0,27,0.48148148148148145
676158424,1,8,1.0,9,0.1111111111111111
676158897,4,6,4.0,10,0.4
676159094,1,26,1.0,27,0.037037037037037035
676164694,1,19,1.0,20,0.05
676171199,5,4,4.0,9,0.4444444444444444
676171533,6,4,4.0,10,0.4
676220197,1,9,1.0,10,0.1
676295822,1,9,1.0,10,0.1
676299618,1,19,1.0,20,0.05
676308972,1,8,1.0,9,0.1111111111111111
676311003,1,8,1.0,9,0.1111111111111111
676334436,6,3,3.0,9,0.3333333333333333
676406387,1,8,1.0,9,0.1111111111111111
676460415,2,8,2.0,10,0.2
676538198,4,6,4.0,10,0.4
676575771,3,7,3.0,10,0.3
676580113,8,2,2.0,10,0.2
676580288,9,1,1.0,10,0.1
676600665,3,14,3.0,17,0.17647058823529413
676605877,4,6,4.0,10,0.4
676607056,7,3,3.0,10,0.3
676608042,7,2,2.0,9,0.2222222222222222
676615938,1,8,1.0,9,0.1111111111111111
676624566,1,9,1.0,10,0.1
676624840,5,5,5.0,10,0.5
676624925,9,1,1.0,10,0.1
676625320,7,3,3.0,10,0.3
676679394,3,6,3.0,9,0.3333333333333333
676731842,1,9,1.0,10,0.1
676752122,8,22,8.0,30,0.26666666666666666
676763338,1,9,1.0,10,0.1
676771118,1,8,1.0,9,0.1111111111111111
676773189,2,8,2.0,10,0.2
676784279,1,9,1.0,10,0.1
676785353,2,7,2.0,9,0.2222222222222222
676785434,1,9,1.0,10,0.1
676788037,5,5,5.0,10,0.5
676791554,4,16,4.0,20,0.2
676942205,3,7,3.0,10,0.3
676947299,8,1,1.0,9,0.1111111111111111
676948180,5,5,5.0,10,0.5
676957231,9,1,1.0,10,0.1
676957561,3,6,3.0,9,0.3333333333333333
676957616,9,1,1.0,10,0.1
677039001,3,7,3.0,10,0.3
677063905,1,7,1.0,8,0.125
677075768,1,8,1.0,9,0.1111111111111111
677077272,1,9,1.0,10,0.1
677117584,4,6,4.0,10,0.4
677117685,3,7,3.0,10,0.3
677158082,1,8,1.0,9,0.1111111111111111
677166635,4,15,4.0,19,0.21052631578947367
677196178,3,7,3.0,10,0.3
677201962,2,8,2.0,10,0.2
677216156,1,18,1.0,19,0.05263157894736842
677222159,1,9,1.0,10,0.1
677223421,1,9,1.0,10,0.1
677264412,7,2,2.0,9,0.2222222222222222
677269954,3,6,3.0,9,0.3333333333333333
677270057,2,7,2.0,9,0.2222222222222222
677271060,1,9,1.0,10,0.1
677410865,8,2,2.0,10,0.2
677412223,18,11,11.0,29,0.3793103448275862
677412321,2,8,2.0,10,0.2
677413448,7,2,2.0,9,0.2222222222222222
677413554,8,2,2.0,10,0.2
677426813,1,9,1.0,10,0.1
677490695,2,8,2.0,10,0.2
677528324,1,8,1.0,9,0.1111111111111111
677586656,8,2,2.0,10,0.2
677601543,1,8,1.0,9,0.1111111111111111
677605369,8,2,2.0,10,0.2
677669168,5,4,4.0,9,0.4444444444444444
677688739,1,9,1.0,10,0.1
677689796,2,8,2.0,10,0.2
677711644,3,6,3.0,9,0.3333333333333333
677719574,5,5,5.0,10,0.5
677719663,5,4,4.0,9,0.4444444444444444
677743015,2,17,2.0,19,0.10526315789473684
677759334,1,8,1.0,9,0.1111111111111111
677760053,1,8,1.0,9,0.1111111111111111
677760650,1,18,1.0,19,0.05263157894736842
677800841,3,7,3.0,10,0.3
677801132,1,8,1.0,9,0.1111111111111111
677812952,1,18,1.0,19,0.05263157894736842
677827525,1,8,1.0,9,0.1111111111111111
677844710,3,7,3.0,10,0.3
677871903,25,5,5.0,30,0.16666666666666666
677872267,4,5,4.0,9,0.4444444444444444
677873292,7,3,3.0,10,0.3
677881956,3,7,3.0,10,0.3
677889583,1,9,1.0,10,0.1
677902671,8,1,1.0,9,0.1111111111111111
677903865,1,17,1.0,18,0.05555555555555555
677956868,3,6,3.0,9,0.3333333333333333
677974143,1,18,1.0,19,0.05263157894736842
678014882,3,5,3.0,8,0.375
678062337,4,4,4.0,8,0.5
678066428,1,8,1.0,9,0.1111111111111111
678078042,1,19,1.0,20,0.05
678100059,1,9,1.0,10,0.1
678111720,1,19,1.0,20,0.05
678126867,1,27,1.0,28,0.03571428571428571
678158508,1,8,1.0,9,0.1111111111111111
678158629,1,18,1.0,19,0.05263157894736842
678175368,9,1,1.0,10,0.1
678176055,8,2,2.0,10,0.2
678178144,9,1,1.0,10,0.1
678211199,1,17,1.0,18,0.05555555555555555
678235384,1,8,1.0,9,0.1111111111111111
678266101,1,9,1.0,10,0.1
678310925,1,9,1.0,10,0.1
678311370,2,7,2.0,9,0.2222222222222222
678317146,2,26,2.0,28,0.07142857142857142
678322613,2,8,2.0,10,0.2
678341757,2,6,2.0,8,0.25
678343711,2,8,2.0,10,0.2
678367404,2,8,2.0,10,0.2
678372890,3,14,3.0,17,0.17647058823529413
678376923,1,8,1.0,9,0.1111111111111111
678384161,5,5,5.0,10,0.5
678399428,4,6,4.0,10,0.4
678424294,8,1,1.0,9,0.1111111111111111
678448805,9,1,1.0,10,0.1
678458429,2,7,2.0,9,0.2222222222222222
678493823,8,2,2.0,10,0.2
678507406,1,8,1.0,9,0.1111111111111111
678510367,24,5,5.0,29,0.1724137931034483
678512153,7,3,3.0,10,0.3
678512647,2,8,2.0,10,0.2
678520991,7,20,7.0,27,0.25925925925925924
678521194,1,9,1.0,10,0.1
678522103,1,9,1.0,10,0.1
678579400,5,4,4.0,9,0.4444444444444444
678614135,3,7,3.0,10,0.3
678634714,1,9,1.0,10,0.1
678641656,1,18,1.0,19,0.05263157894736842
678646444,3,6,3.0,9,0.3333333333333333
678652861,1,9,1.0,10,0.1
678678876,2,24,2.0,26,0.07692307692307693
678693121,1,8,1.0,9,0.1111111111111111
678771145,8,1,1.0,9,0.1111111111111111
678777245,1,9,1.0,10,0.1
678778401,1,9,1.0,10,0.1
678790678,1,9,1.0,10,0.1
678790927,4,16,4.0,20,0.2
678810590,25,4,4.0,29,0.13793103448275862
678815747,3,6,3.0,9,0.3333333333333333
678861064,1,9,1.0,10,0.1
678864355,5,5,5.0,10,0.5
678867596,2,7,2.0,9,0.2222222222222222
678876836,1,9,1.0,10,0.1
678889997,9,1,1.0,10,0.1
678927932,1,17,1.0,18,0.05555555555555555
678958159,2,8,2.0,10,0.2
678959469,3,17,3.0,20,0.15
678968968,1,8,1.0,9,0.1111111111111111
678982448,2,26,2.0,28,0.07142857142857142
679020242,2,16,2.0,18,0.1111111111111111
679024391,1,8,1.0,9,0.1111111111111111
679026388,2,8,2.0,10,0.2
679027019,16,3,3.0,19,0.15789473684210525
679029403,1,18,1.0,19,0.05263157894736842
679170447,5,5,5.0,10,0.5
679170594,26,2,2.0,28,0.07142857142857142
679207498,2,8,2.0,10,0.2
679223140,4,16,4.0,20,0.2
679264420,7,11,7.0,18,0.3888888888888889
679305581,2,8,2.0,10,0.2
679306761,1,9,1.0,10,0.1
679318896,2,18,2.0,20,0.1
679324253,5,14,5.0,19,0.2631578947368421
679329006,1,8,1.0,9,0.1111111111111111
679360183,3,6,3.0,9,0.3333333333333333
679409669,3,17,3.0,20,0.15
679468680,1,9,1.0,10,0.1
679474510,2,8,2.0,10,0.2
679493013,1,8,1.0,9,0.1111111111111111
679513064,1,25,1.0,26,0.038461538461538464
679520905,1,8,1.0,9,0.1111111111111111
679558108,6,13,6.0,19,0.3157894736842105
679559451,3,7,3.0,10,0.3
679564654,3,6,3.0,9,0.3333333333333333
679567591,1,8,1.0,9,0.1111111111111111
679568203,7,3,3.0,10,0.3
679569494,1,9,1.0,10,0.1
679569984,1,9,1.0,10,0.1
679570333,1,9,1.0,10,0.1
679570514,1,9,1.0,10,0.1
679570939,1,9,1.0,10,0.1
679571263,2,7,2.0,9,0.2222222222222222
679572768,3,7,3.0,10,0.3
679573025,2,6,2.0,8,0.25
679573829,13,15,13.0,28,0.4642857142857143
679574407,2,8,2.0,10,0.2
679602012,2,7,2.0,9,0.2222222222222222
679645648,4,6,4.0,10,0.4
679674046,6,4,4.0,10,0.4
679704302,2,8,2.0,10,0.2
679716562,6,4,4.0,10,0.4
679719965,2,8,2.0,10,0.2
679721101,2,8,2.0,10,0.2
679721926,6,4,4.0,10,0.4
679729195,2,8,2.0,10,0.2
679739812,1,9,1.0,10,0.1
679762028,2,7,2.0,9,0.2222222222222222
679767400,4,6,4.0,10,0.4
679768168,5,24,5.0,29,0.1724137931034483
679772308,1,7,1.0,8,0.125
679773605,1,9,1.0,10,0.1
679778836,3,22,3.0,25,0.12
679790883,3,7,3.0,10,0.3
679831498,8,2,2.0,10,0.2
679832272,7,1,1.0,8,0.125
679848638,2,6,2.0,8,0.25
679852702,1,9,1.0,10,0.1
679950822,1,9,1.0,10,0.1
679992085,2,8,2.0,10,0.2
679993568,8,20,8.0,28,0.2857142857142857
679995443,1,22,1.0,23,0.043478260869565216
680117953,4,6,4.0,10,0.4
680119056,5,5,5.0,10,0.5
680160156,1,7,1.0,8,0.125
680174973,1,8,1.0,9,0.1111111111111111
680200419,1,8,1.0,9,0.1111111111111111
680209297,8,10,8.0,18,0.4444444444444444
680219228,9,1,1.0,10,0.1
680222474,1,9,1.0,10,0.1
680230005,2,8,2.0,10,0.2
680237092,3,7,3.0,10,0.3
680246662,1,9,1.0,10,0.1
680313771,2,17,2.0,19,0.10526315789473684
680351942,26,1,1.0,27,0.037037037037037035
680414211,1,19,1.0,20,0.05
680420425,2,17,2.0,19,0.10526315789473684
680436001,4,5,4.0,9,0.4444444444444444
680453221,3,6,3.0,9,0.3333333333333333
680482390,8,2,2.0,10,0.2
680553439,9,1,1.0,10,0.1
680571511,1,9,1.0,10,0.1
680609995,2,8,2.0,10,0.2
680628871,3,16,3.0,19,0.15789473684210525
680629110,1,19,1.0,20,0.05
680642427,5,5,5.0,10,0.5
680642851,1,8,1.0,9,0.1111111111111111
680644118,2,8,2.0,10,0.2
680650089,1,9,1.0,10,0.1
680688993,2,7,2.0,9,0.2222222222222222
680689198,1,18,1.0,19,0.05263157894736842
680696517,1,9,1.0,10,0.1
680749208,4,6,4.0,10,0.4
680749268,1,9,1.0,10,0.1
680749375,9,1,1.0,10,0.1
680749887,3,6,3.0,9,0.3333333333333333
680749933,1,9,1.0,10,0.1
680794190,2,8,2.0,10,0.2
680826500,8,2,2.0,10,0.2
680852556,4,5,4.0,9,0.4444444444444444
680895779,9,1,1.0,10,0.1
680896744,4,6,4.0,10,0.4
680898028,1,8,1.0,9,0.1111111111111111
680904729,1,17,1.0,18,0.05555555555555555
680920045,2,7,2.0,9,0.2222222222222222
680922853,1,9,1.0,10,0.1
680944166,8,2,2.0,10,0.2
681014542,4,5,4.0,9,0.4444444444444444
681050322,1,8,1.0,9,0.1111111111111111
681121661,8,2,2.0,10,0.2
681193710,2,7,2.0,9,0.2222222222222222
681307672,1,8,1.0,9,0.1111111111111111
681347025,12,16,12.0,28,0.42857142857142855
681349783,2,6,2.0,8,0.25
681350295,2,7,2.0,9,0.2222222222222222
681353926,1,9,1.0,10,0.1
681360989,1,8,1.0,9,0.1111111111111111
681361730,1,8,1.0,9,0.1111111111111111
681363359,1,9,1.0,10,0.1
681390669,1,9,1.0,10,0.1
681407761,1,8,1.0,9,0.1111111111111111
681461031,3,7,3.0,10,0.3
681486727,1,19,1.0,20,0.05
681496406,1,9,1.0,10,0.1
681512030,4,6,4.0,10,0.4
681513816,4,4,4.0,8,0.5
681530891,2,8,2.0,10,0.2
681537968,1,7,1.0,8,0.125
681598875,1,9,1.0,10,0.1
681613224,1,9,1.0,10,0.1
681617350,3,7,3.0,10,0.3
681618587,2,8,2.0,10,0.2
681629091,1,18,1.0,19,0.05263157894736842
681636765,3,7,3.0,10,0.3
681648555,3,6,3.0,9,0.3333333333333333
681672435,8,1,1.0,9,0.1111111111111111
681752903,1,18,1.0,19,0.05263157894736842
681780287,6,4,4.0,10,0.4
681781018,1,8,1.0,9,0.1111111111111111
681811437,3,7,3.0,10,0.3
681812491,11,16,11.0,27,0.4074074074074074
681835296,6,4,4.0,10,0.4
681835685,3,7,3.0,10,0.3
681850478,2,8,2.0,10,0.2
681878626,27,1,1.0,28,0.03571428571428571
681903027,4,6,4.0,10,0.4
681919238,1,9,1.0,10,0.1
681920954,1,8,1.0,9,0.1111111111111111
681944595,3,7,3.0,10,0.3
681945439,3,6,3.0,9,0.3333333333333333
681966818,1,9,1.0,10,0.1
681966901,1,9,1.0,10,0.1
681967292,1,9,1.0,10,0.1
681967528,1,27,1.0,28,0.03571428571428571
681993437,21,6,6.0,27,0.2222222222222222
682003046,1,9,1.0,10,0.1
682005008,1,19,1.0,20,0.05
682005450,1,9,1.0,10,0.1
682006081,2,7,2.0,9,0.2222222222222222
682011171,3,6,3.0,9,0.3333333333333333
682013512,5,5,5.0,10,0.5
682013750,1,8,1.0,9,0.1111111111111111
682014157,1,9,1.0,10,0.1
682014511,5,4,4.0,9,0.4444444444444444
682016698,3,7,3.0,10,0.3
682019257,4,16,4.0,20,0.2
682019680,2,8,2.0,10,0.2
682021637,3,7,3.0,10,0.3
682027877,6,3,3.0,9,0.3333333333333333
682033460,8,2,2.0,10,0.2
682037412,3,7,3.0,10,0.3
682050820,4,5,4.0,9,0.4444444444444444
682051239,1,9,1.0,10,0.1
682051504,3,7,3.0,10,0.3
682051726,1,9,1.0,10,0.1
682052005,19,11,11.0,30,0.36666666666666664
682052482,3,7,3.0,10,0.3
682052847,5,5,5.0,10,0.5
682052978,4,5,4.0,9,0.4444444444444444
682053898,12,8,8.0,20,0.4
682054324,8,12,8.0,20,0.4
682054944,1,8,1.0,9,0.1111111111111111
682054996,4,6,4.0,10,0.4
682056865,1,7,1.0,8,0.125
682137739,4,6,4.0,10,0.4
682167912,4,6,4.0,10,0.4
682168087,4,6,4.0,10,0.4
682168991,20,7,7.0,27,0.25925925925925924
682178824,8,2,2.0,10,0.2
682197594,1,9,1.0,10,0.1
682288627,18,9,9.0,27,0.3333333333333333
682303052,2,17,2.0,19,0.10526315789473684
682333665,1,9,1.0,10,0.1
682418539,3,7,3.0,10,0.3
682431277,9,1,1.0,10,0.1
682432002,1,9,1.0,10,0.1
682432413,2,8,2.0,10,0.2
682432657,2,8,2.0,10,0.2
682434625,1,9,1.0,10,0.1
682449615,4,5,4.0,9,0.4444444444444444
682543041,1,9,1.0,10,0.1
682620579,1,9,1.0,10,0.1
682645505,3,27,3.0,30,0.1
682666916,3,7,3.0,10,0.3
682728041,6,4,4.0,10,0.4
682728495,1,9,1.0,10,0.1
682770464,5,14,5.0,19,0.2631578947368421
682783725,1,9,1.0,10,0.1
682809090,4,26,4.0,30,0.13333333333333333
682821633,1,9,1.0,10,0.1
682855447,7,3,3.0,10,0.3
682934273,5,14,5.0,19,0.2631578947368421
683004397,1,8,1.0,9,0.1111111111111111
683051321,1,9,1.0,10,0.1
683095969,3,7,3.0,10,0.3
683128228,2,6,2.0,8,0.25
683142517,3,7,3.0,10,0.3
683146352,2,8,2.0,10,0.2
683256646,2,16,2.0,18,0.1111111111111111
683263001,1,19,1.0,20,0.05
683327300,2,7,2.0,9,0.2222222222222222
683327600,8,1,1.0,9,0.1111111111111111
683329234,8,2,2.0,10,0.2
683329313,1,19,1.0,20,0.05
683389104,1,9,1.0,10,0.1
683404106,1,9,1.0,10,0.1
683416233,1,9,1.0,10,0.1
683433035,9,1,1.0,10,0.1
683468671,6,4,4.0,10,0.4
683468973,1,18,1.0,19,0.05263157894736842
683488344,1,7,1.0,8,0.125
683608730,2,7,2.0,9,0.2222222222222222
683612655,1,9,1.0,10,0.1
683619449,2,7,2.0,9,0.2222222222222222
683667978,4,6,4.0,10,0.4
683669283,3,6,3.0,9,0.3333333333333333
683679961,1,7,1.0,8,0.125
683732636,1,8,1.0,9,0.1111111111111111
683777196,2,8,2.0,10,0.2
683777940,2,8,2.0,10,0.2
683778936,1,8,1.0,9,0.1111111111111111
683780324,3,6,3.0,9,0.3333333333333333
683786519,1,19,1.0,20,0.05
683797856,1,17,1.0,18,0.05555555555555555
683837829,7,2,2.0,9,0.2222222222222222
683843674,7,12,7.0,19,0.3684210526315789
683845325,3,6,3.0,9,0.3333333333333333
683845627,3,6,3.0,9,0.3333333333333333
683847155,16,10,10.0,26,0.38461538461538464
683851173,1,9,1.0,10,0.1
683851716,10,19,10.0,29,0.3448275862068966
683854598,3,7,3.0,10,0.3
683918218,1,8,1.0,9,0.1111111111111111
683929949,2,7,2.0,9,0.2222222222222222
683965519,1,9,1.0,10,0.1
683965546,3,6,3.0,9,0.3333333333333333
683965670,4,6,4.0,10,0.4
684009069,1,9,1.0,10,0.1
684029323,6,4,4.0,10,0.4
684058994,3,6,3.0,9,0.3333333333333333
684059054,3,6,3.0,9,0.3333333333333333
684095817,2,8,2.0,10,0.2
684149123,3,5,3.0,8,0.375
684176068,7,3,3.0,10,0.3
684258291,1,7,1.0,8,0.125
684312823,1,9,1.0,10,0.1
684342266,3,6,3.0,9,0.3333333333333333
684344544,2,8,2.0,10,0.2
684350795,1,7,1.0,8,0.125
684352754,1,8,1.0,9,0.1111111111111111
684355254,7,3,3.0,10,0.3
684446666,2,7,2.0,9,0.2222222222222222
684453451,7,3,3.0,10,0.3
684455204,5,5,5.0,10,0.5
684471246,2,8,2.0,10,0.2
684505490,1,9,1.0,10,0.1
684512850,1,8,1.0,9,0.1111111111111111
684516632,1,9,1.0,10,0.1
684558320,1,19,1.0,20,0.05
684607852,1,8,1.0,9,0.1111111111111111
684650483,1,18,1.0,19,0.05263157894736842
684696922,7,2,2.0,9,0.2222222222222222
684701100,1,9,1.0,10,0.1
684733016,1,9,1.0,10,0.1
684734151,1,9,1.0,10,0.1
684737154,7,20,7.0,27,0.25925925925925924
684746726,8,1,1.0,9,0.1111111111111111
684750883,3,16,3.0,19,0.15789473684210525
684755250,1,9,1.0,10,0.1
684784516,2,7,2.0,9,0.2222222222222222
684784732,3,7,3.0,10,0.3
684804528,3,7,3.0,10,0.3
684805359,2,6,2.0,8,0.25
684811302,1,9,1.0,10,0.1
684811527,6,4,4.0,10,0.4
684811590,16,11,11.0,27,0.4074074074074074
684812233,14,15,14.0,29,0.4827586206896552
684813089,5,4,4.0,9,0.4444444444444444
684813730,2,8,2.0,10,0.2
684813911,1,8,1.0,9,0.1111111111111111
684816096,8,2,2.0,10,0.2
684888872,2,18,2.0,20,0.1
684907670,4,5,4.0,9,0.4444444444444444
684933294,5,4,4.0,9,0.4444444444444444
684934801,2,7,2.0,9,0.2222222222222222
684938086,5,5,5.0,10,0.5
684941825,28,1,1.0,29,0.034482758620689655
684942684,8,1,1.0,9,0.1111111111111111
684950288,6,3,3.0,9,0.3333333333333333
684950809,3,6,3.0,9,0.3333333333333333
684951266,2,7,2.0,9,0.2222222222222222
684951554,9,21,9.0,30,0.3
684953216,8,2,2.0,10,0.2
684968038,3,6,3.0,9,0.3333333333333333
685018851,1,7,1.0,8,0.125
685049249,1,7,1.0,8,0.125
685093609,1,7,1.0,8,0.125
685127824,1,8,1.0,9,0.1111111111111111
685129690,1,9,1.0,10,0.1
685161054,2,8,2.0,10,0.2
685162901,2,8,2.0,10,0.2
685211782,1,8,1.0,9,0.1111111111111111
685228311,1,9,1.0,10,0.1
685262575,1,8,1.0,9,0.1111111111111111
685317821,3,7,3.0,10,0.3
685333214,1,7,1.0,8,0.125
685333432,10,19,10.0,29,0.3448275862068966
685333638,3,7,3.0,10,0.3
685333941,2,27,2.0,29,0.06896551724137931
685334391,5,5,5.0,10,0.5
685374843,1,17,1.0,18,0.05555555555555555
685400977,4,14,4.0,18,0.2222222222222222
685415485,1,9,1.0,10,0.1
685452840,7,3,3.0,10,0.3
685460566,5,25,5.0,30,0.16666666666666666
685461728,9,1,1.0,10,0.1
685488146,1,9,1.0,10,0.1
685543120,4,4,4.0,8,0.5
685546098,8,1,1.0,9,0.1111111111111111
685594923,1,9,1.0,10,0.1
685595563,2,6,2.0,8,0.25
685596509,9,1,1.0,10,0.1
685597042,2,8,2.0,10,0.2
685602058,3,6,3.0,9,0.3333333333333333
685604672,2,26,2.0,28,0.07142857142857142
685611640,3,6,3.0,9,0.3333333333333333
685615139,1,9,1.0,10,0.1
685617217,2,7,2.0,9,0.2222222222222222
685630853,2,17,2.0,19,0.10526315789473684
685635359,5,3,3.0,8,0.375
685677227,4,5,4.0,9,0.4444444444444444
685755354,1,9,1.0,10,0.1
685762173,3,7,3.0,10,0.3
685762664,2,8,2.0,10,0.2
685764044,1,8,1.0,9,0.1111111111111111
685780350,3,6,3.0,9,0.3333333333333333
685784186,2,8,2.0,10,0.2
685788428,3,5,3.0,8,0.375
685825255,2,8,2.0,10,0.2
685825819,1,9,1.0,10,0.1
685828707,1,8,1.0,9,0.1111111111111111
685837631,1,9,1.0,10,0.1
685841979,1,9,1.0,10,0.1
685847233,7,22,7.0,29,0.2413793103448276
685853392,17,13,13.0,30,0.43333333333333335
685889699,2,17,2.0,19,0.10526315789473684
685931964,1,9,1.0,10,0.1
685932316,2,24,2.0,26,0.07692307692307693
685932622,1,7,1.0,8,0.125
685935626,1,7,1.0,8,0.125
685976309,2,8,2.0,10,0.2
685982832,1,9,1.0,10,0.1
685999140,1,19,1.0,20,0.05
686034266,1,19,1.0,20,0.05
686082065,4,5,4.0,9,0.4444444444444444
686128866,1,9,1.0,10,0.1
686183497,1,18,1.0,19,0.05263157894736842
686184910,6,3,3.0,9,0.3333333333333333
686216164,1,9,1.0,10,0.1
686247987,21,6,6.0,27,0.2222222222222222
686335592,1,16,1.0,17,0.058823529411764705
686365028,1,9,1.0,10,0.1
686366548,2,8,2.0,10,0.2
686368827,1,9,1.0,10,0.1
686371672,1,9,1.0,10,0.1
686404909,2,7,2.0,9,0.2222222222222222
686481895,1,9,1.0,10,0.1
686502390,5,4,4.0,9,0.4444444444444444
686562431,1,9,1.0,10,0.1
686593219,1,9,1.0,10,0.1
686627065,4,6,4.0,10,0.4
686629195,2,7,2.0,9,0.2222222222222222
686664875,2,6,2.0,8,0.25
686682358,1,9,1.0,10,0.1
686683465,4,4,4.0,8,0.5
686779662,2,7,2.0,9,0.2222222222222222
686780219,3,7,3.0,10,0.3
686822312,1,9,1.0,10,0.1
686823199,1,9,1.0,10,0.1
686825285,6,2,2.0,8,0.25
686864856,2,8,2.0,10,0.2
686883653,2,8,2.0,10,0.2
686910243,4,15,4.0,19,0.21052631578947367
686920619,5,4,4.0,9,0.4444444444444444
686920763,4,5,4.0,9,0.4444444444444444
686922597,21,8,8.0,29,0.27586206896551724
686922784,1,8,1.0,9,0.1111111111111111
686953890,2,8,2.0,10,0.2
686981635,2,7,2.0,9,0.2222222222222222
686981980,7,2,2.0,9,0.2222222222222222
686982757,6,4,4.0,10,0.4
686996924,2,8,2.0,10,0.2
687054645,6,4,4.0,10,0.4
687058624,8,1,1.0,9,0.1111111111111111
687059010,1,8,1.0,9,0.1111111111111111
687066330,6,3,3.0,9,0.3333333333333333
687067033,2,8,2.0,10,0.2
687067691,1,8,1.0,9,0.1111111111111111
687135479,8,1,1.0,9,0.1111111111111111
687137064,1,9,1.0,10,0.1
687156175,1,9,1.0,10,0.1
687163251,1,8,1.0,9,0.1111111111111111
687182549,1,19,1.0,20,0.05
687224069,5,4,4.0,9,0.4444444444444444
687261377,3,6,3.0,9,0.3333333333333333
687293099,2,6,2.0,8,0.25
687335716,1,8,1.0,9,0.1111111111111111
687341383,8,2,2.0,10,0.2
687368840,7,3,3.0,10,0.3
687391887,3,6,3.0,9,0.3333333333333333
687416090,1,8,1.0,9,0.1111111111111111
687423324,7,2,2.0,9,0.2222222222222222
687424167,4,6,4.0,10,0.4
687424568,3,5,3.0,8,0.375
687428784,2,7,2.0,9,0.2222222222222222
687445886,9,9,9.0,18,0.5
687451611,5,5,5.0,10,0.5
687481619,1,8,1.0,9,0.1111111111111111
687593058,1,9,1.0,10,0.1
687606177,5,15,5.0,20,0.25
687634342,1,17,1.0,18,0.05555555555555555
687651960,1,8,1.0,9,0.1111111111111111
687652255,6,3,3.0,9,0.3333333333333333
687655401,8,2,2.0,10,0.2
687655865,1,8,1.0,9,0.1111111111111111
687657334,2,8,2.0,10,0.2
687661161,14,12,12.0,26,0.46153846153846156
687730031,1,7,1.0,8,0.125
687749567,1,8,1.0,9,0.1111111111111111
687757454,2,7,2.0,9,0.2222222222222222
687821737,3,7,3.0,10,0.3
687868787,5,5,5.0,10,0.5
687934057,1,9,1.0,10,0.1
687953780,19,9,9.0,28,0.32142857142857145
687955012,4,6,4.0,10,0.4
687956825,1,9,1.0,10,0.1
688064198,1,9,1.0,10,0.1
688088827,1,8,1.0,9,0.1111111111111111
688123217,1,18,1.0,19,0.05263157894736842
688123669,1,27,1.0,28,0.03571428571428571
688145134,22,8,8.0,30,0.26666666666666666
688145810,7,3,3.0,10,0.3
688148677,15,13,13.0,28,0.4642857142857143
688154880,2,7,2.0,9,0.2222222222222222
688161877,2,7,2.0,9,0.2222222222222222
688201550,1,9,1.0,10,0.1
688221118,1,9,1.0,10,0.1
688264126,1,9,1.0,10,0.1
688264468,4,6,4.0,10,0.4
688334694,2,8,2.0,10,0.2
688387170,6,4,4.0,10,0.4
688397275,1,9,1.0,10,0.1
688398606,2,7,2.0,9,0.2222222222222222
688398874,4,6,4.0,10,0.4
688438755,1,9,1.0,10,0.1
688460077,4,6,4.0,10,0.4
688460678,4,6,4.0,10,0.4
688519930,7,2,2.0,9,0.2222222222222222
688521864,9,1,1.0,10,0.1
688561332,1,19,1.0,20,0.05
688648112,4,6,4.0,10,0.4
688648295,1,19,1.0,20,0.05
688782745,3,17,3.0,20,0.15
688789715,1,8,1.0,9,0.1111111111111111
688801966,1,9,1.0,10,0.1
688809413,8,2,2.0,10,0.2
688809539,8,1,1.0,9,0.1111111111111111
688810068,8,2,2.0,10,0.2
688977036,5,3,3.0,8,0.375
689011364,1,9,1.0,10,0.1
689089911,3,7,3.0,10,0.3
689110787,2,17,2.0,19,0.10526315789473684
689135961,4,6,4.0,10,0.4
689308421,1,17,1.0,18,0.05555555555555555
689339518,2,8,2.0,10,0.2
689386825,7,2,2.0,9,0.2222222222222222
689391198,23,4,4.0,27,0.14814814814814814
689418446,2,8,2.0,10,0.2
689425384,5,5,5.0,10,0.5
689429449,4,6,4.0,10,0.4
689436574,3,6,3.0,9,0.3333333333333333
689441311,3,7,3.0,10,0.3
689489224,4,5,4.0,9,0.4444444444444444
689626733,2,8,2.0,10,0.2
689634198,1,9,1.0,10,0.1
689643126,1,19,1.0,20,0.05
689686113,2,8,2.0,10,0.2
689686444,1,9,1.0,10,0.1
689691935,2,7,2.0,9,0.2222222222222222
689709577,3,7,3.0,10,0.3
689711999,2,8,2.0,10,0.2
689713616,3,6,3.0,9,0.3333333333333333
689715908,5,21,5.0,26,0.19230769230769232
689726294,4,21,4.0,25,0.16
689800424,3,7,3.0,10,0.3
689804121,1,19,1.0,20,0.05
689805875,3,6,3.0,9,0.3333333333333333
689827505,4,6,4.0,10,0.4
689855377,2,6,2.0,8,0.25
689908580,3,7,3.0,10,0.3
689909966,5,14,5.0,19,0.2631578947368421
689941637,2,6,2.0,8,0.25
689944016,2,6,2.0,8,0.25
689999195,2,8,2.0,10,0.2
690073937,1,18,1.0,19,0.05263157894736842
690118148,1,9,1.0,10,0.1
690163449,1,8,1.0,9,0.1111111111111111
690164877,2,8,2.0,10,0.2
690176316,1,9,1.0,10,0.1
690195924,1,7,1.0,8,0.125
690199089,2,18,2.0,20,0.1
690230453,3,7,3.0,10,0.3
690248442,16,12,12.0,28,0.42857142857142855
690249127,1,8,1.0,9,0.1111111111111111
690253127,1,9,1.0,10,0.1
690343231,6,4,4.0,10,0.4
690431691,1,9,1.0,10,0.1
690441283,3,6,3.0,9,0.3333333333333333
690462479,2,8,2.0,10,0.2
690467070,1,9,1.0,10,0.1
690468427,1,8,1.0,9,0.1111111111111111
690472126,2,7,2.0,9,0.2222222222222222
690479426,2,16,2.0,18,0.1111111111111111
690525812,9,1,1.0,10,0.1
690671765,1,19,1.0,20,0.05
690676620,1,9,1.0,10,0.1
690713537,1,18,1.0,19,0.05263157894736842
690736974,1,8,1.0,9,0.1111111111111111
690770039,26,3,3.0,29,0.10344827586206896
690770729,7,1,1.0,8,0.125
690803222,2,8,2.0,10,0.2
690813893,2,8,2.0,10,0.2
690820429,4,6,4.0,10,0.4
690824273,5,5,5.0,10,0.5
690830123,4,6,4.0,10,0.4
690833174,1,7,1.0,8,0.125
690838892,8,2,2.0,10,0.2
690839424,1,9,1.0,10,0.1
690839631,9,1,1.0,10,0.1
690840524,7,3,3.0,10,0.3
690840934,1,8,1.0,9,0.1111111111111111
690841348,15,14,14.0,29,0.4827586206896552
690841576,4,16,4.0,20,0.2
690844946,8,1,1.0,9,0.1111111111111111
690845188,8,1,1.0,9,0.1111111111111111
690846533,1,8,1.0,9,0.1111111111111111
690856809,1,9,1.0,10,0.1
690859393,8,19,8.0,27,0.2962962962962963
690869647,5,4,4.0,9,0.4444444444444444
690871598,3,7,3.0,10,0.3
691028897,1,9,1.0,10,0.1
691041686,3,15,3.0,18,0.16666666666666666
691055401,3,7,3.0,10,0.3
691115712,1,9,1.0,10,0.1
691162781,1,9,1.0,10,0.1
691181829,2,8,2.0,10,0.2
691184370,2,8,2.0,10,0.2
691185017,1,9,1.0,10,0.1
691186534,3,6,3.0,9,0.3333333333333333
691187709,2,8,2.0,10,0.2
691187905,1,19,1.0,20,0.05
691200410,1,9,1.0,10,0.1
691202883,3,7,3.0,10,0.3
691210934,1,9,1.0,10,0.1
691229341,9,18,9.0,27,0.3333333333333333
691267209,23,7,7.0,30,0.23333333333333334
691269308,1,18,1.0,19,0.05263157894736842
691269981,1,9,1.0,10,0.1
691272316,2,6,2.0,8,0.25
691272320,2,8,2.0,10,0.2
691273245,1,8,1.0,9,0.1111111111111111
691274736,2,8,2.0,10,0.2
691282590,1,8,1.0,9,0.1111111111111111
691283830,1,9,1.0,10,0.1
691284662,1,9,1.0,10,0.1
691326150,5,3,3.0,8,0.375
691341556,1,19,1.0,20,0.05
691343556,1,19,1.0,20,0.05
691372439,18,12,12.0,30,0.4
691375805,1,9,1.0,10,0.1
691414782,1,8,1.0,9,0.1111111111111111
691419124,6,13,6.0,19,0.3157894736842105
691451451,2,8,2.0,10,0.2
691455018,2,15,2.0,17,0.11764705882352941
691520296,1,9,1.0,10,0.1
691521403,1,8,1.0,9,0.1111111111111111
691526320,4,6,4.0,10,0.4
691537069,1,8,1.0,9,0.1111111111111111
691549598,2,8,2.0,10,0.2
691550888,3,6,3.0,9,0.3333333333333333
691562363,1,27,1.0,28,0.03571428571428571
691573777,3,5,3.0,8,0.375
691573896,4,5,4.0,9,0.4444444444444444
691577932,1,9,1.0,10,0.1
691584550,1,8,1.0,9,0.1111111111111111
691595949,2,8,2.0,10,0.2
691627436,5,5,5.0,10,0.5
691634071,1,18,1.0,19,0.05263157894736842
691642222,3,6,3.0,9,0.3333333333333333
691689674,2,18,2.0,20,0.1
691709969,1,8,1.0,9,0.1111111111111111
691762364,1,8,1.0,9,0.1111111111111111
691776725,1,8,1.0,9,0.1111111111111111
691860772,3,7,3.0,10,0.3
691864497,1,8,1.0,9,0.1111111111111111
691950468,2,17,2.0,19,0.10526315789473684
692069576,2,7,2.0,9,0.2222222222222222
692074998,1,17,1.0,18,0.05555555555555555
692099614,10,10,10.0,20,0.5
692146247,1,18,1.0,19,0.05263157894736842
692147711,1,9,1.0,10,0.1
692151260,7,1,1.0,8,0.125
692187112,6,2,2.0,8,0.25
692283018,1,16,1.0,17,0.058823529411764705
692319471,2,7,2.0,9,0.2222222222222222
692336422,9,1,1.0,10,0.1
692377560,2,16,2.0,18,0.1111111111111111
692379449,4,5,4.0,9,0.4444444444444444
692381139,6,4,4.0,10,0.4
692381243,5,5,5.0,10,0.5
692390359,1,8,1.0,9,0.1111111111111111
692390533,1,7,1.0,8,0.125
692409776,6,4,4.0,10,0.4
692418508,2,8,2.0,10,0.2
692419917,2,8,2.0,10,0.2
692420180,2,8,2.0,10,0.2
692420745,1,8,1.0,9,0.1111111111111111
692425123,8,2,2.0,10,0.2
692438552,1,9,1.0,10,0.1
692440075,1,8,1.0,9,0.1111111111111111
692464018,1,27,1.0,28,0.03571428571428571
692468560,4,6,4.0,10,0.4
692481021,9,1,1.0,10,0.1
692500899,1,9,1.0,10,0.1
692509487,3,16,3.0,19,0.15789473684210525
692517229,1,9,1.0,10,0.1
692517446,2,8,2.0,10,0.2
692519890,7,3,3.0,10,0.3
692549675,1,18,1.0,19,0.05263157894736842
692553185,2,17,2.0,19,0.10526315789473684
692563022,1,8,1.0,9,0.1111111111111111
692573135,1,8,1.0,9,0.1111111111111111
692578142,1,18,1.0,19,0.05263157894736842
692604676,4,6,4.0,10,0.4
692661085,2,8,2.0,10,0.2
692697019,2,8,2.0,10,0.2
692697649,2,8,2.0,10,0.2
692716244,1,9,1.0,10,0.1
692716656,2,8,2.0,10,0.2
692717500,4,5,4.0,9,0.4444444444444444
692718901,3,6,3.0,9,0.3333333333333333
692724291,9,1,1.0,10,0.1
692756571,7,1,1.0,8,0.125
692825308,6,4,4.0,10,0.4
692825387,7,3,3.0,10,0.3
692825663,3,7,3.0,10,0.3
692832632,1,9,1.0,10,0.1
692848038,2,17,2.0,19,0.10526315789473684
692959910,3,7,3.0,10,0.3
692960189,10,20,10.0,30,0.3333333333333333
692960864,4,6,4.0,10,0.4
692963262,7,1,1.0,8,0.125
692964813,26,2,2.0,28,0.07142857142857142
692965204,8,2,2.0,10,0.2
692966114,7,3,3.0,10,0.3
692968100,7,3,3.0,10,0.3
692968309,9,1,1.0,10,0.1
692970628,9,1,1.0,10,0.1
692979993,2,6,2.0,8,0.25
692983755,6,4,4.0,10,0.4
692987396,2,16,2.0,18,0.1111111111111111
692988028,1,9,1.0,10,0.1
692990781,4,6,4.0,10,0.4
692993037,1,8,1.0,9,0.1111111111111111
693048409,1,8,1.0,9,0.1111111111111111
693072837,1,9,1.0,10,0.1
693072891,1,9,1.0,10,0.1
693075712,1,9,1.0,10,0.1
693091324,6,3,3.0,9,0.3333333333333333
693091697,8,2,2.0,10,0.2
693146154,2,16,2.0,18,0.1111111111111111
693182745,1,9,1.0,10,0.1
693236128,1,8,1.0,9,0.1111111111111111
693245998,2,7,2.0,9,0.2222222222222222
693274756,4,6,4.0,10,0.4
693275897,1,7,1.0,8,0.125
693276717,3,6,3.0,9,0.3333333333333333
693292084,1,8,1.0,9,0.1111111111111111
693465124,1,18,1.0,19,0.05263157894736842
693535906,1,19,1.0,20,0.05
693583727,1,8,1.0,9,0.1111111111111111
693626982,1,8,1.0,9,0.1111111111111111
693627373,3,6,3.0,9,0.3333333333333333
693638621,1,7,1.0,8,0.125
693657145,3,27,3.0,30,0.1
693714454,4,6,4.0,10,0.4
693720008,1,17,1.0,18,0.05555555555555555
693726050,1,9,1.0,10,0.1
693726313,2,7,2.0,9,0.2222222222222222
693727746,2,8,2.0,10,0.2
693728066,2,7,2.0,9,0.2222222222222222
693779026,1,16,1.0,17,0.058823529411764705
693809172,7,3,3.0,10,0.3
693810822,7,2,2.0,9,0.2222222222222222
693877917,1,9,1.0,10,0.1
693878273,1,9,1.0,10,0.1
693878885,2,8,2.0,10,0.2
693886168,5,14,5.0,19,0.2631578947368421
693886903,20,7,7.0,27,0.25925925925925924
693887008,22,7,7.0,29,0.2413793103448276
693887135,2,8,2.0,10,0.2
693887695,3,7,3.0,10,0.3
693888608,4,15,4.0,19,0.21052631578947367
693890664,1,8,1.0,9,0.1111111111111111
693890778,6,4,4.0,10,0.4
693892979,6,4,4.0,10,0.4
693920277,4,16,4.0,20,0.2
693921202,1,9,1.0,10,0.1
693921420,1,9,1.0,10,0.1
693921489,3,7,3.0,10,0.3
693926780,7,3,3.0,10,0.3
693952369,2,8,2.0,10,0.2
693952488,1,9,1.0,10,0.1
693953382,10,8,8.0,18,0.4444444444444444
693954220,1,9,1.0,10,0.1
693962949,5,5,5.0,10,0.5
693981670,1,8,1.0,9,0.1111111111111111
693989433,2,7,2.0,9,0.2222222222222222
694023363,4,6,4.0,10,0.4
694024085,1,7,1.0,8,0.125
694024325,4,4,4.0,8,0.5
694026254,1,9,1.0,10,0.1
694027711,4,5,4.0,9,0.4444444444444444
694043118,7,2,2.0,9,0.2222222222222222
694059203,3,7,3.0,10,0.3
694064820,6,4,4.0,10,0.4
694065670,5,5,5.0,10,0.5
694066606,4,5,4.0,9,0.4444444444444444
694067156,4,6,4.0,10,0.4
694068806,7,2,2.0,9,0.2222222222222222
694068959,5,5,5.0,10,0.5
694070070,1,7,1.0,8,0.125
694070866,1,8,1.0,9,0.1111111111111111
694071359,4,6,4.0,10,0.4
694071808,3,7,3.0,10,0.3
694082871,4,5,4.0,9,0.4444444444444444
694088207,3,6,3.0,9,0.3333333333333333
694091694,3,6,3.0,9,0.3333333333333333
694095112,3,6,3.0,9,0.3333333333333333
694096223,1,9,1.0,10,0.1
694097215,2,8,2.0,10,0.2
694098552,8,2,2.0,10,0.2
694098729,3,7,3.0,10,0.3
694102709,1,9,1.0,10,0.1
694107131,1,17,1.0,18,0.05555555555555555
694123279,6,3,3.0,9,0.3333333333333333
694167703,2,18,2.0,20,0.1
694184742,2,8,2.0,10,0.2
694184886,3,7,3.0,10,0.3
694185378,8,1,1.0,9,0.1111111111111111
694221457,2,18,2.0,20,0.1
694222698,1,9,1.0,10,0.1
694227824,1,9,1.0,10,0.1
694229378,1,15,1.0,16,0.0625
694241703,1,7,1.0,8,0.125
694261085,1,8,1.0,9,0.1111111111111111
694261376,5,5,5.0,10,0.5
694283901,1,7,1.0,8,0.125
694297209,2,7,2.0,9,0.2222222222222222
694299112,1,8,1.0,9,0.1111111111111111
694334477,1,8,1.0,9,0.1111111111111111
694362409,2,7,2.0,9,0.2222222222222222
694363419,9,1,1.0,10,0.1
694364961,4,6,4.0,10,0.4
694371957,7,2,2.0,9,0.2222222222222222
694372614,7,3,3.0,10,0.3
694377191,3,7,3.0,10,0.3
694394989,4,6,4.0,10,0.4
694418089,2,7,2.0,9,0.2222222222222222
694418412,6,4,4.0,10,0.4
694482273,1,18,1.0,19,0.05263157894736842
694511829,1,9,1.0,10,0.1
694565874,1,9,1.0,10,0.1
694598914,8,2,2.0,10,0.2
694611516,6,4,4.0,10,0.4
694638832,7,3,3.0,10,0.3
694650577,6,14,6.0,20,0.3
694651311,1,9,1.0,10,0.1
694663115,1,8,1.0,9,0.1111111111111111
694680873,1,9,1.0,10,0.1
694710435,4,6,4.0,10,0.4
694788193,3,5,3.0,8,0.375
694854352,2,7,2.0,9,0.2222222222222222
694886458,7,3,3.0,10,0.3
694910227,7,1,1.0,8,0.125
694912744,1,9,1.0,10,0.1
694912776,7,3,3.0,10,0.3
694913364,10,17,10.0,27,0.37037037037037035
694913510,3,6,3.0,9,0.3333333333333333
694979350,6,3,3.0,9,0.3333333333333333
694983586,5,5,5.0,10,0.5
694987248,2,8,2.0,10,0.2
694996787,1,9,1.0,10,0.1
695001453,1,28,1.0,29,0.034482758620689655
695001617,3,7,3.0,10,0.3
695002130,4,5,4.0,9,0.4444444444444444
695084472,1,9,1.0,10,0.1
695085668,9,1,1.0,10,0.1
695092759,1,9,1.0,10,0.1
695093639,6,13,6.0,19,0.3157894736842105
695096114,3,5,3.0,8,0.375
695123190,2,16,2.0,18,0.1111111111111111
695180229,2,18,2.0,20,0.1
695183272,3,7,3.0,10,0.3
695186615,1,8,1.0,9,0.1111111111111111
695197034,3,7,3.0,10,0.3
695199720,4,6,4.0,10,0.4
695201529,1,7,1.0,8,0.125
695211914,3,16,3.0,19,0.15789473684210525
695229742,1,9,1.0,10,0.1
695252435,4,6,4.0,10,0.4
695333599,1,9,1.0,10,0.1
695335949,2,8,2.0,10,0.2
695346026,2,7,2.0,9,0.2222222222222222
695359073,1,9,1.0,10,0.1
695379542,1,9,1.0,10,0.1
695385450,1,18,1.0,19,0.05263157894736842
695472921,6,2,2.0,8,0.25
695537980,1,9,1.0,10,0.1
695570975,1,9,1.0,10,0.1
695631900,3,7,3.0,10,0.3
695638387,1,18,1.0,19,0.05263157894736842
695647458,2,7,2.0,9,0.2222222222222222
695689706,21,5,5.0,26,0.19230769230769232
695689752,9,1,1.0,10,0.1
695734077,4,6,4.0,10,0.4
695790051,1,29,1.0,30,0.03333333333333333
695808639,1,7,1.0,8,0.125
695825460,2,7,2.0,9,0.2222222222222222
695867477,1,8,1.0,9,0.1111111111111111
695915512,9,1,1.0,10,0.1
696002519,1,8,1.0,9,0.1111111111111111
696003466,4,6,4.0,10,0.4
696006140,1,18,1.0,19,0.05263157894736842
696026657,2,6,2.0,8,0.25
696026803,3,7,3.0,10,0.3
696040721,3,5,3.0,8,0.375
696064214,2,18,2.0,20,0.1
696075329,1,19,1.0,20,0.05
696093525,1,9,1.0,10,0.1
696094718,4,6,4.0,10,0.4
696094895,13,16,13.0,29,0.4482758620689655
696108592,1,9,1.0,10,0.1
696123198,1,8,1.0,9,0.1111111111111111
696148668,2,8,2.0,10,0.2
696215159,1,9,1.0,10,0.1
696259957,1,18,1.0,19,0.05263157894736842
696268354,7,1,1.0,8,0.125
696415988,4,5,4.0,9,0.4444444444444444
696584465,1,9,1.0,10,0.1
696634359,1,9,1.0,10,0.1
696646709,2,17,2.0,19,0.10526315789473684
696667760,3,6,3.0,9,0.3333333333333333
696668809,3,7,3.0,10,0.3
696676838,5,14,5.0,19,0.2631578947368421
696684665,3,6,3.0,9,0.3333333333333333
696703189,3,7,3.0,10,0.3
696734638,3,16,3.0,19,0.15789473684210525
696772088,1,9,1.0,10,0.1
696774813,1,8,1.0,9,0.1111111111111111
696792324,1,8,1.0,9,0.1111111111111111
696800730,1,9,1.0,10,0.1
696801498,1,8,1.0,9,0.1111111111111111
696832495,8,1,1.0,9,0.1111111111111111
696837969,1,9,1.0,10,0.1
696865975,7,3,3.0,10,0.3
696906002,7,1,1.0,8,0.125
696915434,8,2,2.0,10,0.2
696920309,3,7,3.0,10,0.3
696920504,6,4,4.0,10,0.4
696920583,16,12,12.0,28,0.42857142857142855
696957559,1,8,1.0,9,0.1111111111111111
696960264,2,8,2.0,10,0.2
696962270,1,9,1.0,10,0.1
696962450,1,9,1.0,10,0.1
697022189,1,9,1.0,10,0.1
697050312,8,2,2.0,10,0.2
697052983,1,8,1.0,9,0.1111111111111111
697054619,2,8,2.0,10,0.2
697055118,2,7,2.0,9,0.2222222222222222
697072920,5,24,5.0,29,0.1724137931034483
697099635,1,9,1.0,10,0.1
697104049,1,27,1.0,28,0.03571428571428571
697104113,1,8,1.0,9,0.1111111111111111
697127594,7,2,2.0,9,0.2222222222222222
697127889,8,2,2.0,10,0.2
697128066,2,7,2.0,9,0.2222222222222222
697128290,7,3,3.0,10,0.3
697128505,8,1,1.0,9,0.1111111111111111
697129349,1,9,1.0,10,0.1
697132087,1,8,1.0,9,0.1111111111111111
697138486,3,7,3.0,10,0.3
697145636,2,8,2.0,10,0.2
697146451,2,8,2.0,10,0.2
697153238,5,5,5.0,10,0.5
697158355,12,16,12.0,28,0.42857142857142855
697160144,6,4,4.0,10,0.4
697160217,7,20,7.0,27,0.25925925925925924
697166806,2,17,2.0,19,0.10526315789473684
697233381,7,3,3.0,10,0.3
697247249,1,9,1.0,10,0.1
697255659,1,8,1.0,9,0.1111111111111111
697263434,1,18,1.0,19,0.05263157894736842
697276506,5,4,4.0,9,0.4444444444444444
697312144,1,8,1.0,9,0.1111111111111111
697358146,3,6,3.0,9,0.3333333333333333
697451150,2,7,2.0,9,0.2222222222222222
697465417,2,8,2.0,10,0.2
697471088,2,8,2.0,10,0.2
697472603,13,17,13.0,30,0.43333333333333335
697511630,4,6,4.0,10,0.4
697513147,6,3,3.0,9,0.3333333333333333
697514604,6,4,4.0,10,0.4
697516268,1,8,1.0,9,0.1111111111111111
697551464,1,9,1.0,10,0.1
697555710,2,8,2.0,10,0.2
697573161,1,8,1.0,9,0.1111111111111111
697574393,3,24,3.0,27,0.1111111111111111
697582601,1,8,1.0,9,0.1111111111111111
697599389,3,6,3.0,9,0.3333333333333333
697610725,3,7,3.0,10,0.3
697611620,5,4,4.0,9,0.4444444444444444
697627388,4,6,4.0,10,0.4
697633374,6,3,3.0,9,0.3333333333333333
697633724,1,8,1.0,9,0.1111111111111111
697639821,1,8,1.0,9,0.1111111111111111
697691212,8,1,1.0,9,0.1111111111111111
697786698,3,6,3.0,9,0.3333333333333333
697805403,3,5,3.0,8,0.375
697806674,1,9,1.0,10,0.1
697812770,9,1,1.0,10,0.1
697839976,1,18,1.0,19,0.05263157894736842
697863229,1,26,1.0,27,0.037037037037037035
697865641,4,6,4.0,10,0.4
697897624,1,9,1.0,10,0.1
697904347,1,9,1.0,10,0.1
697905190,1,9,1.0,10,0.1
697958429,7,3,3.0,10,0.3
697969078,1,17,1.0,18,0.05555555555555555
697971160,3,7,3.0,10,0.3
697971248,1,9,1.0,10,0.1
697977063,3,6,3.0,9,0.3333333333333333
697983665,4,4,4.0,8,0.5
698016916,1,19,1.0,20,0.05
698033716,1,9,1.0,10,0.1
698036715,5,5,5.0,10,0.5
698037597,9,18,9.0,27,0.3333333333333333
698041749,2,7,2.0,9,0.2222222222222222
698074849,1,9,1.0,10,0.1
698095831,1,9,1.0,10,0.1
698137245,2,8,2.0,10,0.2
698137487,1,9,1.0,10,0.1
698168791,8,1,1.0,9,0.1111111111111111
698174378,3,7,3.0,10,0.3
698182495,5,25,5.0,30,0.16666666666666666
698190488,2,18,2.0,20,0.1
698248346,1,7,1.0,8,0.125
698253545,9,1,1.0,10,0.1
698258529,8,2,2.0,10,0.2
698268345,1,18,1.0,19,0.05263157894736842
698276072,8,11,8.0,19,0.42105263157894735
698337564,7,3,3.0,10,0.3
698343837,4,6,4.0,10,0.4
698400944,2,8,2.0,10,0.2
698401526,1,8,1.0,9,0.1111111111111111
698401912,1,8,1.0,9,0.1111111111111111
698403592,7,2,2.0,9,0.2222222222222222
698405549,3,6,3.0,9,0.3333333333333333
698416945,8,2,2.0,10,0.2
698436382,1,9,1.0,10,0.1
698441582,2,8,2.0,10,0.2
698463794,1,8,1.0,9,0.1111111111111111
698464191,1,9,1.0,10,0.1
698464613,4,15,4.0,19,0.21052631578947367
698464852,1,9,1.0,10,0.1
698477785,2,7,2.0,9,0.2222222222222222
698481787,5,5,5.0,10,0.5
698493321,16,13,13.0,29,0.4482758620689655
698514557,1,18,1.0,19,0.05263157894736842
698623252,1,8,1.0,9,0.1111111111111111
698624699,1,8,1.0,9,0.1111111111111111
698658195,3,6,3.0,9,0.3333333333333333
698705636,1,8,1.0,9,0.1111111111111111
698710742,1,9,1.0,10,0.1
698712715,26,1,1.0,27,0.037037037037037035
698713215,5,5,5.0,10,0.5
698738817,3,6,3.0,9,0.3333333333333333
698763771,5,5,5.0,10,0.5
698794883,1,8,1.0,9,0.1111111111111111
698808048,1,8,1.0,9,0.1111111111111111
698859957,3,7,3.0,10,0.3
698867295,1,9,1.0,10,0.1
698869756,2,7,2.0,9,0.2222222222222222
698871106,1,9,1.0,10,0.1
698873415,5,5,5.0,10,0.5
698873916,7,3,3.0,10,0.3
698877099,2,8,2.0,10,0.2
698882263,2,7,2.0,9,0.2222222222222222
698894509,1,9,1.0,10,0.1
698902693,7,23,7.0,30,0.23333333333333334
698903309,3,6,3.0,9,0.3333333333333333
698904581,4,5,4.0,9,0.4444444444444444
698920132,7,3,3.0,10,0.3
698932314,1,9,1.0,10,0.1
698933094,3,6,3.0,9,0.3333333333333333
698934000,2,8,2.0,10,0.2
698934233,6,3,3.0,9,0.3333333333333333
698934733,1,9,1.0,10,0.1
698935359,1,9,1.0,10,0.1
698942691,1,9,1.0,10,0.1
698983762,3,7,3.0,10,0.3
698984149,7,3,3.0,10,0.3
699006912,3,7,3.0,10,0.3
699007192,6,4,4.0,10,0.4
699046902,2,18,2.0,20,0.1
699095653,1,8,1.0,9,0.1111111111111111
699163319,27,1,1.0,28,0.03571428571428571
699212310,2,8,2.0,10,0.2
699241544,2,8,2.0,10,0.2
699245054,1,9,1.0,10,0.1
699255100,5,4,4.0,9,0.4444444444444444
699257991,5,5,5.0,10,0.5
699276420,1,18,1.0,19,0.05263157894736842
699302091,7,2,2.0,9,0.2222222222222222
699322737,1,9,1.0,10,0.1
699331695,2,8,2.0,10,0.2
699334536,3,7,3.0,10,0.3
699349503,5,3,3.0,8,0.375
699351423,3,7,3.0,10,0.3
699352077,2,8,2.0,10,0.2
699352222,5,4,4.0,9,0.4444444444444444
699355719,6,3,3.0,9,0.3333333333333333
699356655,1,8,1.0,9,0.1111111111111111
699358485,4,6,4.0,10,0.4
699358778,1,8,1.0,9,0.1111111111111111
699359637,2,8,2.0,10,0.2
699360534,6,4,4.0,10,0.4
699392333,1,9,1.0,10,0.1
699401238,5,13,5.0,18,0.2777777777777778
699425102,1,9,1.0,10,0.1
699431935,2,25,2.0,27,0.07407407407407407
699442230,5,5,5.0,10,0.5
699445326,5,4,4.0,9,0.4444444444444444
699445375,3,7,3.0,10,0.3
699450992,3,7,3.0,10,0.3
699456034,2,7,2.0,9,0.2222222222222222
699458324,5,15,5.0,20,0.25
699480065,6,4,4.0,10,0.4
699499008,3,26,3.0,29,0.10344827586206896
699522986,6,21,6.0,27,0.2222222222222222
699528880,1,9,1.0,10,0.1
699549435,8,1,1.0,9,0.1111111111111111
699563903,3,25,3.0,28,0.10714285714285714
699565779,3,25,3.0,28,0.10714285714285714
699569747,8,2,2.0,10,0.2
699578052,2,8,2.0,10,0.2
699598266,2,8,2.0,10,0.2
699598285,2,17,2.0,19,0.10526315789473684
699603533,2,8,2.0,10,0.2
699604332,23,6,6.0,29,0.20689655172413793
699621440,1,9,1.0,10,0.1
699640261,7,23,7.0,30,0.23333333333333334
699642939,1,8,1.0,9,0.1111111111111111
699645524,7,3,3.0,10,0.3
699646005,5,5,5.0,10,0.5
699659494,6,4,4.0,10,0.4
699660419,6,4,4.0,10,0.4
699661020,8,2,2.0,10,0.2
699661834,4,6,4.0,10,0.4
699663770,5,5,5.0,10,0.5
699698850,1,28,1.0,29,0.034482758620689655
699741197,1,9,1.0,10,0.1
699755057,2,8,2.0,10,0.2
699756185,1,9,1.0,10,0.1
699813325,3,16,3.0,19,0.15789473684210525
699820699,1,8,1.0,9,0.1111111111111111
699822249,1,9,1.0,10,0.1
699848324,1,8,1.0,9,0.1111111111111111
699851288,1,9,1.0,10,0.1
699891012,2,8,2.0,10,0.2
